target_id,rank,funny,somewhat_funny,unfunny,count,score,precision,contest,caption
3582,1,37,55,83,175,1.737142857142857,0.05952978623524672,660,And I was promoted to branch manager.
1762,2,38,63,100,201,1.691542288557214,0.054379270150976794,660,Tell the boss I'm working from the branch office today.
5061,3,34,47,88,169,1.680473372781065,0.06073930562454675,660,I'm the new branch manager.
337,4,29,64,92,185,1.6594594594594594,0.05407755070982755,660,So you got my tweet.
5635,5,28,48,82,158,1.6582278481012658,0.060748742632374786,660,Are you here about the sublet?
3169,6,30,51,88,169,1.6568047337278107,0.05877934228148399,660,I got rid of everything that didn’t bring me joy.
4385,7,36,46,99,181,1.6519337016574585,0.05891171386769647,660,When he's no longer president.
66,8,27,61,91,179,1.6424581005586592,0.0546378098516659,660,"Well, well, well, if it isn’t my old accountant Jim who said I’d never afford a view of Central Park."
1290,9,32,54,98,184,1.641304347826087,0.05619341930250302,660,They made me a branch manager.
470,10,24,52,80,156,1.641025641025641,0.058904191004059095,660,I come here to brood.
5271,11,29,53,95,177,1.6271186440677967,0.05648433341471241,660,I began tweeting ... and one thing led to another.
5523,12,29,63,102,194,1.6237113402061856,0.05258423178561817,660,My 23 And Me results came back and I'm 8% Pigeon.
3508,13,29,58,99,186,1.6236559139784945,0.0543530586387859,660,Does this hat make me look silly?
3436,14,31,45,96,172,1.622093023255814,0.059015232940433246,660,We’re registered at Bird Bath & Beyond.
2574,15,25,55,89,169,1.621301775147929,0.05622784577013642,660,It's just until I pay down my student loans.
85,16,21,65,89,175,1.6114285714285714,0.05239020667616415,660,It's illegal to sleep on the bench.
3530,17,27,49,93,169,1.6094674556213018,0.057608257477859165,660,I call it my branch office.
136,18,36,40,109,185,1.6054054054054054,0.058424928126898146,660,I'd sit on the far side of the bench if I were you.
595,19,31,42,99,172,1.6046511627906976,0.05921085576960161,660,I call it TRUNK TOWER.
4571,20,29,45,98,172,1.5988372093023255,0.058110627928655435,660,"Prewar, park views, hardwood, no pets, birds ok."
4117,21,25,48,91,164,1.5975609756097562,0.05784259924338145,660,One Central Park Nest.
2180,22,24,48,89,161,1.5962732919254659,0.058033831685953184,660,"“ I had a plan after college, but then my parents moved in with their parents.”"
4841,23,22,53,88,163,1.5950920245398772,0.05615763512262404,660,"No,not full-time. I have a dog sitting gig during the week."
3638,24,25,48,94,167,1.5868263473053892,0.057133450998538275,660,I found a way to live on my Social Security!
26,25,30,45,104,179,1.5865921787709498,0.05696920739824302,660,You're gonna have to speak to the branch manager.
3107,26,28,51,104,183,1.5846994535519126,0.05491436547824058,660,You may now approach the bench.
4225,27,27,49,101,177,1.5819209039548023,0.055818990702595814,660,"Yes, I have two kids in college, how did you know?"
4233,28,22,52,91,165,1.5818181818181818,0.05576368101797616,660,"No, no, I'm just housesitting—the owners go south every winter."
1540,29,28,52,106,186,1.5806451612903225,0.05425523398727897,660,Corporate offered me a branch office position.
1241,30,28,45,101,174,1.5804597701149425,0.05716648973202921,660,"The AirBnB listing said, ""Loft in the city, completely furnished, great park view, owners away south for the winter""."
4829,31,25,45,94,164,1.579268292682927,0.05801388592797364,660,Are you here about the 'Cozy loft with park-view?'
4761,32,22,48,90,160,1.575,0.057153385148757944,660,All they know is that I live in a high rise on Park Avenue.
2238,33,22,56,96,174,1.5747126436781609,0.05361453000005904,660,"I wouldn't sit there, bud."
1893,34,20,59,94,173,1.5722543352601157,0.052606104510727066,660,"I came to rescue a cat and then realized, ""Hey! This isn't so bad!"""
1810,35,27,46,102,175,1.5714285714285714,0.05639910061620378,660,Relax- they're not yours.
3694,36,25,59,107,191,1.5706806282722514,0.051645774958342903,660,"Who's homeless now, Gary?"
1249,37,21,47,88,156,1.5705128205128205,0.05760033105718571,660,"It's comfortable enough, and now I can afford my health insurance premiums."
3364,38,20,58,94,172,1.569767441860465,0.05285368989598215,660,The ad said “Rent controlled with a birds eye view of Central Park West.”
1916,39,25,48,100,173,1.5664739884393064,0.05575061527981644,660,It just made sense considering how much I tweet
1242,40,24,36,89,149,1.563758389261745,0.06195478510441452,660,It was this or move to Jersey.
5118,41,27,48,106,181,1.5635359116022098,0.05499018747686517,660,You and Mom never believed I'd be living on Central Park West.
3987,42,22,41,88,151,1.5629139072847682,0.05985719498645561,660,The good news is I moved out of my parents' place.
3246,43,22,65,107,194,1.5618556701030928,0.04950417367590204,660,Are you the new branch manager?
5391,44,28,37,101,166,1.5602409638554218,0.05947856368953854,660,"As a millennial, this is pretty much my only hope for building a nest egg."
1663,45,21,45,90,156,1.5576923076923077,0.05769230769230769,660,Did you get my tweet?
1564,46,21,35,83,139,1.5539568345323742,0.06308763937528451,660,My ex-boss has lunch on that bench everyday. I'm just waiting for him.
2149,47,26,42,102,170,1.5529411764705883,0.057207169698747895,660,The ad said perfect for an empty nester seeking Central Park views and low utility costs.
5290,48,25,45,102,172,1.552325581395349,0.05608888663886446,660,It's just until the Airbnb couple leave my bedroom.
3201,49,18,44,83,145,1.5517241379310345,0.058665747839884354,660,It's a great place to meet chicks.
3684,50,30,42,113,185,1.5513513513513513,0.05574043898511997,660,Why stop at just destroying their habitat?
3696,51,24,44,99,167,1.5508982035928143,0.05676173635722295,660,Go ahead and have a seat sir.  What's the worst that could happen?
4750,51,27,38,102,167,1.5508982035928143,0.05863726899306487,660,"It's the same rent as our apartment in Soho, but with more room."
1277,53,22,59,106,187,1.5508021390374331,0.05094342531029487,660,"I'm the sitter, may I take a message?"
211,54,30,39,111,180,1.55,0.056963839031173635,660,This is where I do my tweets.
2186,55,20,55,98,173,1.5491329479768785,0.052760969665937234,660,"The listing said, ""cozy loft with a view of Central Park."""
3413,56,18,49,88,155,1.5483870967741935,0.05582421118500361,660,"No, I'm just house sitting. The owners went south for the winter."
2325,57,25,47,105,177,1.5480225988700564,0.05488519555854647,660,And people are finally paying attention to my tweets.
4983,58,19,67,106,192,1.546875,0.04830744693665276,660,"You can't beat the price, and only one flight up."
1652,59,22,45,96,163,1.5460122699386503,0.05653697147851114,660,Tweeting has a whole new meaning.
4794,60,25,40,100,165,1.5454545454545454,0.0579615193693944,660,"I had a lousy divorce attorney."""
4211,61,22,47,98,167,1.5449101796407185,0.05550730602388519,660,The ad said “Rent controlled with a birds eye view of Manhattan.”
2254,62,25,41,102,168,1.5416666666666667,0.05717307144845306,660,Our startup thought I was best suited for a branch office.
2631,62,25,41,102,168,1.5416666666666667,0.05717307144845306,660,You can follow me on Twitter.
2668,64,26,40,104,170,1.5411764705882354,0.057264405500656555,660,"Go ahead, sit down.  I dare you."
3611,64,13,66,91,170,1.5411764705882354,0.048726119913020095,660,It's a sublease; the tenants flew south for the winter.
5734,66,27,45,111,183,1.540983606557377,0.05464180619866079,660,We all have to do our part to keep Portland weird.
205,67,24,61,117,202,1.5396039603960396,0.049175049729577314,660,"Let's see those folks on ""Tiny Homes"" top this!"
3422,68,23,43,99,165,1.5393939393939393,0.05669967933013085,660,Spotted Northeastern Millennial.
4718,69,22,55,107,184,1.5380434782608696,0.05162300968229237,660,I’ll send you a tweet.
412,70,29,45,118,192,1.5364583333333333,0.053698505018037454,660,Guess who just got laid.
5377,71,20,56,103,179,1.5363128491620113,0.05150243062533881,660,Can you believe the owners just up and left?
1203,72,22,44,99,165,1.5333333333333334,0.05606809642135502,660,I just got promoted to branch manager.
4377,73,22,45,100,167,1.532934131736527,0.05555787153511109,660,"cheap, cheap, cheap"
5121,74,21,49,101,171,1.5321637426900585,0.053937847060781696,660,"The ad just said: ""cheap cheap cheap!"""
131,75,23,54,111,188,1.5319148936170213,0.05138000873377299,660,I got it for a song.
3526,76,22,48,103,173,1.5317919075144508,0.05409533653180773,660,"... and after getting my master's in communications, I moved into this tree."
1008,77,23,47,105,175,1.5314285714285714,0.05423816083300174,660,Are you here to set up the WiFi?
4150,78,21,52,104,177,1.5310734463276836,0.05256611510790163,660,I picked it up for a song.
2561,79,24,49,110,183,1.530054644808743,0.053007971632132195,660,My rent is peanuts. I sublet from a squirrel
4653,80,21,50,103,174,1.528735632183908,0.0532500684570549,660,My tweets feel more authentic now.
4278,81,23,47,106,176,1.5284090909090908,0.054013572893029424,660,"Mary, you do realize that “building a nest together” was a metaphor."
951,82,19,48,96,163,1.5276073619631902,0.054567133186610765,660,Got tired of working from home so I opened a branch office.
5008,83,23,50,109,182,1.5274725274725274,0.052663453155299876,660,Any minute now you're gonna ask me if this is my branch office -I can feel it...
2792,84,20,57,107,184,1.5271739130434783,0.050497680669443316,660,Life goal of living on Central Park West? Check.
5679,85,23,43,103,169,1.5266272189349113,0.0557139986429534,660,Sorry about your car.
3466,86,23,45,105,173,1.5260115606936415,0.05473080806598117,660,I can finally afford my own place in the city.
3371,87,23,47,107,177,1.5254237288135593,0.053790451990642064,660,I can tweet all day without being tied to my phone.
114,88,25,44,110,179,1.5251396648044693,0.05449964468454768,660,The rent is cheep cheep cheep.
4816,88,21,52,106,179,1.5251396648044693,0.05214526321911169,660,"No, I've actually been doing great since the divorce."
3144,90,22,42,100,164,1.524390243902439,0.05635654457230424,660,I assembled it myself. IKEA.
2964,91,18,42,89,149,1.523489932885906,0.05760178777420121,660,It's only 'til fall. Then I head south.
3119,91,18,42,89,149,1.523489932885906,0.05760178777420121,660,"Well, I couldn't stay at the Ecuadorian embassy anymore"
4876,93,19,41,91,151,1.5231788079470199,0.05779956009066898,660,I was tweeting before it was even a thing!
1807,94,20,51,103,174,1.5229885057471264,0.052638838497361645,660,I wanted to live off the grid but near a Starbucks.
938,95,17,58,101,176,1.5227272727272727,0.0502942933006007,660,I got it for a song while the owners are south for the winter.
3983,96,23,36,98,157,1.5222929936305734,0.0589706931236923,660,I found it on AirTreeNTree.
3198,97,20,46,99,165,1.5212121212121212,0.054770824547131954,660,"The hunky fireman of my dreams should be along soon, to help me down.  It worked for my cat!"
5029,98,20,39,93,152,1.519736842105263,0.05827363811657393,660,"I think while this may prove my obstetrician wrong, it could unfortunately serve to validate my psychiatrist."
3925,99,31,35,121,187,1.518716577540107,0.0558993186651412,660,The site's called AirTree'nTree.
3073,100,22,40,100,162,1.5185185185185186,0.056900370745306385,660,"Until the bough breaks, I’m fine."
1970,101,24,51,116,191,1.5183246073298429,0.05134881279259825,660,Yeah...you probably don’t want to sit on that bench.
5053,102,18,53,101,172,1.5174418604651163,0.05180926033670916,660,"She puts the food right in my mouth, Fred.  In my mouth!"
2389,103,26,52,123,201,1.5174129353233832,0.050418412179734265,660,I'm Robin.
2549,104,18,39,88,145,1.5172413793103448,0.0588063321484436,660,I wouldn't sit directly below.
750,105,23,45,108,176,1.5170454545454546,0.054040888691168715,660,"If you lived here, you'd be home now."
1592,105,23,45,108,176,1.5170454545454546,0.054040888691168715,660,I wouldn't sit there.
1975,107,19,56,107,182,1.5164835164835164,0.05033147047081378,660,"First, I said goodbye to cable. Then I reconsidered all my other entanglements."
1941,108,24,48,114,186,1.5161290322580645,0.05239168339445811,660,There's laws against sleeping on the bench.
4149,109,23,40,104,167,1.5149700598802396,0.05624949794172674,660,"It might not look like much, but it’s in a great school district."
5694,109,22,42,103,167,1.5149700598802396,0.05560450657818663,660,"I swear, I was nowhere near your car.”"
5483,111,19,50,102,171,1.5146198830409356,0.05269269852545661,660,It's listed on Condó Nest
5662,112,28,33,112,173,1.5144508670520231,0.05774294452051941,660,I still don't regret the divorce.
3845,113,17,43,90,150,1.5133333333333334,0.05655008404914796,660,I said I wanted light and airy with a birds eye view of Central Park.
5752,114,21,47,106,174,1.5114942528735633,0.053287701652201355,660,Catching up on my tweets.
1197,115,25,40,111,176,1.5113636363636365,0.055237760214212894,660,I found it on Airbntree.
3706,115,21,48,107,176,1.5113636363636365,0.052834362811929714,660,I’ve opened a branch office.
5246,117,22,48,110,180,1.511111111111111,0.05255063999069812,660,Don't worry. They're not yours.
4591,118,24,46,114,184,1.5108695652173914,0.05282983393813591,660,That's right. 'Air Tree n Tree.' They're branching out.
1661,119,21,55,114,190,1.5105263157894737,0.04991748896982003,660,This is where I do my best tweets.
5355,119,24,49,117,190,1.5105263157894737,0.05156394169051468,660,You can have the house
3054,121,19,60,113,192,1.5104166666666667,0.04842050535527074,660,"They said, ""Open a branch office""."
5516,122,19,48,102,169,1.5088757396449703,0.05316043172791251,660,They chose me to run their branch office.
1812,123,20,48,105,173,1.5086705202312138,0.05288967757200162,660,"You're my first sighting of a knit hatted, long coat male city pedestrian I've seen this season."""
1615,124,22,57,120,199,1.5075376884422111,0.04877534103816796,660,It's a house swap. I wanted to see New York and she wanted to head south for winter.
1296,125,22,37,101,160,1.50625,0.05745990877431151,660,"Studio, One-bedroom... who cares what they call it, I'm finally out of Brooklyn!"
2289,125,18,45,97,160,1.50625,0.05465506113387093,660,I'm subleasing until they get back from Capistrano.
576,127,22,41,105,168,1.505952380952381,0.05536321716415175,660,"It checked all the boxes---park view, cheap rent, and no roommates!"
1461,128,15,56,99,170,1.5058823529411764,0.05023235868372097,660,She asked if I'd keep them warm for 30 minutes while she ran an errand
1633,129,16,57,103,176,1.5056818181818181,0.04967240675582546,660,It gets a lot of natural light.
4008,130,21,48,109,178,1.5056179775280898,0.05239590134206919,660,"I couldn’t believe it either. Right on the park—and cheep, cheep!"
153,131,18,44,97,159,1.5031446540880504,0.054911044604512786,660,I wouldn’t sit on that bench if I were you.
2827,131,14,52,93,159,1.5031446540880504,0.05193050005496539,660,It's bigger than my apartment.
1459,133,17,47,97,161,1.5031055900621118,0.053687200495903156,660,Sorry about your windshield.
5769,133,24,33,104,161,1.5031055900621118,0.05853028069261986,660,I thought it would be a good way to pick up chicks.
1375,133,20,41,100,161,1.5031055900621118,0.05581428806090506,660,It's OK. The apartment across the street gets HBO.
2794,136,16,52,99,167,1.5029940119760479,0.051577979468181955,660,My summer place is on a telephone pole in the Hamptons.
4903,136,17,50,100,167,1.5029940119760479,0.05227267769028979,660,It was either this or leave Brooklyn for the suburbs.
1773,138,23,43,111,177,1.502824858757062,0.053824157396537786,660,I love living in the sticks.
158,139,20,50,109,179,1.5027932960893855,0.05157387439870336,660,I finally located my family tree.
5723,140,20,52,111,183,1.5027322404371584,0.05074022234803336,660,I’m just subletting for the winter till the owner flies back.
3548,141,21,54,116,191,1.5026178010471205,0.04973024257647151,660,It's called affordable housing.
4616,142,21,39,102,162,1.5,0.05624145258781947,660,I found it on Airbnb. They call it a luxury nest with park and city views.
3213,142,21,33,96,150,1.5,0.05964098406184938,660,It’s made out of the redacted sections of the Mueller Report
2376,142,20,49,109,178,1.5,0.05178830775288298,660,And now I can honestly tell my mom I have a little place with a view of Central Park!
2310,142,17,48,99,164,1.5,0.05296816228425676,660,Trust me. I wouldn't sit there if I were you.
1034,142,15,53,98,166,1.5,0.05109248249075663,660,"You know what they say: location, location, location."
1019,142,19,40,97,156,1.5,0.05643093086812858,660,It’s only five blocks from my office as the crow flies.
900,142,19,52,109,180,1.5,0.05075470152486088,660,"If you're going out, we need eggs."
84,142,18,46,100,164,1.5,0.0536697579168995,660,Can you believe someone just left it here?
1792,142,26,42,120,188,1.5,0.053066185325791874,660,I’m waiting for the lady with the stale bagels.
3870,151,22,50,117,189,1.4973544973544974,0.05067613239243147,660,The Airbnb ad said it was a loft.
4177,152,27,35,117,179,1.4972067039106145,0.055670992545115996,660,I got rid of everything that didn't spark joy.
5696,152,21,47,111,179,1.4972067039106145,0.052178877135591044,660,"Which part of ‘beautiful park views, all hardwood floors, and just one short flight up’ did you not understand?"
3117,154,14,60,103,177,1.497175141242938,0.0481583627312774,660,"You said affordable and close to the park, right?"
1933,154,19,50,108,177,1.497175141242938,0.051383212997010694,660,"Well the ad said best view , hardwood floors, a real cozy nature lovers delight."
3559,156,21,45,109,175,1.497142857142857,0.053066421009006604,660,Last year I waited until March and it was already taken.
307,157,17,52,104,173,1.4971098265895955,0.05095160944152043,660,"Sorry, you'll need to wait for the branch manager"
119,158,18,43,98,159,1.4968553459119496,0.054911044604512786,660,It's public housing.
881,159,20,37,98,155,1.4967741935483871,0.05743738037460623,660,It's a sublet; the owners are out of town until May.
32,160,16,55,105,176,1.4943181818181819,0.04967240675582546,660,Of course I don’t live here. I’m babysitting.
394,160,16,55,105,176,1.4943181818181819,0.04967240675582546,660,This is where I tweet all day.
2752,162,16,53,103,172,1.494186046511628,0.0504953654044208,660,Turns out my nesting instinct is stronger than I thought.
5489,163,17,49,102,168,1.494047619047619,0.0520447482232018,660,You wouldn't believe some of the crazy people I've met since I've been up here.
391,164,17,48,101,166,1.4939759036144578,0.052500100281068524,660,"It has a wood interior throughout, no amenities, but it's close to the park."
2479,165,23,34,105,162,1.4938271604938271,0.057586689355346714,660,The same way you'd get any living space in New York City: I killed the last occupant.
873,166,14,50,94,158,1.4936708860759493,0.05216187031336437,660,My only complaint is that it's a walk-up
3129,167,21,51,117,189,1.492063492063492,0.050114721266055616,660,"It's bigger than my last Manhattan apartment, and cheaper."
5078,168,18,52,109,179,1.4916201117318435,0.05033857813768097,660,Guess how the pregnancy test turned out.
5165,169,20,47,110,177,1.4915254237288136,0.05200070378249679,660,"It was pricey, but like the ad said, it’s got lots of natural light, an open floor plan, and hardwood throughout."""
1995,170,22,41,110,173,1.4913294797687862,0.05414558766807937,660,This is where I do all my best tweeting.
108,171,17,48,102,167,1.4910179640718564,0.052268545299462336,660,Didn't you see my Tweet
3178,172,15,59,108,182,1.489010989010989,0.04786689685749444,660,One bedroom. Central Park views.  What's not to like?
4681,173,23,42,115,180,1.488888888888889,0.05313796204092464,660,This morning I pooped on a Mercedes.
5065,173,18,52,110,180,1.488888888888889,0.05013259197078092,660,I met her on Twitter.
268,175,22,43,113,178,1.4887640449438202,0.05299316470953411,660,Its pretty spacious for a New York apartment.
266,176,20,45,109,174,1.4885057471264367,0.052660596078270366,660,"They had me at ""rent-controlled""."
4746,176,18,49,107,174,1.4885057471264367,0.05138342965595219,660,"Don't knock it, I live on Central Park West!"
3773,178,17,50,105,172,1.4883720930232558,0.051158463276555356,660,I’m just subletting until the owner returns in the Spring.
4597,179,29,46,138,213,1.488262910798122,0.04962893966209765,660,I'm retired and living on my nest egg.
1367,180,16,49,101,166,1.4879518072289157,0.05179364213868047,660,The listing said it was cozy and rustic with a great view.
3003,181,16,45,97,158,1.4873417721518987,0.053678176117681206,660,It really only feels crowded when my roommate gets home.
5564,182,15,46,95,156,1.4871794871794872,0.05340915269868719,660,It's a sublet. The tenants flew south for the winter.
3002,183,17,57,113,187,1.4866310160427807,0.04817304449084411,660,Air bnb is really branching out!
4209,184,23,41,115,179,1.4860335195530727,0.05335845381497349,660,"Sorry, I'm not really interested in a relationship. I'm headed south in a couple of days."
4376,185,16,53,106,175,1.4857142857142858,0.04986493603844046,660,"Yes, this is the correct address for the Airbnb listing:  Cozy one room walk up in the heart of Central Park."
1534,186,18,46,105,169,1.485207100591716,0.05248576460100681,660,I wanted a place that attracted more chicks.
2747,187,16,47,100,163,1.4846625766871167,0.05247479005839871,660,I got tired of sleeping on the bench.
2367,188,27,40,127,194,1.4845360824742269,0.05230992647546711,660,"Its a great deal, the owners are down south for the winter."
2331,189,14,58,106,178,1.4831460674157304,0.04795356250311228,660,Just yesterday I was homeless.
2221,190,17,51,108,176,1.4829545454545454,0.0503071293249863,660,Told ya I lived on Central Park West!
4894,190,27,31,118,176,1.4829545454545454,0.05639288882715219,660,I got it for a song from a couple of empty-nesters.
3734,192,19,44,107,170,1.4823529411764707,0.05291603223907228,660,". . . and best of all, I can finally tell my parents that I live in a New York City high rise!"
286,192,22,38,110,170,1.4823529411764707,0.05485387316087507,660,"Yes, I am pregnant. How did you guess?"
5750,194,16,58,113,187,1.481283422459893,0.047562787273380626,660,They're in Florida for the winter and asked me to watch their place.
271,195,23,43,119,185,1.481081081081081,0.05203942501873334,660,My parents are flying in tomorrow morning.
4228,196,18,52,113,183,1.4808743169398908,0.04952275088906408,660,"Sure it can be unpleasant, but I'm getting millions of retweets."
4825,197,18,49,110,177,1.4802259887005649,0.0507331935329777,660,It comes with the Audubon membership.
878,198,17,48,106,171,1.4795321637426901,0.05135868544655377,660,It’s just til my novel gets published.
5427,198,20,42,109,171,1.4795321637426901,0.05333022519745499,660,It looked much bigger in AirBNB.
2198,200,15,51,103,169,1.4792899408284024,0.05042001482478609,660,"It's got all natural wood flooring, plenty of fresh air, and is right in the middle of Manhattan. It's a steal!"
4245,201,17,57,116,190,1.4789473684210526,0.04761531005865965,660,"As a plus, the bench works as a guest house!"
4467,202,23,33,109,165,1.4787878787878788,0.05675889984482508,660,It was a steal - the previous owners went south for the winter.
5720,203,16,46,101,163,1.478527607361963,0.05246150586172366,660,"In exchange for egg-sitting, they promised to take me south for the winter."
2954,204,19,51,116,186,1.478494623655914,0.049529603163137974,660,"Ironically, dad, this makes you an empty nester."
3404,205,18,41,102,161,1.4782608695652173,0.0543788731195299,660,I've finally started tweeting.
220,206,23,52,130,205,1.4780487804878049,0.04819834367142156,660,"Sure it's cramped, but it's a real chick magnet."
3393,207,18,39,100,157,1.4777070063694266,0.05540077671701142,660,Just seven months ‘til the Macy’s parade.
4642,208,14,56,106,176,1.4772727272727273,0.04831884460333932,660,Did you find any more sticks?
5251,209,19,35,99,153,1.477124183006536,0.05723007065603348,660,It's 'Air Tree & Be'. I'll decide the star rating around midnight.
2946,210,17,58,118,193,1.4766839378238341,0.0470827155759661,660,"Well, for starters, I've got a Fifth Avenue address!"
1065,211,15,50,103,168,1.4761904761904763,0.050625106499327166,660,"Location,location,location"
494,212,21,45,117,183,1.4754098360655739,0.05129656933021343,660,I think we just want different things.
1885,212,15,57,111,183,1.4754098360655739,0.047655457009525545,660,It’s my family tree
1922,214,19,39,104,162,1.4753086419753085,0.054826560983488426,660,"I'd ask you up, but I'm sitting the kids."
5552,215,14,48,98,160,1.475,0.05166260888914442,660,It's considered park adjacent.
823,216,22,40,115,177,1.4745762711864407,0.053190331733970156,660,It's my happy place -- where I first got laid.
4842,216,19,46,112,177,1.4745762711864407,0.05134790534974591,660,Cozy studio. Park views. Excellent lighting. Must like squirrels.
5054,216,23,38,116,177,1.4745762711864407,0.053790451990642064,660,"Take a seat in the living room, I’ll be right down"
2837,219,19,44,110,173,1.4739884393063585,0.052216932225596265,660,It's my solution to writer's block: I'm hatching a plot.
146,220,20,50,120,190,1.4736842105263157,0.04932527792523144,660,"Plus, there's no homeowner's association."
3030,221,19,51,118,188,1.4734042553191489,0.04913260056396652,660,At least I don’t live with my parents.
2878,222,19,42,108,169,1.4733727810650887,0.05312513653863179,660,It makes my tweets more authentic
3037,223,22,34,109,165,1.4727272727272727,0.05608806582627689,660,It was advertised as a walk-up with bird’s eye view of the city.
3148,224,22,42,118,182,1.4725274725274726,0.052083841355504645,660,"The agent said, ""Upper West Side, rent controlled with an unobstructed view of Central Park."""
2470,225,16,45,102,163,1.4723926380368098,0.052443788365148895,660,My parents rented out my room when I left for college
2278,225,17,43,103,163,1.4723926380368098,0.05316099416045055,660,"You can have all our stuff, Tom.  I'm de-cluttering"
5426,227,18,47,111,176,1.4715909090909092,0.05091945337486723,660,"It's just a sublet, but I get it until spring."
258,228,18,46,110,174,1.471264367816092,0.05134440073187335,660,As soon as I can fly I’m outta here.
723,228,18,46,110,174,1.471264367816092,0.05134440073187335,660,I got it on Air Tree 'n B.
3142,230,18,61,127,206,1.470873786407767,0.0454736023792082,660,And you said I’d be on the streets
725,231,20,48,119,187,1.4705882352941178,0.04989444187656737,660,The cable guy is coming between 1 to 4.
3891,231,15,50,105,170,1.4705882352941178,0.05018342310592497,660,"I know it's a little cramped. But this is the Upper East Side, and if you work out the rent per square foot, it's a steal."
4405,231,20,56,128,204,1.4705882352941178,0.04683128609158934,660,It's rent-controlled.  I've been here since it was a sapling.
4528,231,18,52,117,187,1.4705882352941178,0.0487283625585648,660,"It's a walk-up, but has great views of the park."
5610,235,20,46,117,183,1.469945355191257,0.05069169650982786,660,The Airbnb said  surrounded by nature.”
1585,236,16,46,104,166,1.4698795180722892,0.05174903547078258,660,"Yes, I am in my late twenties. How did you know?"
702,237,14,42,93,149,1.4697986577181208,0.05433923362442031,660,"Dad, you know my generation takes longer to leave the nest."
4174,238,13,51,100,164,1.4695121951219512,0.050006568839642836,660,"You know Mark, sometimes it's good to get out of your comfort zone"
1282,239,20,43,114,177,1.4689265536723164,0.05195185388558707,660,"The super is a little squirrely, but the rent is nuts."
552,240,12,43,88,143,1.4685314685314685,0.054180313154473136,660,"And as long as they hatch, this counts as paternity leave."
5502,241,22,44,122,188,1.4680851063829787,0.050823380486225166,660,Remind me again why we broke up.
1153,242,19,42,110,171,1.4678362573099415,0.05264686549400136,660,Ya and the best part is it’s vacant till late spring.
976,243,16,55,115,186,1.467741935483871,0.04770418011183605,660,It's the next stage in the tiny house trend.
5145,244,18,43,108,169,1.467455621301775,0.05243809359698283,660,How long have you been following my tweets?
3340,245,16,54,114,184,1.4673913043478262,0.04806926448605376,660,Let's see your brother brag about his Tiny House now.
3457,246,18,42,107,167,1.467065868263473,0.05289704738396109,660,It's from ikea.
1648,247,19,39,107,165,1.4666666666666666,0.05405462002726678,660,"As they say, pick the worst house in the best neighborhood."
5520,248,19,45,114,178,1.4662921348314606,0.051108996515489453,660,I'm actually waiting for a good looking firefighter to rescue me.
1526,249,18,53,120,191,1.4659685863874345,0.04797606521020338,660,I'm subletting till the owners come back from Capistrano
1364,250,12,51,98,161,1.4658385093167703,0.04986865971828311,660,They don't get back until May.
1274,251,11,46,89,146,1.4657534246575343,0.05249053140126631,660,I told you I live in Central Park West!
830,252,17,61,126,204,1.4656862745098038,0.0452409659440968,660,"I'd invite you up, but the place is a mess."
4189,253,15,51,108,174,1.4655172413793103,0.049343946367606466,660,"Statistically, I'm no longer homeless."
3009,254,14,46,99,159,1.4654088050314464,0.05185813646360258,660,It's a 2nd story climb-up.
5374,255,18,51,118,187,1.46524064171123,0.048709427892002416,660,"It's not a nest,it's a loft."
4728,256,18,49,116,183,1.46448087431694,0.04947303090307817,660,"I was already off the grid, so going off the ground wasn't a big deal."
3791,257,18,40,106,164,1.4634146341463414,0.05359320223623875,660,I got better reception and it is bigger than my previous apartment.
2161,258,13,43,93,149,1.4630872483221478,0.0534697497870494,660,The City says I need a fire escape.
1185,259,12,50,98,160,1.4625,0.05006874205347693,660,"It’s the same size as my last place, but no roommate drama."
2973,260,22,36,115,173,1.4624277456647399,0.05407378603502323,660,The best part is crapping on people.
3051,261,21,42,119,182,1.4615384615384615,0.05145882550941921,660,"Come on! It's an open concept, high-rise with a natural wood interior and panoramic views of Central Park!"
4284,261,18,48,116,182,1.4615384615384615,0.04965755148135667,660,I’m normally a bird watcher but my therapist told me to try and see things from another perspective.
4530,261,22,34,113,169,1.4615384615384615,0.05503655385097699,660,It's cheaper than Brooklyn
3039,264,18,47,115,180,1.461111111111111,0.05005514580844769,660,"A little bird told me: ""One floor walk-up for less than $2000 a month."""
3244,265,23,42,126,191,1.4607329842931938,0.05074683281859801,660,I wouldn't sit on that bench if I were you. My aim has improved quite a bit.
1483,266,23,35,118,176,1.4602272727272727,0.05397257327457693,660,"Pre-war construction, park view, natural light, and under $3,000/month"
1709,267,17,46,111,174,1.4597701149425288,0.05064804632485907,660,Of course we'll take turns.
1874,268,16,53,116,185,1.4594594594594594,0.04785220893234334,660,"Yes, I am a millennial. Why do you ask?"
5675,269,15,49,108,172,1.4593023255813953,0.04972216985545755,660,"For a place like this, you either have to wait for someone to die or fly south."
4187,269,14,51,107,172,1.4593023255813953,0.04903360805743974,660,It's drafty but I really wanted a place on the upper east side.
2602,269,16,47,109,172,1.4593023255813953,0.050401325688312244,660,"Its a sublet, I've got it till spring"
140,269,21,37,114,172,1.4593023255813953,0.05366834179626834,660,"The meals are a little hard to swallow, but the rent is cheap cheap cheap."
3650,273,17,39,103,159,1.4591194968553458,0.05408416217142683,660,Priced out of Brooklyn.
4059,274,17,50,116,183,1.459016393442623,0.048838863427406995,660,You didn't believe me when I said that I was free as a bird.
4244,275,14,50,106,170,1.4588235294117646,0.049435295144787915,660,"It’s right in Central Park, and my roommate spends half the year traveling!"
1819,276,18,47,116,181,1.4585635359116023,0.04984297827891108,660,"Sorry, you'll want the other Mr. Finch, three Maples down."
4994,276,15,53,113,181,1.4585635359116023,0.04795998770951573,660,Chicks dig it.
5705,278,19,44,116,179,1.458100558659218,0.050865262622161865,660,"They really needed some couple time, so I said I’d watch the kids."
277,279,12,52,102,166,1.4578313253012047,0.04879146200317249,660,"What it lacks in privacy, it makes up for in location and price."
5354,279,14,48,104,166,1.4578313253012047,0.050265748424375346,660,Actually I do have a minute to talk about the environment.
3405,281,14,47,103,164,1.4573170731707317,0.050695159863492226,660,"""They offered to bring me back something nice if I kept it warm."
201,282,19,42,114,175,1.457142857142857,0.051712407771470785,660,"My parents were tree-huggers, and well...here I am!"
3586,282,15,50,110,175,1.457142857142857,0.04910648977025045,660,"The plumbing situation is rough, but it's rent-free and it picks up WiFi from the Panera!"
1377,284,20,39,114,173,1.4566473988439306,0.052790416281689116,660,It's the new tiny nest movement.
3967,284,15,49,109,173,1.4566473988439306,0.049505165140271805,660,A park view and no roommates...why would I turn it down?
1903,286,19,46,119,184,1.4565217391304348,0.0498429983113749,660,Thank you.  The Gummy Worms were very thoughtful.
203,287,13,42,94,149,1.4563758389261745,0.05343558744741862,660,I'll tweet you.
2245,288,16,41,103,160,1.45625,0.05308625575715871,660,Just got promoted to manager of the new branch office.
2362,289,17,44,110,171,1.456140350877193,0.051272440741794996,660,Dare you to sit on the bench.
2725,289,18,42,111,171,1.456140350877193,0.0519390279965392,660,I’ve had the place to myself ever since my roommate flew into a window.
3727,289,17,44,110,171,1.456140350877193,0.051272440741794996,660,"Actually, I’m an attorney at a top five law firm, but this is the only apartment I could afford."
5213,289,11,56,104,171,1.456140350877193,0.04707511531578505,660,Every winter I get the whole place to myself.
3621,293,17,49,116,182,1.456043956043956,0.04901691291230613,660,The realtor explained it as an open-concept loft with a great view of the park.
469,294,14,39,94,147,1.4557823129251701,0.05480482096994346,660,The owners went south
5424,294,12,43,92,147,1.4557823129251701,0.05307723128909842,660,I started tweeting and this seemed right!
5726,294,18,31,98,147,1.4557823129251701,0.0581061119161295,660,You told me to move out of the basement and spread my wings!
562,297,19,44,117,180,1.4555555555555555,0.05064587330738604,660,I said I had a little nest on Central Park West.
3746,298,29,29,133,191,1.455497382198953,0.05388508427906765,660,I just got laid
1074,299,21,50,131,202,1.4554455445544554,0.047627059315065744,660,"Don't Worry Fred, I'm just posing for a New Yorker cartoon contest."
3259,300,16,39,101,156,1.455128205128205,0.054067742881899125,660,They’re traveling and asked me to house-sit until they return in Spring.
3818,300,22,27,107,156,1.455128205128205,0.05847733523319875,660,"When I asked if you could make eggs, I meant breakfast."
48,302,15,46,106,167,1.4550898203592815,0.05075477271922511,660,"I have the place all to myself, my roommate's away until the spring."
81,302,17,42,108,167,1.4550898203592815,0.052156846986427766,660,"It's comfortable, it has a great view, it's free, and if I don't like the looks of somebody I can crap on them."
4868,304,18,44,114,176,1.4545454545454546,0.05084875831286206,660,The guest room is more of a guest bench.
3972,305,13,48,102,163,1.4539877300613497,0.050147441466256354,660,"As it turned out, 'pied-à-tree' wasn't a typo."""
4595,306,19,45,119,183,1.453551912568306,0.05002707225323772,660,"...and I'm singing better, too."
4739,306,21,41,121,183,1.453551912568306,0.05121334239224077,660,My psychiatrist said it helps with my empty nest syndrome.
848,308,16,46,110,172,1.4534883720930232,0.050371902272804775,660,"I finally realized, with free wifi I could live anywhere."
1937,308,15,48,109,172,1.4534883720930232,0.04969234430550286,660,It's actually bigger than my apartment.
208,310,17,39,105,161,1.453416149068323,0.05356130068995581,660,And I mate for life.
4684,310,15,43,103,161,1.453416149068323,0.05209158692624242,660,I’ve finally arrived. The Upper East Side with park views.
3439,312,22,38,121,181,1.4530386740331491,0.05222220454277668,660,"Your half would be $3,200 per month and we’d split utilities."
4335,312,21,40,120,181,1.4530386740331491,0.05163110780433218,660,"The rent is cheap, but you have to share a bathroom with the squirrel."
5243,314,17,38,104,159,1.4528301886792452,0.05405175010266245,660,It was advertised as a second floor climb-up.
40,315,20,51,130,201,1.4527363184079602,0.04726368159203981,660,This is the next Brooklyn.
1334,316,19,38,111,168,1.4523809523809523,0.053271584278889436,660,"It's all pretty simple, Dave: the mother targets my ex-wife's windshield and I keep her eggs warm."
792,317,19,47,122,188,1.452127659574468,0.04904630021406272,660,...and it's also roomier than the studio I had in East Village.
3358,317,14,57,117,188,1.452127659574468,0.04605532648362284,660,...and I get food delivered straight to my mouth.
5562,319,14,47,105,166,1.4518072289156627,0.05023292145235779,660,I'm amazed at all my new followers since I started tweeting from here.
5473,320,18,38,108,164,1.451219512195122,0.05353358324032581,660,Don’t sit there that’s my bathroom
49,321,14,50,109,173,1.4508670520231215,0.04878975209340395,660,"Can't say much for the food, but I am learning to sing...."
217,322,18,37,107,162,1.4506172839506173,0.054017685715407125,660,Can you believe I found a studio loft in this neighborhood?
2755,322,16,41,105,162,1.4506172839506173,0.0525789682082622,660,All the books say it's just a normal part of pregnancy...
2234,324,24,34,124,182,1.4505494505494505,0.05314895709518239,660,So it turns out I didn't have anything that sparked joy.
2077,325,12,53,106,171,1.4502923976608186,0.04776659129452376,660,"And, it has more room than my old apartment."
3754,325,19,39,113,171,1.4502923976608186,0.05256656153039587,660,It's off-the-grid but still only a short walk to Starbucks.
668,327,19,38,112,169,1.4497041420118344,0.05302304068331496,660,Just until the kids are out of the house.
967,328,23,38,126,187,1.4491978609625669,0.05150469482108598,660,Are you my mother?
2656,329,16,43,108,167,1.4491017964071857,0.05142699465402505,660,Easiest babysitting job ever.
2001,330,10,59,107,176,1.4488636363636365,0.04542003560106885,660,I figure the homeowner won't be back until spring at the earliest.
2821,331,19,49,126,194,1.4484536082474226,0.04792152794091757,660,When they said AIR bnb they really meant it!
676,332,22,34,118,174,1.4482758620689655,0.05377098605092096,660,I got laid!
941,332,13,52,109,174,1.4482758620689655,0.04788895518165778,660,It was this or move back in with my parents.
2131,334,19,44,120,183,1.4480874316939891,0.0499975471088397,660,You have your cave; I have my nest.
3099,334,22,38,123,183,1.4480874316939891,0.051767774126689786,660,I found it on Aeriebnb.
4504,336,20,29,105,154,1.448051948051948,0.057567332536940664,660,Sorry my body confused you but I identify as a bird.
1544,337,17,52,123,192,1.4479166666666667,0.047136354491793625,660,We’ll call it... ‘Airbnb’
1311,338,16,58,127,201,1.4477611940298507,0.04508187480852562,660,"After taxes this year, I realized this is as close to a nest egg as I'll ever get."
4678,339,15,47,110,172,1.447674418604651,0.04965852035999329,660,Starter apartment. Under $250K and Central Park views!
2851,340,16,49,116,181,1.4475138121546962,0.048536399868550247,660,$25 a night in Central Park? I *love* Airbnb!
3901,340,18,45,118,181,1.4475138121546962,0.049785106413563804,660,I finally found a loft above Central Park!
2559,342,19,51,129,199,1.4472361809045227,0.04704235965959251,660,"Oh, I don't own it.  I'm just housesitting for some empty-nesters."
373,343,12,48,101,161,1.4472049689440993,0.049767020183876104,660,"My roommates are snowbirds, so I've got the whole place to myself!"
541,343,19,34,108,161,1.4472049689440993,0.054956660732361606,660,I identify as a squirrel!
4785,343,14,44,103,161,1.4472049689440993,0.0513033702702651,660,I'm transitioning to avian.
3574,346,20,40,119,179,1.446927374301676,0.051420659051204756,660,"Ya, well, your profile doesn't mention you wear long coats."
2233,347,14,35,92,141,1.446808510638298,0.05642645186075485,660,I don't understand people who say New York isn't affordable.
4089,348,15,45,108,168,1.4464285714285714,0.05048872113403122,660,It's actually more spacious than my old place on the Lower East Side.
3094,349,19,45,122,186,1.446236559139785,0.049396934344950905,660,"It's the most affordable sublet I could find, but I have to be out by spring."
4255,350,18,38,110,166,1.4457831325301205,0.05302532277622512,660,The square footage is about the same but I am losing the condo fees.
5625,350,16,42,108,166,1.4457831325301205,0.05162989594476528,660,The listing said it has a bird's eye view of the Park.
1402,352,17,44,114,175,1.4457142857142857,0.05036297989904408,660,I accumulated a tidy little nest egg and retired early.
3570,352,18,42,115,175,1.4457142857142857,0.051010892849501346,660,It's a 1 bed 0 bath loft within walking distance of Central Park.
4804,354,22,46,134,202,1.4455445544554455,0.04809073030675066,660,It's all I can afford after my student loan payments.
2384,355,14,41,100,155,1.4451612903225806,0.05269600869648962,660,Is this a good time to tell you that I'm pregnant?
3538,355,18,33,104,155,1.4451612903225806,0.05578546454755043,660,I thought “aerie bnb” was a typo
4451,357,18,37,109,164,1.4451219512195121,0.053497353577341804,660,"Airbnb.
Why do you ask?"
2403,358,19,39,115,173,1.4450867052023122,0.05208656196632845,660,Only $1000/mo for a place overlooking the park -- I couldn't be happier!
2676,359,17,47,118,182,1.445054945054945,0.04895562472270629,660,"If it's a boy, Robin and if it's a girl Robyn."
5103,360,10,48,95,153,1.4444444444444444,0.04984400233777272,660,Got a great deal from a couple of empty nesters
4291,360,20,40,120,180,1.4444444444444444,0.051194437245227216,660,"Technically it's a studio apartment, but I've been told the whole tree is mine."
1982,360,14,44,104,162,1.4444444444444444,0.05106037629563537,660,The Airbnb listing said it had an unreal view of Central Park
4217,360,12,48,102,162,1.4444444444444444,0.049535841117809135,660,I read a few books about decluttering my life and this just made sense Bob.
3683,364,17,49,121,187,1.4438502673796791,0.0480067977570498,660,CHEAP!
4552,365,21,37,120,178,1.4438202247191012,0.05222717050681391,660,It's an air bnb with a Central Park view.
617,366,12,51,106,169,1.4437869822485208,0.04811023619887867,660,I'm housesitting until the owners return from down south.
3481,366,11,53,105,169,1.4437869822485208,0.04737248620219557,660,It's actually a Wi-Fi hotspot.
4118,366,15,45,109,169,1.4437869822485208,0.05025855112830008,660,Why the disappointed look? my profile said Upper Eastside with a park view”.
1429,369,17,44,115,176,1.4431818181818181,0.05014000469523565,660,It's quite cozy actually . . . since the wife and kids migrated.
5450,369,17,44,115,176,1.4431818181818181,0.05014000469523565,660,My dad said I needed to branch out.
822,371,13,51,110,174,1.4425287356321839,0.047851065977597695,660,"So I got this part time egg sitting gig. Gives me time off for auditions, and pays more than dog walking"
3849,371,13,51,110,174,1.4425287356321839,0.047851065977597695,660,"Dad, I'm not quite ready to leave the nest."
2748,373,16,52,122,190,1.4421052631578948,0.04686292360572472,660,It's called urban nesting.
5554,374,12,52,108,172,1.441860465116279,0.04752067436835883,660,"Crazy, right ... who flies back from Florida in the dead of winter?!"
129,375,13,42,99,154,1.4415584415584415,0.05210696346011032,660,It's not my patents' basement and it comes with several small meals throughout the day.
4554,375,14,40,100,154,1.4415584415584415,0.05291519705015645,660,Wait until you see my mating dance.
2779,377,14,55,119,188,1.4414893617021276,0.045989575395082825,660,"Thanks, but Mom should be back soon with lunch."
4323,378,14,47,109,170,1.4411764705882353,0.04932956881436479,660,"The Airbnb listing said it was snug, with a view of the park."
5132,378,14,47,109,170,1.4411764705882353,0.04932956881436479,660,"The park view is an upgrade, and honestly, the plumbing isn’t any worse than my old place in Queens."
5286,380,18,35,108,161,1.4409937888198758,0.0542056703395858,660,OK. But we'd better make it your place.
2967,381,15,48,114,177,1.4406779661016949,0.04861563193924038,660,I am pretty sure that I am safe from gentrification here.
3323,382,17,36,106,159,1.440251572327044,0.05397295404381147,660,It’s reclaimed wood.
4822,383,14,53,117,184,1.440217391304348,0.046670566937385104,660,Hey Pal - Mama Bird could use a coffee & a scone over here.
3256,384,21,46,133,200,1.44,0.0478901590797464,660,"No, wise-ass, I'm not sitting on eggs.  But you're standing on dog poop."
2030,385,21,42,128,191,1.4397905759162304,0.04953840154283374,660,"Yes, it's very comfortable and the view is great.  If it weren't for the regurgitated food, I'd definitely give this place a five-star rating."
3090,386,18,37,111,166,1.4397590361445782,0.052985904137729446,660,"It's the LJUNGSKILE bed, but I lost the assembly instructions."
5646,387,18,40,115,173,1.439306358381503,0.05139952760936997,660,"Son, when I said “work on your nest egg”, this wasn’t quite what I had in mind..."
2956,388,14,44,106,164,1.4390243902439024,0.050580294080558065,660,It's only uncomfortable when the eagle returns.
3025,388,18,36,110,164,1.4390243902439024,0.05345683254388238,660,"You're gonna bring the ladder back, right?"
5109,390,15,45,111,171,1.4385964912280702,0.049803626468580615,660,It's just a sublet while the owners go south for the winter.
2085,391,13,38,95,146,1.4383561643835616,0.05409329293062161,660,Location;... Location; ...Location!
3767,391,13,38,95,146,1.4383561643835616,0.05409329293062161,660,"Alright, you’ve made your point. We’ll move to Jersey and get a bigger place."
3585,393,18,31,104,153,1.4379084967320261,0.05627930598392961,660,"I'm peeping, Tom."
5504,394,13,48,108,169,1.4378698224852071,0.04879414941559361,660,"I know, I know.. but we we'll be able to afford private school for the kids!"
3912,394,15,44,110,169,1.4378698224852071,0.05021706655571038,660,The hardest thing?  Sticking to the diet.
781,394,13,48,108,169,1.4378698224852071,0.04879414941559361,660,I told her I'd sit on them while she ran an errand. It's been three days now. I'm starting to get worried.
2463,394,15,44,110,169,1.4378698224852071,0.05021706655571038,660,It's an Airbnb owned by a couple who went south for the winter!
2806,398,15,51,119,185,1.4378378378378378,0.047106379827164875,660,I'm just house-sitting for a couple of snowbirds.
1911,399,14,42,104,160,1.4375,0.05146249473917752,660,Let's just say it's below market rate for a park view.
3154,399,16,45,115,176,1.4375,0.04944907520834984,660,"So, I said, ""Oh, yeah? If Donald Trump ever becomes President, I'll live in a tree. I've been here for over 2 years now."""
3472,401,15,50,118,183,1.4371584699453552,0.047462267739284136,660,"I was fired for Tweeting at my last job, but the new boss seems to be pretty lax about it."
4393,401,16,48,119,183,1.4371584699453552,0.0480907069955579,660,This can’t be the strangest thing you have seen in this city
5745,401,20,40,123,183,1.4371584699453552,0.05052636005929022,660,It's a Tree-bedroom no bathroom.
841,404,19,35,113,167,1.437125748502994,0.05341312835993386,660,Hey it’s Manhattan. I feel lucky that I found this for the night under $300.
1344,405,17,42,115,174,1.4367816091954022,0.0505121592363713,660,I never dreamed I'd find an aerie overlooking Central Park for just $4000 a month.
4191,406,15,39,104,158,1.4367088607594938,0.05268991427530116,660,I'll come down when America is great again.
5746,407,15,49,117,181,1.4364640883977902,0.047825437460418216,660,"So, I'm making $15.00 an hour and all I have to do is turn the eggs twice a day!"
348,407,14,51,116,181,1.4364640883977902,0.0471792869178344,660,It's technically a studio loft.
3700,407,22,35,124,181,1.4364640883977902,0.052124696140271265,660,I'm learning to tweet.
614,410,14,44,107,165,1.4363636363636363,0.05034317492677621,660,I’m housesitting for a friend while he’s south for the winter.
3947,410,15,42,108,165,1.4363636363636363,0.051071959936107594,660,"I'm taking a gap year, dad!"
5156,410,14,44,107,165,1.4363636363636363,0.05034317492677621,660,Park view and only five hundred a month.
4279,413,17,44,118,179,1.4357541899441342,0.04948138964470605,660,"Their Airbnb profile said, "" Central Park view, plenty of grub"""
3567,414,15,51,120,186,1.435483870967742,0.046911532131169206,660,"I can take the bench tonight, if you'd be more comfortable..."
4927,414,20,41,125,186,1.435483870967742,0.04991297467325225,660,Stand under the tree. I dare you.
5074,414,19,43,124,186,1.435483870967742,0.04932729874993076,660,"It’s prewar, and look at this hardwood!"
3267,417,17,50,126,193,1.4352331606217616,0.04688033634212581,660,I'm calling it 'Gentreefication'.
455,418,16,35,103,154,1.4350649350649352,0.05444765100739231,660,"Park views, walking distance to The Met, tons of outdoor space - and it's only $4850 a month!"
5172,419,20,37,120,177,1.4350282485875707,0.0517735109133222,660,I've taken the tiny houses trend to new heights.
2,420,16,48,120,184,1.434782608695652,0.04788760379826322,660,"Where else are you going to find a park view for $1,700 a month?"
681,420,20,40,124,184,1.434782608695652,0.050307143851641346,660,"It all started with my parents sitting in this tree, K-I-S-S-I-N-G."
3935,420,22,36,126,184,1.434782608695652,0.051474282753574005,660,I call it my little place on the beech.
5071,420,18,44,122,184,1.434782608695652,0.04911227606235109,660,"It’s not much, but it’s a chick magnet."
2530,424,24,35,132,191,1.4345549738219896,0.05114611931937955,660,"I only pay $3,000 a month, AND I have a view of the park!"
3491,424,21,41,129,191,1.4345549738219896,0.049503441480933254,660,"No, the question is, ""what are you doing DOWN THERE?"""
5362,424,15,53,123,191,1.4345549738219896,0.04604260106145319,660,Totally amicable. Beth got the gilded cage.
1961,427,17,39,112,168,1.4345238095238095,0.051799580424032945,660,They are artificial twigs from Ikea. Assembly was a snap.
5342,428,19,38,118,175,1.4342857142857144,0.051574323659124045,660,Welcome to the Upper Nest Side
994,428,17,42,116,175,1.4342857142857144,0.050284669342777845,660,Just keeping them warm until she gets back.
1675,428,18,40,117,175,1.4342857142857144,0.05093357847141994,660,I wouldn't stand there if I were you.
637,431,15,49,118,182,1.434065934065934,0.047622355571632295,660,This is what they don't tell you about unpaid internships.
4613,432,13,43,103,159,1.4339622641509433,0.05088837561068932,660,I sublet it from some snowbirds.
605,433,18,39,116,173,1.4335260115606936,0.051357937635756745,660,"Sure, there's no privacy, but I can tell everyone that I live in the city."
2137,433,19,37,117,173,1.4335260115606936,0.0520081829458016,660,The views are great but the rent is nuts.
3624,433,18,39,116,173,1.4335260115606936,0.051357937635756745,660,Easiest real estate transaction ever; did it all over tweets!
5525,433,9,57,107,173,1.4335260115606936,0.045085671139144405,660,"The listing read “Available immediately, previous owners relocated to warmer climate, cozy studio with great views of the park..."
802,437,13,39,98,150,1.4333333333333333,0.05302202207345211,660,Finally a walk up that I can afford
1837,438,13,51,114,178,1.4325842696629214,0.047031816075427654,660,"All I need is for you to co-sign, Dad."
4159,439,18,44,123,185,1.4324324324324325,0.04890258831104493,660,"But, Dad, it's, like, my first baby-sitting job!"
52,439,15,34,99,148,1.4324324324324325,0.055213705197201125,660,It's my tweet spot.
290,439,14,52,119,185,1.4324324324324325,0.046437544263209854,660,"Oh I’m just house sitting for the week, my tree is actually over there."
1229,442,17,42,117,176,1.4318181818181819,0.05005899707067022,660,I got it on Airbntree.
3562,442,17,42,117,176,1.4318181818181819,0.05005899707067022,660,"1 Bdrm CPW, hi flr, 360 views.  Walk up."
3846,444,13,53,117,183,1.4316939890710383,0.04613708620074068,660,"I’m usually gone in the evenings, so you’d have the place to yourself."
608,445,11,47,102,160,1.43125,0.049065059972070675,660,They said I couldn't sleep on the bench anymore.
2521,445,12,45,103,160,1.43125,0.049859767972425924,660,It's mine until Spring when the owners will be returning from Mexico.
974,447,16,40,111,167,1.4311377245508983,0.05130083452942935,660,"It's listed on airbnb as ""authentic tree nest experience""."
2048,447,16,40,111,167,1.4311377245508983,0.05130083452942935,660,...and I've got the place to myself until Spring.
5104,449,16,43,115,174,1.4310344827586208,0.04980608660071267,660,I know. I still can’t believe it’s rent controlled.
4913,449,12,51,111,174,1.4310344827586208,0.04706254551399207,660,I wanted a first floor climb-up with lots of natural light.
5439,449,14,47,113,174,1.4310344827586208,0.04845373800200695,660,"I know what you’re thinking, how could I afford a place in the city with a view."
445,452,17,44,120,181,1.430939226519337,0.049050762449259065,660,...and I don’t even have to chew my own food.
1731,453,9,69,124,202,1.4306930693069306,0.04078248698914617,660,It's an Upper East Side zip code.
1487,454,18,35,112,165,1.4303030303030304,0.053152114348697925,660,It's just a sub-let... The owners go south for the winter.
2249,454,12,47,106,165,1.4303030303030304,0.04880254378301108,660,"Not only do I save $$ on an apartment, but it's a great place to pick up chicks!!"
3161,454,14,43,108,165,1.4303030303030304,0.05029421377959393,660,This is where I hatch my best ideas.
4848,454,14,43,108,165,1.4303030303030304,0.05029421377959393,660,"Yup, my divorce is final today!"
3018,458,17,40,115,172,1.430232558139535,0.05088726920957333,660,My parents just said that it was time to leave THEIR nest.
4186,458,20,34,118,172,1.430232558139535,0.05285368989598215,660,Egg sitting is the new dog walking
818,460,16,45,118,179,1.4301675977653632,0.048799888637214656,660,"If you can get past the pre-chewed food, it's actually a pretty sweet gig."
5113,461,19,42,125,186,1.4301075268817205,0.049287689240315166,660,"Well, they want us off the streets."
4272,462,18,28,103,149,1.429530201342282,0.057342307015553894,660,We met on Timber.
5225,463,11,45,100,156,1.4294871794871795,0.04990659554116538,660,"Homeless maybe, but not treeless."
256,464,17,36,110,163,1.4294478527607362,0.05291568833013047,660,Just resting on my laurels.
5278,465,16,44,117,177,1.4293785310734464,0.04918677116698294,660,I hatch my best ideas up here.
5019,466,10,59,115,184,1.4293478260869565,0.043963715944472966,660,I don't think they'll be back until spring
5419,467,19,37,119,175,1.4285714285714286,0.05153064127664587,660,"The squirrels sublet it for peanuts."""
5394,467,12,42,100,154,1.4285714285714286,0.051178408630845613,660,"It’s a great gig. They come by to feed me every day, I pay no rent, and all I have to do is keep the eggs warm."
4574,467,10,43,94,147,1.4285714285714286,0.05108094442387969,660,The listing mentioned a feather bed.
4281,467,14,41,106,161,1.4285714285714286,0.051162181019157996,660,"First month's, last month's, and a bag of acorns."
3257,467,16,40,112,168,1.4285714285714286,0.0510590916124309,660,"Honey, I'll come back down after I finish tweeting."
5242,467,14,47,114,175,1.4285714285714286,0.0482389859493689,660,The owners were moving down to Florida so I bought it for a song.
2535,467,14,53,122,189,1.4285714285714286,0.04572385355238447,660,You’re in luck—it’s mating season.
2270,467,17,47,125,189,1.4285714285714286,0.04753454170042489,660,"It's a wonderful Bed and Breakfast, but don;t order the eggs!"
3074,467,22,25,114,161,1.4285714285714286,0.05690946124379891,660,I'm donating my eggs
2159,467,17,41,117,175,1.4285714285714286,0.050239865648693566,660,6 million people stream me on my nest cam.
579,467,16,40,112,168,1.4285714285714286,0.0510590916124309,660,"Eat your heart out, it's rent controlled."
4026,478,17,52,132,201,1.427860696517413,0.045494513391659025,660,You can rent one of theses for a song.
800,479,19,45,130,194,1.4278350515463918,0.047783433558773375,660,I like to tweet on location
5138,480,15,50,122,187,1.427807486631016,0.046675270817795114,660,You have your man cave. Now I have my nest.
4003,481,16,42,115,173,1.4277456647398843,0.04998548680657999,660,I call it my 'Marie Kondo condo'.
5321,481,15,44,114,173,1.4277456647398843,0.04930857487461074,660,Just house sitting - the owners are snowbirds and will be back in May.
3490,483,15,41,110,166,1.427710843373494,0.05078159827771626,660,I’m just not ready to leave the nest!
5252,483,16,39,111,166,1.427710843373494,0.05149553450316968,660,Go find your own empty nest.
4743,485,15,38,106,159,1.4276729559748427,0.052376922881568595,660,I hear a couple Maples on 59th are still available through AirB&B
5430,486,20,42,130,192,1.4270833333333333,0.04870127410825416,660,I'm up here on a lark.
1233,487,14,45,112,171,1.4269005847953216,0.04901375350529407,660,"Believe it or not, the most disturbing part of this is my singing."
4916,488,10,47,100,157,1.4267515923566878,0.04883404693249284,660,I'm tired of city life.  I've moved to the sticks.
5425,489,12,54,117,183,1.4262295081967213,0.045434740999429214,660,"2 stars. Park view, but a bit cramped and just eggs for breakfast."
3601,490,9,54,106,169,1.4260355029585798,0.04571118760353231,660,"I know Dad, I’m just not ready to leave the nest."
4097,491,14,41,107,162,1.4259259259259258,0.050914160968229726,660,Found it on AiryBnB.  Why?
3248,492,17,52,133,202,1.4257425742574257,0.04531825911243022,660,You said I had to branch out!
658,493,17,29,102,148,1.4256756756756757,0.056796906626474644,660,My parents dropped me off here when I told them that I wasn't ready to leave the nest yet.
1918,494,21,41,133,195,1.4256410256410257,0.048686635177761645,660,"Airbnb on Central Park, $30"
1968,495,13,51,117,181,1.425414364640884,0.046432949976752985,660,I’m in a different place now.
1090,496,16,42,116,174,1.4252873563218391,0.049758147260479446,660,I found it on Airbnb.  It includes breakfast.
4305,497,14,40,106,160,1.425,0.051357361851561284,660,I'm housesitting until the owner returns from South America.
2838,497,16,36,108,160,1.425,0.05286597507617464,660,"Actually most of my neighbors aren't birds anymore, they're people I went to college with"
3505,497,16,36,108,160,1.425,0.05286597507617464,660,The tiny house was too big.
1789,500,18,29,106,153,1.4248366013071896,0.05617433982606975,660,It wasn’t advertised on line. A little birdie told me.
3078,501,17,45,124,186,1.424731182795699,0.04805010358463378,660,Hardwood floors throughout.
12,502,16,44,119,179,1.4245810055865922,0.04875315748935335,660,Welcome to the Branch Office at Park Place.
4936,503,17,39,116,172,1.4244186046511629,0.05083868946655726,660,"The treetop views are what sold me.  Plus, my roommate goes south every winter."
5478,503,14,45,113,172,1.4244186046511629,0.048791126023734935,660,"Hey mister, got any bread?"
806,505,12,46,107,165,1.4242424242424243,0.04874744115672679,660,This beats living with my parents.
4205,506,19,43,129,191,1.4240837696335078,0.04829675839335137,660,She said I lacked the ambition to live on Central Park West.
533,507,14,50,120,184,1.423913043478261,0.04654069774878669,660,Monday I'm getting cable.
4258,508,17,38,115,170,1.423529411764706,0.05126519108875492,660,"It's small, but it overlooks the park and I get to tweet all day."
3236,508,12,48,110,170,1.423529411764706,0.04774988582180242,660,My parents always told me I would end up in a place overlooking the Park.
2624,508,14,44,112,170,1.423529411764706,0.04918616558081879,660,Nature-lover seeks roommate for lovely NY loft with plenty of natural light.
4381,511,14,41,108,163,1.4233128834355828,0.050668264305789044,660,Why are you down there?
5293,511,19,31,113,163,1.4233128834355828,0.05427683500312034,660,"Yes, this is the advertised cozy and affordable Mid-Town nest for rent!"
3986,513,14,38,104,156,1.4230769230769231,0.05227532692073865,660,I just love driving the bird watchers crazy.
1390,514,16,42,117,175,1.4228571428571428,0.0495326504676507,660,I’m house sitting while the owners are south for the winter.
3820,514,16,42,117,175,1.4228571428571428,0.0495326504676507,660,"It's just an Airbnb, the owners have a nest in Boca for the winter"
4020,514,14,46,115,175,1.4228571428571428,0.048188386281000084,660,Learning to fly was easier than living in a fifth floor walk-up
4472,514,13,48,114,175,1.4228571428571428,0.04750199077275696,660,I found something I can afford that isn’t a walk-up.
5519,518,12,47,109,168,1.4226190476190477,0.04813089258213534,660,It's for millennials without a nest egg.
5296,518,16,39,113,168,1.4226190476190477,0.05100712517356667,660,"If I migrate, they might not let me back in the country."
2429,518,17,37,114,168,1.4226190476190477,0.05170118778037513,660,Have you seen the tuition at NYU?
2324,518,14,43,111,168,1.4226190476190477,0.04958986609794863,660,"Yeah, I’m an empty nester. What’s your story?"
297,522,11,54,115,180,1.4222222222222223,0.045228954456891166,660,"Yes, it's probably an illegal sublet."
563,522,14,48,118,180,1.4222222222222223,0.04724275669937032,660,Who knew Fifth Avenue could be cheaper than the West Side?
3114,522,17,42,121,180,1.4222222222222223,0.04917415784584689,660,"Yep, Airbnb.  I can't wait to see what's for breakfast."
4679,522,16,44,120,180,1.4222222222222223,0.04853889732387291,660,Mom should be back any minute with breakfast
317,526,15,43,115,173,1.4219653179190752,0.04925733288679937,660,And can you believe it? - She waived the broker's fee!
4706,527,15,45,118,178,1.4213483146067416,0.04826675162075603,660,The ad called it a cozy rental with a view of Central Park.
5536,527,17,41,120,178,1.4213483146067416,0.0495644959235679,660,It was the only loft with a view of the park in my price range.
4592,529,17,38,116,171,1.4210526315789473,0.051024660841373075,660,Guess who's pregnant?
1847,529,15,42,114,171,1.4210526315789473,0.049658001518067006,660,"""What did I say, Fred? Location, Location, Location."
962,531,17,43,123,183,1.4207650273224044,0.04857950144467261,660,"I changed my mind, I want kids."
3476,532,13,48,115,176,1.4204545454545454,0.04729239101519275,660,"Just don't stand there, bring me mud and twigs."
3742,532,12,50,114,176,1.4204545454545454,0.04660080667755462,660,"Just tell mom I found a cozy nest with a park view, and not to worry."
2545,534,14,51,123,188,1.4202127659574468,0.045818180982422185,660,It's an air tree n tree.
5422,534,17,45,126,188,1.4202127659574468,0.04764423982857656,660,Well it’s better than living with you!
3020,536,10,51,108,169,1.4201183431952662,0.046416984022964194,660,Airbnb.  Central Park Views.  What more can you ask for?
4522,537,23,30,128,181,1.419889502762431,0.052584638369499614,660,"But when they hatch, we'll be splitting the rent four ways!"
748,538,13,47,114,174,1.4195402298850575,0.04765916519886831,660,My psychiatrist encouraged me to branch out!
4345,538,19,35,120,174,1.4195402298850575,0.051672435938173965,660,"Yes, but you can't beat the location."
5013,540,12,54,120,186,1.4193548387096775,0.04487391441282552,660,I think this air tree 'n tree thing could catch on.
1193,540,13,39,103,155,1.4193548387096775,0.051675705402628794,660,Can you believe it? Second floor overlooking Central Park for only $2200 a month!
76,540,12,54,120,186,1.4193548387096775,0.04487391441282552,660,It's not much smaller than my last place. And it has a great view of the park.
2558,540,14,50,122,186,1.4193548387096775,0.04615098560448292,660,They don't allow sleeping on park benches anymore.
1445,544,15,42,115,172,1.4186046511627908,0.04942910345194765,660,"It took me three interviews with the co-op board and an acorn basket, but finally, it’s mine!"
4206,544,15,42,115,172,1.4186046511627908,0.04942910345194765,660,I love it here in Brooklyn - a spectacular skyline view and only $2700 a month!
5009,544,13,46,113,172,1.4186046511627908,0.048033710621340084,660,Aren't you back a little early this year?
3260,547,16,45,123,184,1.4184782608695652,0.047750904750814595,660,My name’s Robin. What’s yours?
4106,547,16,45,123,184,1.4184782608695652,0.047750904750814595,660,I leased out my apartment 'till September. Then I'm flying the coop.
1374,549,20,42,134,196,1.4183673469387754,0.04790041713898164,660,"The L.L. Bean catalogue, page 32, and it comes in plaid too."
3285,549,22,38,136,196,1.4183673469387754,0.04898068200426406,660,the future of affordable housing in New York City
3600,549,15,52,129,196,1.4183673469387754,0.04508665926083314,660,"The ad said,"" reasonable rent, park views and huge bathroom""
I'm home!"
5692,552,18,28,107,153,1.4183006535947713,0.05611427100850462,660,"You see Philip, to birdwatch, you need to become the bird."
349,553,19,31,115,165,1.4181818181818182,0.053738800048497744,660,An apartment grows in Brooklyn.
641,554,14,46,117,177,1.4180790960451977,0.047761306127611175,660,The name's Partridge.  Yours?
874,554,18,38,121,177,1.4180790960451977,0.050378047843941835,660,Housekeeping is a breeze!
3111,556,12,42,104,158,1.4177215189873418,0.05016717185668834,660,Nothing special. How about you?
2046,557,14,43,113,170,1.4176470588235295,0.04912993733157306,660,"No finder's fee, no 2-months deposit, that's why."
2699,557,14,43,113,170,1.4176470588235295,0.04912993733157306,660,"Duh, they flew south for the winter and put the place on airbnb for a song"
2350,559,14,48,120,182,1.4175824175824177,0.04683658531005489,660,"Unfortunately, there's still an association fee."
5459,559,15,46,121,182,1.4175824175824177,0.04748029582259506,660,The free meal delivery is what really sold it for me.
1024,561,16,36,111,163,1.4171779141104295,0.05208371232418014,660,There’s nothing like living in the sticks.
2494,562,22,29,124,175,1.417142857142857,0.053313390594688814,660,Just make sure not to park your car underneath
5665,563,16,46,125,187,1.4171122994652405,0.047192845261018794,660,"I was going to use the bench, but then most people would just look down on me."
5557,563,14,50,123,187,1.4171122994652405,0.0459582705429093,660,"This is not what I meant when I said we should start preparing for empty nesting, Barbara."
65,565,15,45,120,180,1.4166666666666667,0.04784298237082759,660,Hi! I’m Robin.
280,565,8,54,106,168,1.4166666666666667,0.04500789357206484,660,It gets more natural light than my current apartment.
1264,565,13,49,118,180,1.4166666666666667,0.04652745930387499,660,Marie Kondo’s organizing tips have revolutionized my living quarters.
3310,565,12,51,117,180,1.4166666666666667,0.04585554735081629,660,"Mom and Dad flew south, so I have the place all to myself."
4124,565,14,52,126,192,1.4166666666666667,0.04512280444624048,660,"It said ""cosy 5th Ave 1br w/vu."""
5077,565,17,41,122,180,1.4166666666666667,0.04912328831620392,660,"The kids moved back home, and I miss my empty nest."""
343,571,16,45,124,185,1.4162162162162162,0.047545930342226504,660,I finally found a New York apartment I could afford.
3216,572,15,37,109,161,1.4161490683229814,0.05179915690575983,660,Airbnb guarantees the residents will be gone all winter.
5275,573,9,44,96,149,1.4161073825503356,0.04957708970292527,660,"Don’t worry, I won’t Tweet."
1897,574,19,46,137,202,1.4158415841584158,0.0463082991672368,660,"It took forever, but I'm finally an empty nester."
5373,575,12,50,116,178,1.4157303370786516,0.04619597682150584,660,"I swore I'd never live in a walk-up, but the view really sells it"
3332,576,19,31,116,166,1.4156626506024097,0.053473464058987466,660,How do you want your eggs?
1130,577,18,45,132,195,1.4153846153846155,0.04694016927159791,660,"The realtor said it was ""Central Park adjacent."""
1178,577,21,39,135,195,1.4153846153846155,0.04860024458335459,660,There's no kitchen but it's actually bigger than my old apartment.
1273,579,16,44,123,183,1.4153005464480874,0.04790612331792743,660,I am sitting on a pretty nice nest egg myself!
871,580,14,43,114,171,1.4152046783625731,0.04890281138838091,660,I misread condo for condor.
1210,580,16,39,116,171,1.4152046783625731,0.050289997622751624,660,Well some pickles and ice cream would be lovely.
3808,580,15,41,115,171,1.4152046783625731,0.049601254130233044,660,It was advertised as a one room walk up.
4221,580,12,47,112,171,1.4152046783625731,0.047475109925925935,660,"Down there, vagrancy. Up here, instinct."
1715,584,16,34,109,159,1.4150943396226414,0.05301354558638672,660,It's amazing what you can find on 'AirBnB.'
1365,585,14,55,131,200,1.415,0.04385763858567351,660,I’m egg sitting for crazy rich pigeons.
5683,586,11,56,121,188,1.4148936170212767,0.0438628258044432,660,It's roomier now that the kids have flown.
272,587,16,41,119,176,1.4147727272727273,0.049254702099054345,660,"They don't call it AIR bnb for nothing!"""
1883,587,11,51,114,176,1.4147727272727273,0.04584048815393728,660,"And the best part is, I don't have to share a bathroom anymore."
4707,587,14,45,117,176,1.4147727272727273,0.04791821729777161,660,It was the only thing I could find on the Upper East Side under a million dollars.
4847,587,17,39,120,176,1.4147727272727273,0.04990952558181307,660,I like the exposed stick.
5639,587,14,45,117,176,1.4147727272727273,0.04791821729777161,660,"No, it’s an air bnb."
1737,592,16,43,122,181,1.4143646408839778,0.048273650817188235,660,If there's one downside it's that they don't allow cats.
2439,592,17,41,123,181,1.4143646408839778,0.04890534446688676,660,I hope at least one of them will be a boy
2934,592,17,41,123,181,1.4143646408839778,0.04890534446688676,660,Did you tweet?
5076,592,17,41,123,181,1.4143646408839778,0.04890534446688676,660,"You know, this whole tiny home movement has really taken off."
3690,596,14,42,113,169,1.4142011834319526,0.04929980177495065,660,I swooped on it as soon as it came on the market.
2801,596,14,42,113,169,1.4142011834319526,0.04929980177495065,660,I'm brooding so you're on the bench tonight.
4867,598,14,49,123,186,1.413978494623656,0.046098480658634935,660,It was the obvious progression after my 'tiny house' phase.
3194,599,13,46,115,174,1.4137931034482758,0.047601043021994235,660,Yes sir— this is the Upper West Side branch.
657,600,17,33,112,162,1.4135802469135803,0.053009325880924524,660,Just missed him. He left for the winter.
1728,600,17,33,112,162,1.4135802469135803,0.053009325880924524,660,I actually got it at Ikea.
2132,600,16,35,111,162,1.4135802469135803,0.052281042398258745,660,"You're taking this name change a bit far, Robin."
3847,603,16,42,121,179,1.4134078212290502,0.04864874932260608,660,I found it on Air-B-In-Tree.
5627,604,13,36,101,150,1.4133333333333333,0.05282757962728048,660,"It’s $1,000 per month with an unobstructed park view."
425,605,16,37,114,167,1.4131736526946108,0.05113636104542334,660,"It's a rent-controlled high-rise with a nest egg, Dad."
3689,606,14,48,122,184,1.4130434782608696,0.046436540890698354,660,The rent is a little lower because it's only park-adjacent.
4436,607,13,45,114,172,1.4127906976744187,0.0479740017486055,660,"Technically, I’m not homeless."
2868,607,17,37,118,172,1.4127906976744187,0.05072970202743765,660,It's an Aerie bnb!
5332,609,11,56,122,189,1.4126984126984128,0.043685319924404255,660,"Sure the bathroom situation isn't great...but open concept on the upper west side, what more could you ask for?"
5517,609,17,44,128,189,1.4126984126984128,0.04739336365860322,660,What? You’ve never spotted a 'trendy-hatted urban warbler' before
784,611,18,30,112,160,1.4125,0.05421502437447139,660,I’ll be down as soon as they hatch
1166,612,16,41,120,177,1.4124293785310735,0.04903166571366286,660,It puts the air in bnb.
1907,613,11,46,108,165,1.412121212121212,0.0478571713905216,660,Actually more space than my last place.
2300,614,12,51,119,182,1.4120879120879122,0.045465037059763694,660,Sure it's a loft.
2312,614,7,61,114,182,1.4120879120879122,0.04199411572316108,660,Should be any minute now. I'm just keeping the eggs warm while she takes a break.
2380,616,19,44,136,199,1.4120603015075377,0.0467759209886386,660,. . . and that's how I was able to retire!
4397,617,12,46,112,170,1.411764705882353,0.04762967372648242,660,The bench got a little old after a while so I thought I'd branch out a bit.
3062,617,14,42,114,170,1.411764705882353,0.049069472259641485,660,"Would you be doll and get me a triple, venti, soy, no foam latte please?"
187,617,14,42,114,170,1.411764705882353,0.049069472259641485,660,"To be fair, the AirBnB listing did say it had a great view of the park"
2893,620,17,38,120,175,1.4114285714285715,0.05008273708176053,660,Great view and my mom brings me food.
5598,621,20,41,136,197,1.4111675126903553,0.04765706976257507,660,"I'm living tree-to-tree for now, but this summer, when I'm a full-time unpaid intern, they said I'll get the hammock."
3798,622,11,52,117,180,1.4111111111111112,0.0451144409273986,660,"The good news is, I no longer suffer from empty nest syndrome"
4160,622,11,52,117,180,1.4111111111111112,0.0451144409273986,660,The listing said 'View of Central Park'--may be a bit of a stretch once the foliage comes in
4551,624,12,52,121,185,1.4108108108108108,0.04495015465596457,660,It’s called the Tinier House Movement.
247,625,10,49,109,168,1.4107142857142858,0.04649870774536294,660,People are really impressed when I tell them I have a view of the park.
593,625,17,35,116,168,1.4107142857142858,0.05158615917081499,660,"If they wanted it empty, why'd they let me major in philosophy?"
4823,625,15,39,114,168,1.4107142857142858,0.05018525499723236,660,Can you believe it? Only two bags of birdseed a month for a studio in midtown.
4900,625,18,33,117,168,1.4107142857142858,0.052272534063563164,660,I inherited a nest egg!
1339,629,17,44,129,190,1.4105263157894736,0.047193277492687875,660,"In today's economy, I'm in no rush to leave the nest."
516,630,15,34,107,156,1.4102564102564104,0.05293049492449913,660,"Say what you will, but the rent is cheap, cheap, cheap."
401,630,15,34,107,156,1.4102564102564104,0.05293049492449913,660,I'm renting a room from some empty-nesters.
2666,632,16,41,121,178,1.4101123595505618,0.04881045392527687,660,My old life wasn't sparking joy.
178,633,15,52,133,200,1.41,0.04437732229042601,660,I just sent my last kid to college.  Give me a moment.
2073,634,17,41,125,183,1.4098360655737705,0.048474691179218994,660,"Yes, I am an odd bird."
5266,634,15,45,123,183,1.4098360655737705,0.047219669674473934,660,"Yup, fully off-grid. You should see where the toilet is."
915,636,14,31,99,144,1.4097222222222223,0.05523594446939628,660,You wanna get me a medium soy latte and a half pound of worms?
2004,637,20,28,118,166,1.4096385542168675,0.054092998736893,660,Go look at your car.
5671,637,15,38,113,166,1.4096385542168675,0.050605886631009525,660,Unforgettable trips start with Airbnb.
5603,639,16,45,127,188,1.4095744680851063,0.046940398500854394,660,Best way to pick up chicks.
2133,640,14,42,115,171,1.409356725146199,0.04884106798841088,660,Central Park view and only $2000 a month!
4265,641,13,53,127,193,1.4093264248704662,0.04428208163062665,660,"You call me 'homeless', but I prefer 'inhabitant' of a 6 branch conifer/river vu."
2809,642,15,42,119,176,1.4090909090909092,0.0485321738728696,660,"No, I don't think you are the father."
3465,643,17,40,124,181,1.408839779005525,0.0488498332748003,660,I've got hardwood flooring!
4069,643,18,38,125,181,1.408839779005525,0.04947417068714564,660,it has a view of the park and I got it for a song
5466,643,15,44,122,181,1.408839779005525,0.047576585654770555,660,"You forage, I hatch."
2329,646,16,33,110,159,1.4088050314465408,0.052947390855365546,660,Then I found this cute walkup right on Central Park
5636,646,10,45,104,159,1.4088050314465408,0.048226105202377675,660,The realtor says the furniture is all natural oak
287,648,15,37,112,164,1.4085365853658536,0.051035971498743726,660,I'm officially an Upper-Nest-Sider.
2981,648,12,43,109,164,1.4085365853658536,0.04878750136621954,660,Staycation
2716,650,15,48,128,191,1.4083769633507854,0.0458069910765412,660,"This isn't what I thought when you said you had a nice, little nest egg."
3954,651,24,21,124,169,1.4082840236686391,0.05593426458185826,660,Best $2.7 million I ever spent.
3095,651,9,51,109,169,1.4082840236686391,0.04551929571393912,660,I love human watching
1934,651,13,43,113,169,1.4082840236686391,0.04851572729364963,660,Worms?  Hell no.  Zabar's delivers here.
1062,651,15,39,115,169,1.4082840236686391,0.049946576970811035,660,That's when Harold realized he couldn't ignore the issue of gentrification any longer.
1518,655,10,40,97,147,1.4081632653061225,0.050857067768233524,660,Just waiting for Mom to get back with dinner.
2903,656,13,45,116,174,1.4080459770114941,0.04753883383735767,660,The only downside is I have to vacate when the owner returns this spring.
4180,656,14,43,117,174,1.4080459770114941,0.04823257706852477,660,Fight or flight were my only two options.
2372,658,13,56,132,201,1.407960199004975,0.043062855738074425,660,The roommates are vacationing in Florida and I’ve got the whole place to myself.
3238,659,13,36,103,152,1.4078947368421053,0.052270897280421856,660,I'm taking a gap year before I spread my wings.
4051,660,10,53,116,179,1.4078212290502794,0.0445473436932153,660,You get great twitter reception up here
5219,660,17,39,123,179,1.4078212290502794,0.049232720020191655,660,The previous owners took off to Florida.
650,662,18,39,127,184,1.4076086956521738,0.04887342974956914,660,I couldn't afford to fly South.
5087,663,18,41,130,189,1.4074074074074074,0.047930734724603165,660,It was listed on Airbnb as fully air conditioned with great view.
4827,663,10,46,106,162,1.4074074074074074,0.04760626569756676,660,"Just the sweetest little sublet - owners are snowbirds, south for the winter."
1973,663,14,38,110,162,1.4074074074074074,0.050725550544803606,660,"Joe, I did tell you my name was Robyn and
I lived on Central Park West!"
2281,663,12,42,108,162,1.4074074074074074,0.049190639413107584,660,"Can I have my phone, I want to tweet someone."
3805,663,15,47,127,189,1.4074074074074074,0.0461355986224385,660,Are you willing to sit on them for a few hours so that I can go shower?
5531,668,15,49,130,194,1.407216494845361,0.04529868613936958,660,Be patient. In a few days I'll be able to tweet.
942,669,16,36,115,167,1.407185628742515,0.051072960978420616,660,I’m warming the eggs as a favor. Mother robin is over there on the windowsill watching “Game of Thrones.”
3065,669,14,40,113,167,1.407185628742515,0.049640282123672844,660,I sublet it from a couple of snowbirds over the winter.
4909,671,13,44,115,172,1.4069767441860466,0.04791009273442624,660,"The listing did say it had a ""bird's eye view"" of the Park."
453,671,12,46,114,172,1.4069767441860466,0.04719510069718011,660,It was a new listing on Airbnb.
3081,673,15,42,120,177,1.4067796610169492,0.048312518012675346,660,It just seemed like the obvious answer when my therapist  said I was suffering from Empty Nest syndrome.
330,673,14,44,119,177,1.4067796610169492,0.04764344720249893,660,"I don't care if you are from the Audubon society, I'm not moving."
448,673,13,46,118,177,1.4067796610169492,0.04696484563957948,660,"People just think I'm a hipster, not homeless!"
3461,676,12,50,120,182,1.4065934065934067,0.045404464707104665,660,You were right Dad! I do feel a real sense of accomplishment in my own place.
4264,676,17,40,125,182,1.4065934065934067,0.048632594572099015,660,The pigeons act like they own the place.
685,678,12,52,123,187,1.4064171122994653,0.044575928283770605,660,It's really spacious now that the kids are at college.
698,679,16,33,111,160,1.40625,0.05267742929000782,660,Finally found a rental I can afford.
4635,679,18,42,132,192,1.40625,0.04737678632198424,660,The ground floor is still available.
4796,681,20,40,137,197,1.4060913705583757,0.04760738959295099,660,"That's not what I meant when I said ""build a nest egg""."
1160,682,14,39,112,165,1.406060606060606,0.05005316441613571,660,It's a sublet until the Swallows return from Capistrano.
1720,682,14,39,112,165,1.406060606060606,0.05005316441613571,660,Dad... I found a place to stay and people feed me. What do you think?
3812,682,13,41,111,165,1.406060606060606,0.049309324047905216,660,I’m glad I got in when I did. I’ll be priced out of the market come Spring.
4949,685,16,37,117,170,1.4058823529411764,0.050405290099339445,660,"So, this is your airy, spacious apartment with a panoramic view of the city."
4723,685,9,51,110,170,1.4058823529411764,0.0453144321389844,660,It's month to month until the spring migration.
3361,685,11,47,112,170,1.4058823529411764,0.0468254743556024,660,The Airbnb listing said ‘rustic perch with access to the park.’ I’ve already contacted the host about a hair dryer.
487,685,15,39,116,170,1.4058823529411764,0.0497099549962006,660,I always wanted to live on a beech!
1285,685,16,37,117,170,1.4058823529411764,0.050405290099339445,660,A tree house grows in Brooklyn.
1558,685,19,31,120,170,1.4058823529411764,0.05243600101858837,660,My mom is actually getting me food right now!
4128,691,12,47,116,175,1.4057142857142857,0.046624759173177925,660,"I started in ornithology, then branched into architecture."
3006,692,17,39,124,180,1.4055555555555554,0.04901083769113703,660,"It was easy, I found it on Air Tree & Tree"
3940,692,13,47,120,180,1.4055555555555554,0.04640871928273635,660,Keep walking mister. I’m waiting for a cute firefighter to rescue me.
1822,694,15,47,128,190,1.4052631578947368,0.04594220360305879,660,You must be the downstairs tenant!
5644,695,16,32,110,158,1.4050632911392404,0.05315034959111755,660,"It's rent controlled, great part of the city, wonderful view and I can get Nestflix."
778,695,14,36,108,158,1.4050632911392404,0.051611126237383294,660,I think it's time we started a family.
2509,695,9,46,103,158,1.4050632911392404,0.04754555790054289,660,"You must be Jack. I'm ""Empty Nest on Central Park West."""
3997,698,19,28,116,163,1.4049079754601228,0.054096754953037486,660,I figured I’d return the favor for what they did to my car.
5263,698,15,36,112,163,1.4049079754601228,0.05122008832765972,660,I’m just house sitting until the owners get back from South America.
5553,698,14,38,111,163,1.4049079754601228,0.05047531165088862,660,It was the one Airbnb option that fit my budget.
745,701,12,44,112,168,1.4047619047619047,0.047938761339419884,660,The ad said “a view of the park and rent controlled.”
1748,701,14,40,114,168,1.4047619047619047,0.04940340916998829,660,"That’s right, Bruce, I’m pregnant."
4751,701,12,44,112,168,1.4047619047619047,0.047938761339419884,660,"Cheap, cheap cheap cheap"
3568,704,15,42,121,178,1.404494382022472,0.04809465730088342,660,This is not what I meant when I said you should go out on a limb
2021,704,11,50,117,178,1.404494382022472,0.045378146421093155,660,"Pre-war, 5 branch layout with great park access."
3298,706,14,48,126,188,1.4042553191489362,0.04565442890473622,660,The rent is cheap-cheap.
1134,707,10,58,125,193,1.4041450777202074,0.04235507009693445,660,"Believe it or not, my financial advisor suggested this."
1627,708,12,35,99,146,1.404109589041096,0.05286212324528574,660,When was the last time you saw an unhappy squirrel? Think about it.
3817,708,13,33,100,146,1.404109589041096,0.053748277975106694,660,"Next week, I fly to Florida."
24,710,10,41,100,151,1.403973509933775,0.04988180993317363,660,I promised her I'd stay until she came back.
721,710,15,31,105,151,1.403973509933775,0.05412666686543721,660,"Hey, it’s free. And I get to crap on people."
1578,712,13,37,106,156,1.4038461538461537,0.05126912574907167,660,"I am just following my psychiatrist's advice. I am relaxing, getting some fresh air and taking a birds eye view of life around me."
4433,712,11,41,104,156,1.4038461538461537,0.04962960087686117,660,"Yes, Carl left me a comfortable nest egg."
696,714,16,33,112,161,1.4037267080745341,0.0524099953036745,660,"Can you believe it? This close to Central Park and only $599,900!"
5140,714,10,45,106,161,1.4037267080745341,0.04775949223363261,660,"Nope, I'm not coming down.  I'm happy as a lark up here."
3351,716,13,45,118,176,1.4034090909090908,0.047110658121264394,660,"So, yeah, I'm sitting on a pretty tidy nest egg."
4643,716,12,47,117,176,1.4034090909090908,0.04641636611889808,660,"Yeah, Dad. This time I've moved out for good."
5279,718,18,37,126,181,1.4033149171270718,0.0494158669060727,660,I won the affordable housing lottery for a place near the park.
1658,718,11,51,119,181,1.4033149171270718,0.0448577353713209,660,"Just listed, a cozy loft in a great location, perfect for outdoor entertaining."
5534,718,15,43,123,181,1.4033149171270718,0.047515953525774784,660,It's an Airbnb.
2330,721,17,41,128,186,1.403225806451613,0.04784154331709032,660,"It's triple what I'd pay in Queens, but so worth it."
3159,722,14,36,109,159,1.4025157232704402,0.05134873599330073,660,"Well, they wanted to get us homeless people off the street."
77,723,15,36,113,164,1.4024390243902438,0.0509666488633309,660,Retiring in New York is more affordable than you think.
4878,723,13,40,111,164,1.4024390243902438,0.04947692288515522,660,"The bed is comfy, but the breakfast takes some getting used to."
556,725,15,38,116,169,1.4023668639053255,0.04987976994947613,660,The Branch Manager promotion came with a housing allowance.
1638,725,14,40,115,169,1.4023668639053255,0.04916857809697141,660,I sublet it for a song while they're south for the winter.
2689,725,14,40,115,169,1.4023668639053255,0.04916857809697141,660,Second floor walkup. Park view.
1794,728,19,32,123,174,1.4022988505747127,0.051500338962837525,660,"PLUS the schools round here are great"""
2420,728,16,38,120,174,1.4022988505747127,0.04952739251284409,660,I'm egg-sitting in exchange for a place to stay.
2686,728,18,34,122,174,1.4022988505747127,0.05085119610424008,660,It's the only place I know where my nest-egg is safe.
5658,731,18,38,128,184,1.4021739130434783,0.048815602104996365,660,I've come to the conclusion I shouldn't drink at brunch.
1177,732,11,54,124,189,1.402116402116402,0.04356585365414348,660,"My therapist said one day I'd feel the urge to nest.
 I guess today was the day."
5264,733,14,50,130,194,1.402061855670103,0.044648193993752944,660,"Well, yeah, it was pretty dodgy at first, with the squirrels all in an uproar about gentrification, but nothing beats the rent control""."
3083,734,14,54,136,204,1.4019607843137254,0.04313132735896074,660,The bench made it all work.
1187,735,12,33,97,142,1.4014084507042253,0.05387757273082423,660,I nabbed this place for a song.
2552,736,17,31,114,162,1.4012345679012346,0.052875215379630976,660,"You got a better way to meet firemen?"""
1219,737,13,41,113,167,1.401197604790419,0.04883749235341147,660,"Yeah, I'm still here.  I missed my flight."
436,738,11,47,114,172,1.4011627906976745,0.04639886712177673,660,Can you believe I’m only paying $1800 a month for this place?
3047,738,8,53,111,172,1.4011627906976745,0.044145854869639095,660,It’s a fixer upper.
3639,738,11,47,114,172,1.4011627906976745,0.04639886712177673,660,It’s aloft!
5258,738,10,49,113,172,1.4011627906976745,0.04566021697473569,660,"This isn’t what I meant when I told you to branch out more, Carol"
5488,738,14,41,117,172,1.4011627906976745,0.048547432869281044,660,The tiny house thing is so over.
5550,738,10,49,113,172,1.4011627906976745,0.04566021697473569,660,"Sorry, this tree is taken."
3449,744,13,45,119,177,1.4011299435028248,0.04689915240169089,660,How do you like your eggs?
3350,744,15,41,121,177,1.4011299435028248,0.04824865974068689,660,"It’s hard to heat, but it’s right on the park!"
370,746,15,43,124,182,1.401098901098901,0.04730608790504896,660,Show me anywhere else this close to the park for $2100 a month.
1266,746,16,41,125,182,1.401098901098901,0.047943495083017346,660,I got in early. It's going coop in the Spring.
2155,746,14,45,123,182,1.401098901098901,0.04665997412113654,660,Too broke to fly South
2834,749,14,47,126,187,1.4010695187165776,0.04578734037566287,660,What? This isn’t what you meant when you said I should start working on a nest egg?
5464,750,15,51,136,202,1.400990099009901,0.04397601624670818,660,The funny thing is my moving here made my parents empty-nesters.
886,751,19,45,143,207,1.4009661835748792,0.045355509530951965,660,Best pregnancy reveal ever- am I right?
5326,752,18,42,135,195,1.4,0.04678396195231429,660,How do you expect me to lay an egg while you are staring at me?
4920,752,18,40,132,190,1.4,0.04766914657832077,660,I'm house sitting till spring.
3499,752,13,48,124,185,1.4,0.045476973422088805,660,On the upper East Side it's all about the view.
3463,752,17,44,134,195,1.4,0.04621548443812294,660,It was empty!
2191,752,18,42,135,195,1.4,0.04678396195231429,660,...and the best part; it’s only 1200 dollars a month.
2002,752,18,32,120,170,1.4,0.05170264925641883,660,My realtor went out on a limb for me.
1890,752,15,38,117,170,1.4,0.049641948061185444,660,"Why, yes, I am ovulating."
1221,752,13,38,109,160,1.4,0.0503134826948056,660,Want to follow my tweets?
38,752,14,44,122,180,1.4,0.047008590416391605,660,"...and, best of all, it's in your price range!"
513,761,14,43,121,178,1.398876404494382,0.04736428063774108,660,Birds do it.
1211,761,16,39,123,178,1.398876404494382,0.04868608655938901,660,I figured this is a great way to meet chicks.
3022,761,15,41,122,178,1.398876404494382,0.048029730921581346,660,My building went coop.
4664,764,15,37,116,168,1.3988095238095237,0.05004979054433272,660,I got it through Airbirdnb.
1121,765,16,33,114,163,1.3987730061349692,0.05188259027426864,660,I'm subletting while the owner migrates South for the winter.
2522,766,14,35,109,158,1.3987341772151898,0.05153444355641805,660,At least they respond to my tweets.
5431,767,15,25,98,138,1.3985507246376812,0.05776237181450507,660,"Just ""tweet"" me when you have dinner ready."
4035,768,17,40,129,186,1.3978494623655915,0.047781086758410696,660,"Yes, I'm on the endangered species list--my wife's"
475,769,13,46,122,181,1.3977900552486189,0.04613985599563923,660,I owed a bird a favor.
897,770,15,40,121,176,1.3977272727272727,0.04840276466193369,660,Your tree or mine?
2065,771,17,34,120,171,1.3976608187134503,0.05077963355811091,660,I’ve decided to take my tweets to the next level.
2298,771,11,46,114,171,1.3976608187134503,0.046537882275299175,660,"My college admissions consultant suggested I need to have a ""unique and authentic"" experience."
4989,771,16,36,119,171,1.3976608187134503,0.05009762204627701,660,"Just looking forward to mating season, dude."
5068,771,10,48,113,171,1.3976608187134503,0.04579274000390457,660,I warned you that I wasn't like other girls you dated.
3980,775,12,42,112,166,1.3975903614457832,0.048247504516042025,660,Not until they hatch.
413,776,15,34,112,161,1.3975155279503106,0.05158926346122106,660,I find migrating is much easier than immigrating.
1369,776,11,42,108,161,1.3975155279503106,0.048486009304335394,660,Apparently this is a normal reaction in the first trimester
1040,778,15,49,135,199,1.3969849246231156,0.04438932799497002,660,Only $1500 a month and right by the park!
3919,779,13,51,130,194,1.3969072164948453,0.04398495365356216,660,"It's small, yes, but when you get a chance to live in Central Park Nest..."
3447,780,11,51,122,184,1.3967391304347827,0.04428561116578994,660,I've decided to downsize
5580,780,16,41,127,184,1.3967391304347827,0.04752050097105896,660,My nesting instinct finally kicked in.
2246,782,13,45,121,179,1.3966480446927374,0.046481225518942106,660,You should have seen it before I renovated.
895,783,17,35,122,174,1.396551724137931,0.05012704974384207,660,I sublet it from some pigeons who got a Condo in Manhattan.
2909,783,16,37,121,174,1.396551724137931,0.04945988625104529,660,"Yes, all new construction, hardwood floors, drenched in sunlight and views of the park!"
3325,783,17,35,122,174,1.396551724137931,0.05012704974384207,660,Bought it from an empty nester!
1703,786,12,43,114,169,1.3964497041420119,0.047640092318493484,660,It's my little nest on Central Park West.
2360,786,12,43,114,169,1.3964497041420119,0.047640092318493484,660,"Silly man, no I’m not homeless, I have a nest egg."
4109,786,14,39,116,169,1.3964497041420119,0.04909646781983357,660,They let me use it while they’re in Florida for the winter.
5501,789,5,55,104,164,1.396341463414634,0.04291742088754304,660,It's really not that bad... people have been tossing me chunks of bread all day.
1470,789,13,39,112,164,1.396341463414634,0.04940079562452821,660,"Cheep was a pun, not a typo."
1423,789,10,45,109,164,1.396341463414634,0.04707428715418532,660,"I picked it up from some empty nesters for less than $1,000/sq. ft.!"
2409,792,11,41,107,159,1.3962264150943395,0.048886061210701624,660,"John, didn’t you say you wanted to build a love nest?"
4102,792,14,35,110,159,1.3962264150943395,0.05127066869464928,660,It's really true what they say about nesting instincts in your 7th month.
1927,794,10,41,103,154,1.396103896103896,0.049114760202082865,660,"It's in our price range, and the view is fantastic!"
197,795,13,50,129,192,1.3958333333333333,0.0442840647253391,660,Upper West Side. Park view. Can you believe it?
5463,795,15,46,131,192,1.3958333333333333,0.0454989388033176,660,Great view of the of park...nice neighbors...low utilities. I can't complain.
3561,797,20,34,133,187,1.3957219251336899,0.04935224643369403,660,It's an Air Bird 'n' Bird.
4626,797,14,46,127,187,1.3957219251336899,0.045723497137100166,660,"Living near Central Park  AND, within my means! Can you make the same claim?"
2693,799,14,44,124,182,1.3956043956043955,0.04659379606991243,660,"‘No, I’m just housesitting till spring.’"
4741,800,17,36,124,177,1.3954802259887005,0.049495523920721,660,"With your brother's Netflix password, I think we can afford this."
5216,800,14,42,121,177,1.3954802259887005,0.0475100292782833,660,"Pop, if you let me have two million a year I can build these all over Manhattan."
5484,802,16,34,117,167,1.3952095808383234,0.050933203038893204,660,Late fall is the best time to buy.
3557,802,13,40,114,167,1.3952095808383234,0.04876224534537923,660,I can tweet better from up here.
2314,802,10,46,111,167,1.3952095808383234,0.04649002011663144,660,Real wood floors!
2715,802,18,30,119,167,1.3952095808383234,0.05233049689795197,660,"No more taxes or bills, and no more having to chew my own food."
527,806,12,40,110,162,1.3950617283950617,0.04903643640228667,660,It's all part of her 'New Green Deal'.
1007,807,9,44,104,157,1.394904458598726,0.047609833119381516,660,You can airb’n’b these things for a song in the off season.
2105,807,13,36,108,157,1.394904458598726,0.050924782561811544,660,"Oh, I’m just house sitting. The owners fly south for the winter."
4519,809,15,43,127,185,1.3945945945945946,0.046686504350217206,660,"So, I'm on a stool down at O'Malley's last night when she just flies right in and sweeps me off my feet."
5389,809,7,59,119,185,1.3945945945945946,0.04134724217887937,660,"Don't worry, they won't be back for at least a couple of months."
1392,811,21,29,130,180,1.3944444444444444,0.051360885385904075,660,You mean they never intended to cut this one down?
4566,812,10,47,113,170,1.3941176470588235,0.04592481546504075,660,"Sure, it's small, but there's no co-op board and the views are priceless."
5480,813,16,46,136,198,1.393939393939394,0.04508127513511808,660,Those time share guys are really persuasive.
2554,813,7,51,107,165,1.393939393939394,0.044420361232384166,660,"""Where else are you going to find something this cheap with a view of the park?"
1319,815,18,38,132,188,1.3936170212765957,0.047962330558685935,660,I was an empty nester until I discovered my family tree !
173,816,17,38,128,183,1.3934426229508197,0.04829157521701401,660,"Yep, the kids went off to college and it’s just me now."
3569,816,11,50,122,183,1.3934426229508197,0.044404738425959295,660,I dare you to park there.
4134,816,15,42,126,183,1.3934426229508197,0.047031667588831066,660,Free rent. Clean air. And I can sing anytime I want.
4235,816,13,46,124,183,1.3934426229508197,0.04573706675588285,660,"Nope, just house sitting for some snowbirds."
4629,816,9,54,120,183,1.3934426229508197,0.043031178393388755,660,"I’m normally in the doghouse, but I thought this would be more comfortable."
4985,821,7,45,98,150,1.3933333333333333,0.047200525787336786,660,It shouldn't be too much longer. I think I felt one of the eggs kick.
25,822,16,38,124,178,1.3932584269662922,0.04861828243492196,660,It's all the rage in Portland.
3671,822,11,48,119,178,1.3932584269662922,0.0452364623570166,660,The owner is in Florida for the winter.
4152,822,11,48,119,178,1.3932584269662922,0.0452364623570166,660,Just house-sitting while they're on vacation in the south
3053,825,15,38,120,173,1.393063583815029,0.04894081662661735,660,We'll start with K-I-S-S-I-N-G
4330,826,14,38,116,168,1.3928571428571428,0.04925718129533265,660,Rent's cheap and the chicks aren't bad.
245,826,15,36,117,168,1.3928571428571428,0.04997555310940521,660,The City is a lot less restrictive than my Homeowner's Association.
2425,828,12,40,111,163,1.392638036809816,0.04879490161737772,660,Thought I’d branch out for a while
4644,828,15,34,114,163,1.392638036809816,0.051070182200246374,660,I'm with Occupy Walltweet.
5498,828,15,34,114,163,1.392638036809816,0.051070182200246374,660,The owners are snow birds.
2136,831,18,48,148,214,1.3925233644859814,0.04369511698441514,660,Did you rent or buy?
1146,832,11,47,118,176,1.3920454545454546,0.045566015915103245,660,"Well,the ad said it had a bird's eye view of the park!"
157,833,15,37,119,171,1.391812865497076,0.04933285150648032,660,First prize from Tiny House Gazette.
1603,834,15,35,116,166,1.391566265060241,0.05039029588475551,660,My financial advisor told me to protect my next egg
5106,834,15,35,116,166,1.391566265060241,0.05039029588475551,660,"Yes, I know I'm early, but I didn't want to wait until May and all the good trees are taken."
5653,834,14,37,115,166,1.391566265060241,0.049660472905777124,660,"This is my family tree, that’s why."
957,837,15,42,127,184,1.391304347826087,0.046824211047438564,660,This is Fresh Airbnb.
500,837,16,31,114,161,1.391304347826087,0.05225795508662071,660,What can I say?  The rent is cheep-cheep!
1077,839,17,36,126,179,1.3910614525139664,0.04904002761731478,660,The rent here is cheap-cheap.
1760,839,15,40,124,179,1.3910614525139664,0.04774288335900173,660,I found it on Airbrd.
2195,839,18,34,127,179,1.3910614525139664,0.04967589966316536,660,"My grammar is fine. I'm laying, not lying."
1379,842,12,37,107,156,1.391025641025641,0.05028760784516313,660,I still have my pied a terre.
2163,842,11,39,106,156,1.391025641025641,0.04945837155477443,660,It's only temporary - I'm flying to Florida next week.
4694,842,16,29,111,156,1.391025641025641,0.05347612033930736,660,Nothing in my old place sparked joy!
430,845,11,46,117,174,1.3908045977011494,0.04590220477319572,660,..Then it hit me. I was already paying a lot more for about the same size and nowhere even close to downtown!
1771,845,16,36,122,174,1.3908045977011494,0.04938842215860702,660,"Park and skyline views, easy access, walk to everything, wake up to the sounds of birds, only $900/month, it sounded perfect."
5594,845,12,44,118,174,1.3908045977011494,0.04662030856928845,660,This is all that's left of our nest egg.
3482,848,11,37,103,151,1.390728476821192,0.0505803056838393,660,This unique Air B-n-B listing was just $45 a night!
2712,849,15,36,118,169,1.3905325443786982,0.04973331672047508,660,I stay here while the owners are down South
835,849,15,36,118,169,1.3905325443786982,0.04973331672047508,660,I'm taking my twitter account to a whole new level.
2634,849,15,36,118,169,1.3905325443786982,0.04973331672047508,660,Quiet open house today but we should get more interest in the spring.
2322,852,17,39,131,187,1.3903743315508021,0.04750780324332742,660,...and it'll be even more affordable once I get a roommate!
1685,853,15,34,115,164,1.3902439024390243,0.05081425505976652,660,I'll sit on the eggs. You go get some worms.
2611,853,12,40,112,164,1.3902439024390243,0.04855551894499016,660,Pregnancy test? Nah. Sometimes you just know.
3573,853,12,40,112,164,1.3902439024390243,0.04855551894499016,660,"Compared to Babysitting & Dogsitting, Eggsitting is a BREEZE!"
4201,856,15,41,126,182,1.39010989010989,0.04717191601665491,660,"Kids? No, they've flown."
4967,857,14,50,136,200,1.39,0.043577459481644536,660,"You should sit down, this is going to take awhile."
4276,857,11,56,133,200,1.39,0.04181197443352981,660,I'm housesitting for them until spring comes.
5546,859,16,37,124,177,1.3898305084745763,0.04877206048577863,660,"Son, it’s time to leave the nest"
2432,859,17,35,125,177,1.3898305084745763,0.049425855778289014,660,Tweet.
2729,859,10,49,118,177,1.3898305084745763,0.04464869395292312,660,"The square footage leaves something to be desired, but you can't beat the bird's-eye view."
495,862,13,50,132,195,1.3897435897435897,0.04374108788937347,660,It's hard to beat -- rent controlled AND park views!
549,863,14,39,119,172,1.3895348837209303,0.04840062803226184,660,Found it on Airtreenb
2538,863,11,45,116,172,1.3895348837209303,0.04624524219748789,660,Who says it’s too expensive to live in Manhattan?
3970,863,11,45,116,172,1.3895348837209303,0.04624524219748789,660,I have 3 million viewers of my webcam.
4301,863,11,45,116,172,1.3895348837209303,0.04624524219748789,660,The rent is ridiculous but you can't beat the view.
4469,863,15,37,120,172,1.3895348837209303,0.049098067680120795,660,It's an anniversary thing. I saved this tree in the '60s.
4471,863,13,41,118,172,1.3895348837209303,0.04769299044841934,660,"Sure she kicked me out, but look who gets the last laugh."
390,869,9,40,100,149,1.389261744966443,0.04921975048530217,660,"It was listed as a “quaint, move-in-ready, studio with a view”."
5682,870,12,41,114,167,1.3892215568862276,0.04793574460455058,660,I’m thinking outside - just not using a box.
3853,870,11,43,113,167,1.3892215568862276,0.04717722696280462,660,"No, it's a co-op."""
940,870,15,35,117,167,1.3892215568862276,0.05014249905490214,660,What can I say?  It sparks joy.
674,870,10,45,112,167,1.3892215568862276,0.04640631290037228,660,The best part? No robocalls!
2511,870,13,39,115,167,1.3892215568862276,0.048682445272247986,660,You should see where I park my car.
2475,875,16,40,129,185,1.3891891891891892,0.047244388738610116,660,"Sure, I thought of going south for the winter, but it turns out I can’t fly."
2580,875,15,42,128,185,1.3891891891891892,0.04661842833799116,660,"it's small but only $1,000/month and what a view."
209,877,15,33,114,162,1.3888888888888888,0.05124775445302227,660,That's when I realized it's not a diet; it's a lifestyle.
851,877,13,37,112,162,1.3888888888888888,0.04972896403781414,660,I met an eagle on Tinder.
1894,877,18,34,128,180,1.3888888888888888,0.04944690290235517,660,"Obviouslyy, I'm nesting."
5428,877,15,33,114,162,1.3888888888888888,0.05124775445302227,660,Airbnb is branching out.
3118,881,13,49,131,193,1.38860103626943,0.044035100629266646,660,It's the latest therapy for empty nest syndrome.
718,881,17,41,135,193,1.38860103626943,0.04642175731296444,660,It’s the original AirBnB
127,881,11,53,129,193,1.38860103626943,0.04279188422040534,660,"It has a low carbon footprint, great views of the park, and is surprisingly affordable."
1172,884,9,50,116,175,1.3885714285714286,0.044232978824285805,660,Now my tweets can be authentic.
3162,884,10,48,117,175,1.3885714285714286,0.044969299090173796,660,Are you looking for Mika? I'm subletting while she flies south for the winter.
14,886,11,39,107,157,1.3885350318471337,0.04920541385484286,660,"If you can't find a place on Fifth Avenue, it's only because you're not looking."
630,886,13,35,109,157,1.3885350318471337,0.0508378932223059,660,"Mom said you can stay for dinner, but you probably won't like it."
2032,888,10,34,95,139,1.3884892086330936,0.05257501442005063,660,"It's a metaphor, Petey."
4220,889,16,41,131,188,1.3882978723404256,0.04669478784559685,660,Well I used to sleep on the bench but the birds would always poop on me. Now the tables are turned.
4955,889,20,33,135,188,1.3882978723404256,0.049070972944146946,660,Feeling pretty good - just took a dump on some guy's Mercedes.
4932,891,7,52,111,170,1.388235294117647,0.043504851915735436,660,"Except for charging my phone, it's a pretty sweet nest."
4421,891,13,40,117,170,1.388235294117647,0.048066141990550225,660,"Call it what you might. But to me it's a high rise,comfortable, and cheap."
480,891,13,40,117,170,1.388235294117647,0.048066141990550225,660,I do miss  the family.  They've flown south for the winter.
496,891,11,44,115,170,1.388235294117647,0.04659535081214842,660,"No, it's not a love nest mister."
2334,895,15,41,127,183,1.3879781420765027,0.046961846191085184,660,"Cheap, cheap, cheap... cheap-cheap. CHEAP. cheap cheap."
3963,896,13,38,114,165,1.387878787878788,0.04907712890454762,660,It is a first floor climb up.
4312,896,10,44,111,165,1.387878787878788,0.04676360862349495,660,Airbnb...cozy retreat...city views.
5131,896,12,40,113,165,1.387878787878788,0.04831826519553649,660,My boss said don’t come back to work until you hatch some new ideas!
4142,899,11,40,109,160,1.3875,0.04855417450266476,660,And you told me I’d never find a 5th Avenue apartment for under $3000 a month!
384,899,10,42,108,160,1.3875,0.047737736743942556,660,My parents thought I'd never leave the nest.
2317,899,10,42,108,160,1.3875,0.047737736743942556,660,The tree is pre-war.
3309,902,19,36,136,191,1.387434554973822,0.04791889530441873,660,My kids wouldn't leave the nest so I had to find a new one
5144,903,12,43,118,173,1.3872832369942196,0.04675662215484491,660,"I know it’s a walk-up, but it’s rent stabilized."
4271,903,15,37,121,173,1.3872832369942196,0.04886534273601282,660,I'm just subletting until the owner flies back from Florida.
1091,903,16,35,122,173,1.3872832369942196,0.04954831032269102,660,Soon I'll be heading to Capistrano.
4025,903,17,33,123,173,1.3872832369942196,0.05022199110906873,660,It's a little squirrelly but I call it home.
1396,907,20,39,145,204,1.3872549019607843,0.04620403316798822,660,Don't worry; I only poop on Republicans.
1056,908,14,32,109,155,1.3870967741935485,0.05209245171114574,660,It's rent controlled with a great view of the park.
5713,909,9,47,112,168,1.3869047619047619,0.04540913967085192,660,It's a time share I have until spring.
30,910,10,50,121,181,1.3867403314917126,0.04394880133989585,660,And it's got a view of the park!
4468,910,13,44,124,181,1.3867403314917126,0.045996295522886754,660,It's a seasonal sublet.
4851,910,13,44,124,181,1.3867403314917126,0.045996295522886754,660,I read that it’s the new Brooklyn.
5381,913,12,34,104,150,1.3866666666666667,0.05162822413388333,660,Why didn’t you take me seriously when I said I was feeling broody ?
1831,914,11,41,111,163,1.3865030674846626,0.0479253387619797,660,"Rent is pretty good, but dogs keep using my bathroom."
17,914,15,33,115,163,1.3865030674846626,0.05098822946137899,660,The rent is *cheep* *cheep* *cheep*
2283,916,16,36,124,176,1.3863636363636365,0.04892588906719375,660,Finally found a reasonable Airbnb on the Upper West Side!
5199,916,16,36,124,176,1.3863636363636365,0.04892588906719375,660,"Surprisingly, this new lifestyle gets me a lot of chicks"
5195,918,12,49,128,189,1.3862433862433863,0.044004566966247924,660,"Yes, as a matter of fact, my name is Robin Finch."
5108,919,14,33,111,158,1.3860759493670887,0.051365835417697715,660,"$4,500 a month AND it has a view."
5714,920,10,46,115,171,1.3859649122807018,0.045629909121639105,660,This part is easy.  Flying south for the winter will be the real challenge!
943,921,10,51,123,184,1.3858695652173914,0.043461552384658354,660,"The relationship is over, Ted.  I don't need your apartment anymore."
1473,921,13,45,126,184,1.3858695652173914,0.0454653288717032,660,It's a rental.
3740,921,15,41,128,184,1.3858695652173914,0.04675349390042716,660,Sitting on these eggs is nothing compared to laying them.
4199,924,8,48,110,166,1.3855421686746987,0.044943395174373506,660,The ad said magnificent view of the park!
3283,925,15,39,125,179,1.3854748603351956,0.047669376181673696,660,"Yes, another package of worms and a venti latte, please."
3031,926,10,42,109,161,1.3850931677018634,0.04750131724329336,660,The reviews were spot on-open and airy
227,926,5,52,104,161,1.3850931677018634,0.043222406019147334,660,"When you said ""nesting"" I thought you meant something a bit more 'Crate and Barrel'"
1247,928,16,35,123,174,1.3850574712643677,0.04931298302853579,660,"Cozy one bedroom, great light, views of the park..."
1252,928,12,43,119,174,1.3850574712643677,0.046540382711700426,660,"It's fine for a bachelor, but I wouldn't raise a family here."
4619,928,16,35,123,174,1.3850574712643677,0.04931298302853579,660,Just baby sitting.
118,931,16,38,128,182,1.3846153846153846,0.04773954233676017,660,A studio loft finally opened up in the city - how could I say no?
1659,931,11,43,115,169,1.3846153846153846,0.04673022279184276,660,I'm a former branch manager seeking a higher position. Why do you ask?
3166,931,12,46,124,182,1.3846153846153846,0.04512441502050706,660,Another millennial refuses to leave the nest.
5392,931,15,30,111,156,1.3846153846153846,0.052608970340233714,660,It's all about the Marie Kondo method.
4817,935,13,47,130,190,1.3842105263157896,0.04445048984958668,660,"I miss having a doorman, but you can't beat the outdoor space"
5016,936,8,47,109,164,1.3841463414634145,0.04527617403283769,660,"Yeah, I was lucky to score a sublet; landlord's a little flighty, though."
638,936,13,37,114,164,1.3841463414634145,0.04923429120529702,660,I got a real bargain on a sublet. Owners gone south for the winter.
4050,938,12,34,105,151,1.3841059602649006,0.05134906483438445,660,It's part of the city's affordable housing program.  I also get a free can of worms every morning.
411,939,9,58,131,198,1.3838383838383839,0.040767731954696865,660,"It's a walk-up, but you can't beat the price."
3001,939,12,52,134,198,1.3838383838383839,0.04261256220386051,660,The rent is unbelievably cheep.
1028,941,11,49,125,185,1.3837837837837839,0.043949867067570175,660,"No rent, and a bird's eye view. I can see why you're jealous."
1852,941,16,39,130,185,1.3837837837837839,0.04717375168628797,660,"The kids moved back in, and I missed the empty nest."
3894,941,15,41,129,185,1.3837837837837839,0.0465468413705921,660,"Light, aerie, 1 bd., park view...I'll take it!"
5289,941,14,43,128,185,1.3837837837837839,0.045911371521645594,660,Be careful. People have been sliding off that bench all day.
1030,945,14,38,120,172,1.3837209302325582,0.04832092252084716,660,Hi. My name's Robin.
4350,945,9,48,115,172,1.3837209302325582,0.04466446320335614,660,The rent is pretty good for Central New York.
4535,947,13,35,111,159,1.3836477987421383,0.050314465408805034,660,"It's that nesting instinct, I finally gave in."
1245,948,10,36,100,146,1.3835616438356164,0.050748087144762484,660,"Don't worry, Honey. It's normal for an expectant mother to start nesting."
4514,949,9,51,120,180,1.3833333333333333,0.04335051943970357,660,Flying south wasn’t an option.
103,949,9,51,120,180,1.3833333333333333,0.04335051943970357,660,It's a sublet.
1571,951,12,40,115,167,1.3832335329341316,0.04785005237368278,660,"Did you ""find yourself"" yet, son?"
4963,951,12,40,115,167,1.3832335329341316,0.04785005237368278,660,"Airy park side residence.
Great Views.
A Must See."
2303,953,11,37,106,154,1.3831168831168832,0.04978354978354979,660,"Sorry, Frank, I can’t come home. I self-identify as a park pigeon now."
5417,953,12,35,107,154,1.3831168831168832,0.050628887671711635,660,"Sure, but I'm getting Manhattan for less than 800 a month."
1097,955,10,52,126,188,1.3829787234042554,0.042808427849027365,660,Its not much but it is rent controlled
5304,956,13,41,121,175,1.3828571428571428,0.04702951992930259,660,It's a branch of AirBNB.
1765,956,14,39,122,175,1.3828571428571428,0.047722711467104,660,It's the new Brooklyn.....
5421,956,16,35,124,175,1.3828571428571428,0.04907973186312288,660,It’s from Ikea’s Biomimicry section!
27,956,7,53,115,175,1.3828571428571428,0.042634341496379784,660,"The listing mentioned ""park views."""
98,956,17,33,125,175,1.3828571428571428,0.04974436173826969,660,"My apartment did not spark joy, 
so I got rid of it."
5474,961,16,30,116,162,1.382716049382716,0.0519062305003203,660,"I found a cheaper way to freeze my eggs, darling"
51,962,8,41,100,149,1.3825503355704698,0.04818237640836997,660,Can you believe it? I'm only paying twelve hundred a month!
1415,962,9,39,101,149,1.3825503355704698,0.049114520438715996,660,I'm just crashing here till they come back in Spring.
2093,962,10,37,102,149,1.3825503355704698,0.05002929981013382,660,Urban Nesting
2111,962,11,35,103,149,1.3825503355704698,0.05092765026053589,660,"The view is great, the rent is free, and I get fed 10 times a day."
5269,962,11,35,103,149,1.3825503355704698,0.05092765026053589,660,It got five stars on airbnb.
5456,967,10,50,123,183,1.3825136612021858,0.04356923110812124,660,"My youngest just left for college, you know how it is."
991,967,14,42,127,183,1.3825136612021858,0.04624364670807566,660,‘ My Grandfather  left me a nest egg’
5081,969,16,41,134,191,1.382198952879581,0.04609270865463714,660,Air B&B said it had a view of Central Park.
4859,969,12,49,130,191,1.382198952879581,0.043635895626802784,660,"I had to get my own place, my parents wanted to be empty nesters"
3274,969,16,41,134,191,1.382198952879581,0.04609270865463714,660,I suppose there are other ways to let you know that I’m expecting
47,972,7,46,104,157,1.3821656050955413,0.04566369749142547,660,You get the best views of central park and it's only 2150$ per month!
821,972,14,32,111,157,1.3821656050955413,0.0515440441747169,660,Airbnb
3549,972,13,34,110,157,1.3821656050955413,0.050745730584523654,660,Very cozy except for the egg
5515,972,11,38,108,157,1.3821656050955413,0.04911018772007337,660,"$89 Airbnb with a view of the Park, I'm not complaining."
4400,976,16,36,126,178,1.3820224719101124,0.048471354681493974,660,I'm a retired ornithologist...you?
5227,976,12,44,122,178,1.3820224719101124,0.045777203238991544,660,I got the whole place to myself. Mom and Dad are in Florida.
4461,978,12,52,135,199,1.3819095477386936,0.04244174023222756,660,Maybe it's the pregnancy talking - but I love it.
4289,979,10,43,112,165,1.3818181818181818,0.04667252149371692,660,"The park views are amazing, but it's the rent that keeps me from moving"
2451,979,14,35,116,165,1.3818181818181818,0.04973895437794237,660,It’s only until the Grossbeeks return in the Spring.
451,979,12,39,114,165,1.3818181818181818,0.048230114271026255,660,I'm subletting it from a snow bird.
420,979,11,41,113,165,1.3818181818181818,0.047457708463313514,660,"Brother, can you sparrow dime?"
1589,979,10,43,112,165,1.3818181818181818,0.04667252149371692,660,YOU try getting an affordable place right next to Central Park.
3726,984,13,45,128,186,1.381720430107527,0.04507020886875909,660,It’s convenient to the subway and only $2500 a month!
2340,985,6,46,100,152,1.381578947368421,0.04566824093282499,660,"You are welcome to come up, but please take off your shoes."
2764,985,11,36,105,152,1.381578947368421,0.05021235016011432,660,Then I noticed all the nests were free in the off-season!
4608,985,12,34,106,152,1.381578947368421,0.05107267845279518,660,"Yeah, but breakfest is included and you can't beat the view."
5549,985,11,36,105,152,1.381578947368421,0.05021235016011432,660,I dare you to find cheaper rent with this view.
270,989,9,48,116,173,1.3815028901734103,0.04446089722659308,660,"You laugh, but I won’t have to worry about the sea level."
3012,989,10,46,117,173,1.3815028901734103,0.045210449205016316,660,The restroom's right where you're standing
4695,991,18,33,130,181,1.3812154696132597,0.049147468735831194,660,Been living here rent-free since my landlord flew south for the winter.
4560,991,14,41,126,181,1.3812154696132597,0.046582445903144344,660,Found this place on Airbnb.
2053,991,15,39,127,181,1.3812154696132597,0.047236761325522764,660,"It may not be as big as a studio, but it’s got location, location, location."
1535,991,14,41,126,181,1.3812154696132597,0.046582445903144344,660,"And then I thought, ""$3500 a month for a studio, in Queens??"
936,991,12,45,124,181,1.3812154696132597,0.045245436873891515,660,I'm just subletting while the owner winters in Florida.
4430,996,16,45,141,202,1.381188118811881,0.044290963470416916,660,My waterfront home is under the bridge
826,997,9,46,113,168,1.380952380952381,0.045317940132534575,660,"Sure,  but I get to go south every winter."
2293,997,19,34,136,189,1.380952380952381,0.04820644133800967,660,My apartment didn't spark joy.
3402,997,15,42,132,189,1.380952380952381,0.04581169965364299,660,"Can you believe I only pay $1,500 a month...and with this view!?"
5718,997,15,34,119,168,1.380952380952381,0.04981397087599281,660,But it’s in central park.
3895,1001,13,41,122,176,1.3806818181818181,0.04681211346374087,660,TreeBnb
4167,1001,13,41,122,176,1.3806818181818181,0.04681211346374087,660,"Sure, she regurgitates in my mouth. But other than that, it's pretty cushy."
4557,1001,16,35,125,176,1.3806818181818181,0.04884853285153346,660,I'm subletting from empty nesters.
5337,1004,11,37,107,155,1.3806451612903226,0.04952304372107702,660,"When you said “I’m meeting a chick,” I didn’t think you meant it literally."
1707,1005,14,50,141,205,1.3804878048780487,0.04272014500868064,660,I got it through Aerie bnb.
2939,1006,9,52,123,184,1.3804347826086956,0.042691564141982746,660,It's a sublet until spring.
3593,1007,13,36,114,163,1.3803680981595092,0.049391195453951736,660,"As you can see, it's a cozy one-bedroom with great views of the park..."
4329,1007,14,34,115,163,1.3803680981595092,0.050152074238354216,660,"And the best part is the young ones leave the nest all by themselves!"""
1152,1009,14,37,120,171,1.3801169590643274,0.04846895589565221,660,I thought Nesting meant you were going to buy new pillows for the couch.
2859,1009,13,39,119,171,1.3801169590643274,0.04775395518708661,660,"Well, yes; my name IS Robin."
88,1011,15,46,139,200,1.38,0.04401918266177889,660,Retiring in New York is easier than you think.”
4715,1012,11,46,122,179,1.3798882681564246,0.044876747551744686,660,"I have my own nest now, Dad."
632,1013,15,30,113,158,1.379746835443038,0.05205414832221643,660,I'd rather sleep up here—that park bench is for the birds.
4821,1013,9,42,107,158,1.379746835443038,0.04717923724532458,660,A little extra cash house sitting while they've gone south!
3843,1015,13,45,129,187,1.3796791443850267,0.04487499512439912,660,"Yeah, I found it through Airbnb. It's a little drafty, but the view is fantastic."
2433,1015,16,39,132,187,1.3796791443850267,0.04675754705090584,660,Just house-sitting while the family winters in the Bahamas. Lucky ducks.
1162,1017,12,39,115,166,1.3795180722891567,0.0479938391468013,660,Couldn’t afford rent so tapped into my nest egg.
1421,1017,11,41,114,166,1.3795180722891567,0.04722699700299875,660,I reduced my carbon footprint.
1183,1019,13,40,121,174,1.3793103448275863,0.047165879609820965,660,"I tried, turns out you can't go out on a limb but you can hang out on one, Todd."
2705,1019,13,40,121,174,1.3793103448275863,0.047165879609820965,660,It was the cheapest place I could find in Manhattan.
3121,1019,12,42,120,174,1.3793103448275863,0.04645620982509062,660,Told you I was housesitting; the owners are flying back soon.
3858,1019,16,34,124,174,1.3793103448275863,0.04923355058833317,660,I Kondo’d my condo!
5681,1019,16,34,124,174,1.3793103448275863,0.04923355058833317,660,It’s built from rejection notices for my cartoons
3337,1024,14,41,127,182,1.379120879120879,0.046373119951565,660,And did I mention it's right on the park?
3403,1024,12,45,125,182,1.379120879120879,0.04504487449479751,660,I'm subletting while the leaseholder goes south for the winter.
2468,1024,16,37,129,182,1.379120879120879,0.04766436603829335,660,It was listed as a park view studio.
1336,1027,7,44,102,153,1.3790849673202614,0.04637396777443322,660,Joyce Kilmer was right.
3749,1027,10,38,105,153,1.3790849673202614,0.04907690722896751,660,I decided to take my birding to the next level.
234,1029,14,44,132,190,1.3789473684210527,0.04499939337865333,660,"My doctor called, we're going to need a bigger nest."
1895,1029,14,44,132,190,1.3789473684210527,0.04499939337865333,660,"Dad, I am working. It's the gig economy"
4306,1029,13,46,131,190,1.3789473684210527,0.04437623927182081,660,"It’s one of those new AirBNB ""Experiences"" for only $200 a night."
4553,1032,15,31,115,161,1.3788819875776397,0.05133625855533087,660,"Entertaining view, carbon neutral, and zero rent."
3320,1033,16,43,139,198,1.378787878787879,0.04488698630483059,660,It's the latest from IKEA.
3661,1034,12,40,117,169,1.378698224852071,0.047390080440945996,660,"Great view, affordable, and I get to fly south for the winter."
2828,1034,11,42,116,169,1.378698224852071,0.04664094066444894,660,"It's drafty, but rent-controlled."
5207,1034,9,46,114,169,1.378698224852071,0.0451053499021488,660,I just got approved by the squirrels on the co-op board.
2803,1037,13,52,141,206,1.3786407766990292,0.041992190397785595,660,We Avian-Americans do this all the time.
3971,1038,17,36,132,185,1.3783783783783783,0.04771928587298615,660,"Like the ad said,
‘high-rise/low maintenance’"
4602,1038,14,28,106,148,1.3783783783783783,0.053731340399351624,660,You looked taller on Tinder.
908,1040,10,39,107,156,1.3782051282051282,0.048418280832466645,660,I never understood why one flew over the cuckoo's nest.
1283,1040,13,33,110,156,1.3782051282051282,0.05091629284019001,660,". . . and it's only $4,000 a month."
2516,1042,10,42,112,164,1.3780487804878048,0.046804587865134036,660,"Just admit you're wrong, Dan!"
4788,1043,12,41,119,172,1.377906976744186,0.0468060685694805,660,I’m getting more followers on Twitter.
2667,1044,16,36,128,180,1.3777777777777778,0.04802463905406106,660,Tell Mom they actually treat me like one of their own
4944,1044,13,42,125,180,1.3777777777777778,0.04604504552045184,660,It's all reclaimed wood!
1307,1044,14,40,126,180,1.3777777777777778,0.04671423191503067,660,"One floor up, great view, and rent-controlled!"
1955,1044,11,46,123,180,1.3777777777777778,0.044676612719843765,660,I’m nesting. Why do you ask?
965,1048,9,36,98,143,1.3776223776223777,0.05041363018627635,660,"No thank you, Mr. Schwab. I'm protecting my own nest egg."
1236,1049,9,39,103,151,1.3774834437086092,0.048593208815481174,660,I thought by “nesting” you meant something like shopping for furniture at IKEA.
3158,1050,14,32,113,159,1.3773584905660377,0.051006309431916474,660,"It might be small, but it's wren controled."
4601,1050,8,44,107,159,1.3773584905660377,0.046086599206975165,660,"Because it's spring, silly."
5667,1050,12,36,111,159,1.3773584905660377,0.04942085197631052,660,"Finally!  Affordable housing, right here in New York City."
316,1053,11,41,115,167,1.377245508982036,0.04699832487921222,660,The tiny house movement is over -- I'm moving on.
1295,1053,12,39,116,167,1.377245508982036,0.04775968392216074,660,"I know it seems small, but where else can I get a one bedroom on the Park for less than two thousand per month?"
3477,1053,10,43,114,167,1.377245508982036,0.046224427249661595,660,That bench is for the birds.
758,1056,14,38,123,175,1.3771428571428572,0.047640061045022254,660,"Relax. Nesting does not always mean  
pregnant"
3438,1056,14,38,123,175,1.3771428571428572,0.047640061045022254,660,I offered to house-sit while the owners were away for the winter.
4915,1058,6,57,120,183,1.3770491803278688,0.040630799936528045,660,It’s built entirely from reclaimed wood!
3016,1058,11,47,125,183,1.3770491803278688,0.04417134937227653,660,It’s all oak!
2092,1060,9,57,133,199,1.3768844221105527,0.040532741210505104,660,I sublet it from some snowbirds 'til spring.
4139,1060,17,41,141,199,1.3768844221105527,0.045265592538564325,660,"I was going to migrate but, you know, the wall..."
1620,1062,10,35,101,146,1.3767123287671232,0.050636394945208656,660,It’s a seasonal rental. I have to vacate on April 1st.
2621,1063,13,35,114,162,1.376543209876543,0.04954778408423333,660,The Airbnb description was a room with a view.
3338,1063,15,31,116,162,1.376543209876543,0.05107196275708285,660,"She said she'd be back in about an hour, I'm just baby sitting."
5542,1063,18,25,119,162,1.376543209876543,0.053276534123058675,660,The listing highlighted a bird’s-eye view with plenty of chicks.
5712,1063,12,37,113,162,1.376543209876543,0.048767834394775826,660,"I’m subletting from a pair of snowbirds
in Tucson."
5005,1067,9,49,120,178,1.3764044943820224,0.043559670515986734,660,The police can't touch me. Audubon says I'm an endangered species.
5368,1068,18,34,134,186,1.3763440860215055,0.04811346959995193,660,It’s only $2200 a month! That’s why.
1586,1068,18,34,134,186,1.3763440860215055,0.04811346959995193,660,AvianTinyHouse.com
3981,1070,17,39,138,194,1.3762886597938144,0.046088068222171846,660,Wanna flock?
3868,1070,13,47,134,194,1.3762886597938144,0.04370865168866324,660,I never thought I’d find an affordable short term rental with a view of the park!
3326,1072,15,26,108,149,1.3758389261744965,0.05427198207188896,660,I think Marie Kondo would be proud of me.
2175,1073,15,32,118,165,1.3757575757575757,0.05038764377647361,660,"No rent and this large, feathered thing feeds me all the time."
2635,1073,15,32,118,165,1.3757575757575757,0.05038764377647361,660,The mother said she'll be back in 15 minutes.
2940,1073,9,44,112,165,1.3757575757575757,0.04577614734007717,660,It’s rent controlled with a park view!
3032,1073,14,34,117,165,1.3757575757575757,0.04964881484323074,660,"Well I say, what are you doing down there?"
1630,1077,12,41,120,173,1.3757225433526012,0.04658596938373756,660,"John, when I said you need to 'sit on your nest egg', this wasn't what I meant..."
4297,1077,14,37,122,173,1.3757225433526012,0.048007074621079664,660,"Well, it was either this or a cardboard box under the freeway."
5231,1079,14,40,127,181,1.3756906077348066,0.046502288330273686,660,"...sold the house, got a little nest egg..."
4173,1080,12,50,135,197,1.3756345177664975,0.04263996388822925,660,"Yes, it is unusual - I'd normally have migrated by now"
4979,1081,11,35,106,152,1.375,0.05010663080898807,660,It's the only affordable sublet on the Upper West Side.
4953,1081,11,44,121,176,1.375,0.04531634835874829,660,I have a flying lesson at two o'clock!
5747,1081,17,35,132,184,1.375,0.04785894624876121,660,"I thought it wouldn’t kick in until later in the pregnancy, but here I am."
4648,1081,13,34,113,160,1.375,0.04996067636041306,660,Yeah...I live in a loft off Central Park
1071,1081,9,48,119,176,1.375,0.043860019365035606,660,Don't have to worry about that.... the tree's hollow....
2024,1081,10,34,100,144,1.375,0.051090478420513785,660,I just refuse to be THAT millennial who has to move back in with his parents.
1964,1081,12,45,127,184,1.375,0.04464858429814923,660,I'm branching out a little.
1904,1081,9,42,109,160,1.375,0.046707641490284064,660,"My parents finally tossed me out, so I just googled 'Millennial housing' and came up with this."
2525,1081,9,48,119,176,1.375,0.043860019365035606,660,"If you're interested, I can talk to my roommates when they get back."
1938,1090,13,47,135,195,1.3743589743589744,0.04352672280318827,660,I found it online at Treebnb.
109,1091,21,25,133,179,1.3743016759776536,0.051321677902542516,660,Don't worry I'm not going to poop on you
954,1092,14,36,121,171,1.3742690058479532,0.04838171793560149,660,"Bees do it, birds do it, why can't we do it?"
1830,1092,11,42,118,171,1.3742690058479532,0.046199483564071296,660,"The rent is decent, and I rarely get asked to host Thanksgiving."
3336,1092,11,42,118,171,1.3742690058479532,0.046199483564071296,660,AirBnB said it was light and airy.
4351,1092,12,40,119,171,1.3742690058479532,0.04693816923561567,660,It still has more room and better lighting than your studio.
4952,1096,11,39,113,163,1.3742331288343559,0.047735900204530606,660,Once you get used to regurgitated food it's not so bad.
4828,1096,8,45,110,163,1.3742331288343559,0.045293433102604544,660,"My realtor says when choosing a new home to consider, 'location, location, location.'"
3609,1096,11,39,113,163,1.3742331288343559,0.047735900204530606,660,"Nesting, Norman, it is called nesting."
2255,1096,13,35,115,163,1.3742331288343559,0.049297027216808585,660,"Ironically, I moved here because I lost my nest egg."
4292,1096,11,39,113,163,1.3742331288343559,0.047735900204530606,660,I make my living by house-sitting.
72,1101,14,46,138,198,1.3737373737373737,0.04365717218702492,660,I'd love a coffee the next time you come by.
4663,1101,18,38,142,198,1.3737373737373737,0.045946113384754336,660,"The DNA test said I'm 1 percent bird, so I'm connecting with my roots."
1175,1103,12,47,131,190,1.3736842105263158,0.04366540109660783,660,I’m just watching it for them while they’re on winter vacation.
2743,1104,14,40,128,182,1.3736263736263736,0.046292121950873524,660,It started when he retweeted me.
3469,1104,17,34,131,182,1.3736263736263736,0.04821927890792034,660,Air B & B
5223,1104,12,44,126,182,1.3736263736263736,0.04496148372690085,660,"I gave her everything, I just wanted out."
5210,1107,12,41,121,174,1.3735632183908046,0.046367766780162904,660,"Yeah, it’s a bit drafty. But it’s affordable and in Manhattan."
4414,1107,13,39,122,174,1.3735632183908046,0.047078769782512984,660,Don't worry.  I use the restroom across the street.
1176,1107,10,45,119,174,1.3735632183908046,0.044912005745335194,660,"I know it’s small, but the view is spectacular."
2079,1107,10,45,119,174,1.3735632183908046,0.044912005745335194,660,"Yea the rent is great, but my roommate is a little flighty."
2845,1107,9,47,118,174,1.3735632183908046,0.04416613512651681,660,"It’s bigger than my old apartment, has a better view, plenty of outdoor space and you can’t beat the rent. No kitchen, but I order in anyway. I just have to request tall delivery guys."
697,1112,13,36,117,166,1.3734939759036144,0.04865604275227942,660,She said she wouldn’t be long.
1302,1112,8,46,112,166,1.3734939759036144,0.04474722053572404,660,There's really good wifi up here.
4489,1112,10,42,114,166,1.3734939759036144,0.046350323040171906,660,and theres no property tax!
1826,1115,14,31,113,158,1.3734177215189873,0.05117673365721463,660,"She said free eggs if I keep the rent warm. Wait, I hope I don't have that backwards."
2099,1116,12,45,128,185,1.372972972972973,0.04445282453822381,660,Would you mind sitting on some eggs while I call my broker?
3654,1117,12,42,123,177,1.3728813559322033,0.04581546921850963,660,I just jumped on the ad “Low-rent dwelling adjacent to park”
4090,1117,12,42,123,177,1.3728813559322033,0.04581546921850963,660,I just got tired of being stigmatized as homeless
5457,1119,7,49,113,169,1.3727810650887573,0.04341491262930008,660,"Yeah, it lacks privacy-but the rents low, and it’s near the bus stop,,,"
107,1119,17,29,123,169,1.3727810650887573,0.05088495278524505,660,The landlord is a little squirrelly...
3131,1119,15,33,121,169,1.3727810650887573,0.049481245575341434,660,It's a new Airbnb category
2772,1122,7,46,108,161,1.3726708074534162,0.044773303880811986,660,I decided not to go south for the winter.
3036,1122,8,44,109,161,1.3726708074534162,0.045632099359511485,660,"I just bought it from a couple of snowbirds."""
3495,1122,12,36,113,161,1.3726708074534162,0.048916740469572464,660,This is not what I meant when I told you to branch out.
4425,1122,7,46,108,161,1.3726708074534162,0.044773303880811986,660,"I tell you Frank, this life isn’t just for the birds!"
1671,1126,13,31,109,153,1.3725490196078431,0.05153504735665164,660,"So, your nest or mine?"
3759,1127,21,28,139,188,1.372340425531915,0.04944111651202897,660,You're not gonna get fed any worms standing down there.
3433,1127,11,48,129,188,1.372340425531915,0.043307401995574236,660,It’s just a sublet.
5539,1129,11,45,124,180,1.3722222222222222,0.04458969127853497,660,Welcome to my pied-à-tree.
1486,1129,14,39,127,180,1.3722222222222222,0.04663110879667587,660,"The owners are away until spring.  Until then, I’m all set!"
2944,1129,11,45,124,180,1.3722222222222222,0.04458969127853497,660,And the best part is I get served breakfast in bed.
4546,1132,12,40,120,172,1.372093023255814,0.04671518086158252,660,"I sat on the fence for a while, until I found this place. It really grows on you!"
680,1133,10,41,113,164,1.3719512195121952,0.04670457534159954,660,Laugh all you want--It's rent controlled.
5382,1133,15,31,118,164,1.3719512195121952,0.050550972822244765,660,"Yes, I'm pregnant!  Why do you ask?"
1835,1135,14,30,112,156,1.3717948717948718,0.05162211482770178,660,I'm renting this for peanuts...
4000,1135,14,30,112,156,1.3717948717948718,0.05162211482770178,660,The broker listing described it as an ‘airy studio overlooking the park and occasional bench sleeper.’
546,1137,10,51,130,191,1.3717277486910995,0.0421936807085064,660,This has gotten me over a thousand more followers on Instagram.
628,1138,8,39,101,148,1.3716216216216217,0.0482078196773919,660,Who said you can’t find affordable housing in New York City?
5575,1138,9,37,102,148,1.3716216216216217,0.04915203496708115,660,"When it gets cold, I'll migrate."
5166,1140,15,38,130,183,1.3715846994535519,0.04673069542162107,660,"- Well, I AM an apple branch manager!"
4784,1140,8,52,123,183,1.3715846994535519,0.04199301384693115,660,Come on up. My roommate's out of town.
3957,1140,12,44,127,183,1.3715846994535519,0.044761704318055054,660,My living arrangements are still up in the air.
3965,1140,10,48,125,183,1.3715846994535519,0.04339944346074924,660,"I'm not high, you're high."
4004,1140,12,44,127,183,1.3715846994535519,0.044761704318055054,660,"It's all good, Dad. I set my own rules, and I come and go as I please. Moreover, a park bench is within walking distance."
3474,1145,13,39,123,175,1.3714285714285714,0.04685762345061719,660,We decided not to go south this winter.
1714,1145,13,39,123,175,1.3714285714285714,0.04685762345061719,660,"And only $1,800 a month.
Can you believe it?!"
2434,1145,9,47,119,175,1.3714285714285714,0.04396488479994769,660,"They kept trying to ease me out of the nest, so I thought ""I'll show them!"""
2784,1145,13,39,123,175,1.3714285714285714,0.04685762345061719,660,"Saving $ 2,850 a month, with more space."
971,1149,13,46,135,194,1.3711340206185567,0.04363141533005126,660,"The last tenant's s@#% was everywhere, but I got a good deal on it."
1889,1150,13,33,113,159,1.371069182389937,0.050120036725075263,660,You must be the empty nester from next door.
1346,1150,14,31,114,159,1.371069182389937,0.05090805022020487,660,It's a pied-à-tree
5741,1152,15,26,110,151,1.3708609271523178,0.05366554428760804,660,"Eco-friendly, open concept design, solar lights and heating, all wood interior, great view of the park...it was a no-brainer. I had to take it!"
589,1153,13,40,125,178,1.3707865168539326,0.0462962269517056,660,It was my financial adviser's idea.
4032,1153,13,40,125,178,1.3707865168539326,0.0462962269517056,660,I plan to look for a job after I fledge.
615,1155,9,35,99,143,1.3706293706293706,0.05029051979448822,660,"Just keep watch for a big, angry bird flying around here."
4105,1156,15,33,122,170,1.3705882352941177,0.04923817152228551,660,"Cheap rent, good view, and I don't have to tell anyone I live in Jersey!"
2084,1157,14,42,133,189,1.3703703703703705,0.045038063527765355,660,"I know it's a little out of your price range, but it's a one bedroom with a view of the park"
798,1157,13,34,115,162,1.3703703703703705,0.04944976661122089,660,"It's a little bit spartan, I'll admit, but it's the cheapest thing on AirB&B downtown."
1278,1157,13,34,115,162,1.3703703703703705,0.04944976661122089,660,But it's the pentnest!
2421,1157,17,36,136,189,1.3703703703703705,0.046875249730754055,660,"It’s only $2,400 a month, utilities included!"
2896,1157,16,38,135,189,1.3703703703703705,0.04627096008287179,660,I got the nest egg in the divorce.
3663,1157,13,44,132,189,1.3703703703703705,0.04440878151898771,660,It was the only place in my price range
4332,1157,14,32,116,162,1.3703703703703705,0.050219126376369216,660,"I don't know, regurgitated worms? What sounds good to you?"
5664,1157,12,36,114,162,1.3703703703703705,0.048668246134442636,660,Time -share.
4371,1165,15,37,129,181,1.3701657458563536,0.04707493569975865,660,I found it on Airbnb; it's got a bird's eye view of the park.
5540,1165,11,45,125,181,1.3701657458563536,0.04439031599703112,660,I am going to have to work out the migration thing
3043,1165,11,45,125,181,1.3701657458563536,0.04439031599703112,660,"Black, no sugar; thanks for asking."
3448,1168,12,40,121,173,1.369942196531792,0.046494141382396985,660,It was on Airbnb. $120 a night overlooking the park.
4676,1168,10,44,119,173,1.369942196531792,0.045025309689495106,660,"This is my first air b-n-b!
And just what I wanted. A cozy urban nest with a view of the park."
2239,1168,11,42,120,173,1.369942196531792,0.04576561862097606,660,It’s a walk up.
2848,1168,15,34,124,173,1.369942196531792,0.04861424881928535,660,I’m an empty nester.
5192,1168,12,40,121,173,1.369942196531792,0.046494141382396985,660,I'm still getting the hang of Twitter.
3874,1173,11,39,115,165,1.3696969696969696,0.047263819351359364,660,"Gentrification, man - a huge cedar was planted down the block."
63,1174,10,48,126,184,1.3695652173913044,0.04321014981831189,660,"A guy brings me spaghetti, one piece at a time."
2320,1174,10,48,126,184,1.3695652173913044,0.04321014981831189,660,"Yeah, but the property taxes are nothing."
1079,1176,8,42,107,157,1.3694267515923566,0.046330851355706526,660,It's really taken my people-watching to the next level.
1914,1177,11,43,122,176,1.3693181818181819,0.04522466219706072,660,I got a terrific deal on this sublet while the owners are away in the south.
5386,1177,14,37,125,176,1.3693181818181819,0.047329433396602665,660,...and the omelette was amazing!
5697,1177,12,41,123,176,1.3693181818181819,0.04593696916181256,660,"There's a nice DoubleTree in town, but this SingleTree is a lot more economical."
2473,1180,10,52,133,195,1.3692307692307693,0.04158357073276955,660,Don't you think this strikes the right note of middle aged whimsy?
4534,1180,10,52,133,195,1.3692307692307693,0.04158357073276955,660,So extreme downsizing turned out to be my best option.
1168,1182,11,40,117,168,1.369047619047619,0.04667404200257338,660,And it’s only $1350 a month!
863,1182,7,48,113,168,1.369047619047619,0.043512322382735856,660,My accountant told me to protect my nest egg.
621,1182,13,36,119,168,1.369047619047619,0.048177154292438316,660,"I'm actually looking to sublet, maybe spend summer in the south"
410,1182,12,38,118,168,1.369047619047619,0.047431552750122945,660,"Dad, can I still use your Netflix login?"
275,1182,12,38,118,168,1.369047619047619,0.047431552750122945,660,The rest of my family migrated to Florida.
431,1187,12,45,130,187,1.3689839572192513,0.04406599660256535,660,"It’s a lot more comfortable than the bench, and a better view!"
2918,1188,9,41,110,160,1.36875,0.04659968941376239,660,"If you think this is something, you should see my summer place."
3409,1188,9,41,110,160,1.36875,0.04659968941376239,660,It won't look so odd after the trees leaf out.
404,1190,12,42,125,179,1.3687150837988826,0.04539727774027769,660,My boss said not to come back until I hatched a plan.
3317,1190,10,46,123,179,1.3687150837988826,0.043992856567312846,660,It's the cheapest one bedroom I could find.
4316,1190,14,38,127,179,1.3687150837988826,0.04675953617716566,660,"Welcome to your Airbnb, friend! First floor with a bird’s-eye view of the park."
1093,1193,14,35,122,171,1.368421052631579,0.04829015675293391,660,Come down? Are you kidding--it's rent controlled!
4138,1193,15,33,123,171,1.368421052631579,0.048997333486908566,660,Staying home is the new flying south
4699,1195,12,43,127,182,1.3681318681318682,0.04487422125184898,660,They told me I could be whatever I wanted when I grew up.
3206,1195,14,39,129,182,1.3681318681318682,0.04620737245018452,660,The rent is not as bad as you'd think for place overlooking Central Park.
2456,1197,13,34,116,163,1.3680981595092025,0.049197956580139424,660,What really holds the place together is my spit.
3281,1197,12,36,115,163,1.3680981595092025,0.048422087621480696,660,"Yes, this is what I meant by ""nesting"". What did you think it meant?"
3441,1197,13,34,116,163,1.3680981595092025,0.049197956580139424,660,I'm just house-sitting for a friend who winters in the south.
340,1200,14,36,124,174,1.367816091954023,0.04768920059785337,660,"Sleeping's not so bad, but bathroom breaks are brutal."
2767,1200,14,36,124,174,1.367816091954023,0.04768920059785337,660,"It's a ""light-filled, aerie studio,"" just like the ad says."
4845,1202,8,41,106,155,1.367741935483871,0.046691416576940904,660,And the ravens are charging half of what I was paying in SoHo.
5485,1203,10,48,127,185,1.3675675675675676,0.043022350040171055,660,My old place was getting to be such a rat’s nest.
1600,1204,8,45,113,166,1.3674698795180722,0.044641420454599845,660,It's only obvious now because the leaves haven't come out yet.
2958,1205,15,35,127,177,1.3672316384180792,0.04778408395553074,660,I have a strong nesting instinct.
1566,1205,10,45,122,177,1.3672316384180792,0.0442979909536576,660,Funny though; virtually no tweets.
647,1207,5,48,105,158,1.3670886075949367,0.0433931590053992,660,"I originally wanted a man cave, but this isn't bad."
5066,1207,10,38,110,158,1.3670886075949367,0.04781312083398338,660,It's rent controlled and has a great view of the park!
1173,1209,12,45,131,188,1.3670212765957446,0.04387489711369381,660,"The inaugural parade passes right by here so I’m not moving until January, 20, 2021 to make sure Trump leaves town."
175,1210,8,46,115,169,1.3668639053254439,0.0441149294799705,660,"It was my parent's idea, in so many words."
5645,1210,12,38,119,169,1.3668639053254439,0.04720059867799892,660,"Don't worry, my mom's coming back soon with food."
44,1212,9,41,111,161,1.3664596273291925,0.0463659499999034,660,What did you think ornithologists did all day?
947,1212,15,29,117,161,1.3664596273291925,0.051143326335997275,660,Where else can you get this location in NYC for $3200 a month?
2795,1214,7,53,123,183,1.366120218579235,0.04117631189601676,660,"There's no wifi, but I've got a bird's eye view of the park!"
1032,1214,13,41,129,183,1.366120218579235,0.04534075543725211,660,"It’s like, a metaphor."
4103,1214,14,39,130,183,1.366120218579235,0.04599818848604602,660,Damnit Alex! - You are taking this empty nester thing way too far.
183,1217,12,32,109,153,1.3660130718954249,0.05058280393488865,660,I’m just watching the chicks until she gets back.
221,1218,16,28,120,164,1.3658536585365855,0.051189933244652534,660,"I'm pregnant, John."
1686,1218,14,32,118,164,1.3658536585365855,0.04970689959570512,660,"Tiny houses? Yeah, I was pretty into those a couple years ago."
2107,1218,11,38,115,164,1.3658536585365855,0.047395419295073245,660,The WiFi is a little spotty but the maintenance is dirt cheap.
2126,1218,15,30,119,164,1.3658536585365855,0.05045386572409241,660,"Honey, this new place is perfect, but we have to decide fast...before the kids try to move back after college."
2765,1218,9,42,113,164,1.3658536585365855,0.04578965354729526,660,I’m trending tiny.
3346,1218,13,34,117,164,1.3658536585365855,0.04894853591610554,660,The owners let me have it while they're in Rio.
4192,1218,10,40,114,164,1.3658536585365855,0.04659945354903387,660,"Of course they can charge $5,000 a month, it’s technically a loft!"
4698,1218,9,42,113,164,1.3658536585365855,0.04578965354729526,660,"He's flown south for Winter, so we've the place to ourselves"
2932,1226,13,53,150,216,1.3657407407407407,0.04048225690426496,660,"Sitting on eggs, what do you think."
631,1227,13,38,124,175,1.3657142857142857,0.04676541945663693,660,"Don't look so surprised -- I told you I was up a tree, didn't I?"
558,1228,12,44,130,186,1.3655913978494623,0.04417205829128798,660,"And the best part? It's rent controlled."""
956,1228,14,40,132,186,1.3655913978494623,0.04546884660099202,660,It's not mine. I'm just house sitting for the winter.
1132,1228,10,48,128,186,1.3655913978494623,0.042836029883187625,660,Just enjoying my nest egg.
4544,1228,13,42,131,186,1.3655913978494623,0.04482514219114919,660,You know Johnny sometimes you need a bird's eye view in order to appreciate the bigger picture
4745,1228,13,42,131,186,1.3655913978494623,0.04482514219114919,660,"Migration, migration, migration."
369,1233,10,37,109,156,1.3653846153846154,0.048198770324963496,660,It's actually pretty spacious when the roommates are out of town.
557,1233,12,33,111,156,1.3653846153846154,0.049885342864574626,660,It’s when she brings my lunch that you may wish to turn away.
2061,1233,11,35,110,156,1.3653846153846154,0.04904930628232548,660,Its only 500 per month and even has a roof in spring.
4420,1233,12,33,111,156,1.3653846153846154,0.049885342864574626,660,Two words : Rent controlled.
5477,1237,17,27,123,167,1.3652694610778444,0.05121655513207037,660,The only thing I had left that “brought me joy” was this plaid hat.
3021,1237,11,39,117,167,1.3652694610778444,0.04680028117693398,660,You never know who's sat on those benches.
498,1237,8,45,114,167,1.3652694610778444,0.044427825937827736,660,I downsized.”
1554,1237,12,37,118,167,1.3652694610778444,0.04756481036578198,660,They sold me with “birds-eye view of the city!”
788,1241,11,43,124,178,1.3651685393258426,0.044810711922451056,660,Don’t worry.  My parents still come by to feed me.
1306,1241,12,41,125,178,1.3651685393258426,0.045513513103975056,660,And it came with breakfast!
2343,1241,13,39,126,178,1.3651685393258426,0.04620562570872211,660,I'm not an empty nester any more!
3368,1241,12,41,125,178,1.3651685393258426,0.045513513103975056,660,"No, it's not a statement on homelessness, or part of a Zen-like journey to enlightenment, it just feels good on my hemorrhoids."
4282,1241,15,35,128,178,1.3651685393258426,0.04755964456629324,660,"It's not so bad, I can see my old apartment from here."
4893,1241,11,43,124,178,1.3651685393258426,0.044810711922451056,660,I'm egg sitting for a friend
4249,1247,15,39,135,189,1.3650793650793651,0.04557706712686855,660,I summer in Nantucket.
3181,1247,9,51,129,189,1.3650793650793651,0.04170785664485794,660,"Sure it's small, but the rent is cheap, the view is great, and I can walk to work."
2785,1247,20,29,140,189,1.3650793650793651,0.04856650594325578,660,It's a rental from Air Tree 'n' Tree.
3725,1250,15,32,123,170,1.3647058823529412,0.049144521203205296,660,I’m just babysitting.
5085,1250,8,46,116,170,1.3647058823529412,0.043907726590798925,660,It’s better than squatting.
5122,1250,10,42,118,170,1.3647058823529412,0.04546554456861708,660,"It's just  for the winter, while they are south."
3319,1253,11,44,126,181,1.3646408839779005,0.044298537161430986,660,"Oh yeah??? Well let me tell you,the squirrels don't think I'm nuts!"""
538,1254,12,35,115,162,1.3641975308641976,0.04856358050108655,660,Tiny houses are so two thousand eighteen.
2087,1255,12,39,122,173,1.3641618497109826,0.046397945061846156,660,My Dad gave me a nest egg.
4598,1255,15,33,125,173,1.3641618497109826,0.04852225583522639,660,"Now this is what I call an 'Airbnb'"""
5678,1257,14,40,133,187,1.3636363636363635,0.04526728143824591,660,I used to be so grounded.
4240,1257,15,34,127,176,1.3636363636363635,0.04792014214933791,660,This is what I could afford with my Trump tax refund
5018,1257,13,34,118,165,1.3636363636363635,0.048701474676766505,660,When the snowbirds come back for the summer the value will really take off.
2892,1257,9,42,114,165,1.3636363636363635,0.04556527532740437,660,"'They can't evict me.  This space is protected under the Endangered Species Act."""
4762,1257,10,44,122,176,1.3636363636363635,0.04440343116176301,660,It feels more natural to tweet from here
998,1257,10,40,115,165,1.3636363636363635,0.046369215495515516,660,Please excuse the mess. I wasn't expecting company.
555,1257,8,52,127,187,1.3636363636363635,0.04128099721668197,660,Come down? In this economy?
180,1257,14,40,133,187,1.3636363636363635,0.04526728143824591,660,It’s called genTREEfication
1049,1257,12,36,117,165,1.3636363636363635,0.04793666452397724,660,And it’s all mine till the owner comes back in the spring!
427,1266,11,43,125,179,1.3631284916201116,0.04460634421842305,660,If you really love me you’ll make the climb.
1313,1267,5,51,112,168,1.3630952380952381,0.04172772421560075,660,"It’s a little small, but it’s turnkey and park-adjacent."
1704,1267,12,37,119,168,1.3630952380952381,0.04733080354506162,660,I refuse to be called an empty nester.”
4285,1267,12,37,119,168,1.3630952380952381,0.04733080354506162,660,"...and the best part is, I'm on their health insurance till I'm 26."
2563,1270,12,33,112,157,1.3630573248407643,0.04962118975609682,660,It's only 1500 a month and has a great view of the park.
4213,1270,11,35,111,157,1.3630573248407643,0.04879142502000183,660,You can’t get a park view apartment for cheaper.
5135,1272,13,27,106,146,1.3630136986301369,0.053130739528841175,660,"John, this is the only way we'll afford a place with a high-rise view of Central Park."
791,1272,13,27,106,146,1.3630136986301369,0.053130739528841175,660,A mate will join me up here; it will be for life;  we'll have three chicks; It's all good!
1276,1272,12,29,105,146,1.3630136986301369,0.05223410927346235,660,The bench was uncomfortable.
2618,1275,16,38,139,193,1.3626943005181347,0.04546921197921582,660,"...before utilities, it’s about thirteen hundred a month..."
387,1276,15,36,131,182,1.3626373626373627,0.04677244021904243,660,"Hello father, I am a bird now."
712,1276,14,38,130,182,1.3626373626373627,0.046118850767867245,660,"The neighbors can be a little loud in the morning, but you can't beat the rent."
1232,1276,9,48,125,182,1.3626373626373627,0.042701107206644745,660,The ad said it overlooked the park.
2357,1276,16,34,132,182,1.3626373626373627,0.04741702154225828,660,Can you believe this Airbnb is only $200 a night?
4782,1280,9,44,118,171,1.3625730994152048,0.04448244894406263,660,You upper-west-siders look like you’ve never seen anyone having an eggsincentral crisis.
5605,1280,11,40,120,171,1.3625730994152048,0.046003121233998294,660,It’s an Airbnb off-season special.
4736,1280,14,34,123,171,1.3625730994152048,0.048194247707409585,660,I booked it on Up-in-the-AirBnB.
3875,1280,9,44,118,171,1.3625730994152048,0.04448244894406263,660,It will only take 9 months. Now go get us some food!
3212,1280,15,32,124,171,1.3625730994152048,0.04890281138838091,660,2000 a month!  Near central park
2923,1280,11,40,120,171,1.3625730994152048,0.046003121233998294,660,No bedbugs!
2643,1280,14,34,123,171,1.3625730994152048,0.048194247707409585,660,You wouldn't believe what I was paying for this in Williamsburg
4917,1287,12,34,114,160,1.3625,0.04895728789195588,660,Great views...and only 300 bucks a month
3840,1288,10,34,105,149,1.3624161073825503,0.049681339991210494,660,It has park views - and only $950 a month!
5446,1289,12,26,100,138,1.3623188405797102,0.05436809805639403,660,This is not what I meant when I said affordable with plenty of natural light
4314,1290,6,55,124,185,1.3621621621621622,0.04009944129266632,660,What am I doing up in this tree?  Brooding.
5157,1290,10,47,128,185,1.3621621621621622,0.04292997575477964,660,I'll keep the eggs warm while you bring home the bacon.
2185,1292,7,49,118,174,1.3620689655172413,0.0424287774411771,660,"You might get more room in Brooklyn, but you can’t beat this location."
5706,1292,12,39,123,174,1.3620689655172413,0.046177970889043324,660,"It's our starter nest, Honey!"
5512,1294,12,35,116,163,1.361963190184049,0.04831641485117751,660,"Though I'm not a pigeon, I'd not recommend sitting on that bench."
3163,1294,10,39,114,163,1.361963190184049,0.04672253439180312,660,"The broker listed it as an aerie and I'll tell you, the views are amazing"
703,1296,10,44,123,177,1.3615819209039548,0.044199623716894225,660,"''Any day now, thank you.''"
977,1296,9,46,122,177,1.3615819209039548,0.04346729116620062,660,Rent Free Until the Robins Return
1105,1296,10,44,123,177,1.3615819209039548,0.044199623716894225,660,You really don't want to be standing there when Mother brings me my dinner.
1560,1296,11,42,124,177,1.3615819209039548,0.04492001861200432,660,I never thought I could afford living near Central Park until I found this place.
2761,1296,14,36,127,177,1.3615819209039548,0.04701501970930293,660,"If you loved me,you'd bring me some pre-chewed grubs and a latte."
3015,1296,13,38,126,177,1.3615819209039548,0.046327213847568764,660,I love it! It's just about as spacious as my old Midtown apartment and with a view.
3622,1296,12,40,125,177,1.3615819209039548,0.04562904127297209,660,"When Spring arrives, I'll trade this nest egg for a tree house in the Hamptons."
4380,1296,11,42,124,177,1.3615819209039548,0.04492001861200432,660,It's the latest thing on Airbnb: fresh air and an amazing view of the park.
3007,1304,12,36,118,166,1.3614457831325302,0.04769734394747745,660,Affordable housing is everywhere!
3756,1304,7,46,113,166,1.3614457831325302,0.04370285881959033,660,Not too pretentious for “a penthouse with a view of the park.”
50,1306,16,41,145,202,1.3613861386138615,0.044003733390671824,660,"Airbnb lied.  It's not 'near the park'.  But, you can't beat the price."
1292,1307,10,36,109,155,1.3612903225806452,0.048335400396854585,660,A nice little pied-a-terre overlooking Central Park. Exactly what I've always wished for.
2272,1307,10,36,109,155,1.3612903225806452,0.048335400396854585,660,Look dad I got my own place. I’m Adultimg!
1269,1309,13,43,135,191,1.361256544502618,0.04394230116431437,660,And next winter I'm going to try migrating!
2027,1310,9,47,124,180,1.3611111111111112,0.04298303397549552,660,"And further more, there’s no carbon footprint."
2364,1310,10,45,125,180,1.3611111111111112,0.043699135645563866,660,"All-new, eco-friendly construction with Central Park views.  I can barely afford it, but it's worth it."
2000,1312,13,35,121,169,1.3609467455621302,0.04784090364080714,660,"I've wanted to nest for a long time, 
and finally realized I didn't need you for that."
5632,1312,12,37,120,169,1.3609467455621302,0.04709893505201904,660,"Well, there is a lot more space now that the kids are off to college."
3688,1314,13,31,114,158,1.360759493670886,0.050169714734853876,660,I’ll only come home if you stop calling me birdbrain.
5201,1314,14,29,115,158,1.360759493670886,0.050966910163949136,660,"How else could I afford this view?"""
713,1314,9,39,110,158,1.360759493670886,0.04684546569565537,660,"No, I am not a little cuckoo. Guess again.."
767,1314,14,29,115,158,1.360759493670886,0.050966910163949136,660,"In today's economy, this is my only chance at a nest egg."
1843,1318,15,36,132,183,1.360655737704918,0.04655834121009871,660,"Who's the cuckoo now, Jim?"
749,1319,13,36,123,172,1.3604651162790697,0.047245334985692486,660,"Yeah, normally you don't see chicks like me until spring."
829,1319,11,40,121,172,1.3604651162790697,0.045783433312734365,660,"Yes, sitting on eggs. I got a grant."
2067,1319,8,46,118,172,1.3604651162790697,0.04349855627361141,660,A view like this AND rent control!
4991,1319,10,42,120,172,1.3604651162790697,0.04503469007217928,660,"In the Spring, you won't even see the neighbors."
5641,1319,10,42,120,172,1.3604651162790697,0.04503469007217928,660,Central Park West starter home!
5701,1319,7,48,117,172,1.3604651162790697,0.04270977571802721,660,"Forget about walls, Jon!  It's all about location, location, location."
2835,1325,14,43,140,197,1.3604060913705585,0.04360335600551648,660,It's the only room with a view I could afford.
2639,1326,12,39,124,175,1.36,0.045959931145900995,660,The positives are great indoor/outdoor flow; the negatives...my roommate is an early bird.
1880,1326,14,35,126,175,1.36,0.04736747999334079,660,...and I’ll call it ‘Airbnb’.
1182,1326,11,41,123,175,1.36,0.0452397372444201,660,He's getting dinner.
849,1326,9,36,105,150,1.36,0.04849410121188961,660,My roommate said he's bringing back some chicks.
147,1326,6,51,118,175,1.36,0.041451496969171345,660,I'll be heading down to my place in Florida in a couple months.
2043,1331,15,38,136,189,1.3597883597883598,0.045492041312325635,660,I got it for a song on Airbnb.
351,1332,12,35,117,164,1.3597560975609757,0.048071592267032046,660,It’s cheaper than a studio and has great views!
2532,1332,9,41,114,164,1.3597560975609757,0.045677433003903214,660,"Hey, the ad didn’t lie!  It is a great view of the park.  Plus, the squirrels are pretty good landlords."
2267,1334,17,30,131,178,1.3595505617977528,0.04878670232270157,660,I'm warming eggs AND getting a masters degree
4236,1334,14,36,128,178,1.3595505617977528,0.04679425613595602,660,She said she’d be back in 20 minutes.
4390,1334,10,44,124,178,1.3595505617977528,0.043997528556070156,660,I told you $2500 for East 82nd with garden on the park was suspicious.
3959,1337,11,33,109,153,1.3594771241830066,0.04960662168271359,660,Park views are rare so let me know soon if you want to make an offer.
4892,1338,14,41,137,192,1.359375,0.044372173176436276,660,I've met this great bird...
2036,1338,11,47,134,192,1.359375,0.04248855359922982,660,I'm subletting for the winter while the owner's down south.
115,1340,16,28,123,167,1.3592814371257484,0.050408873557254506,660,"Alright you can stay up there, but you have to stop pooping on cars!"
3673,1340,11,38,118,167,1.3592814371257484,0.04669400602698027,660,No sleeping on benches? Fine.
5276,1340,13,34,120,167,1.3592814371257484,0.04821431252888617,660,Can you believe the rent is only $575?
560,1343,12,41,128,181,1.3591160220994476,0.04489174570587618,660,"Typical broker's fee, but it's root-stabilized."
5707,1343,12,41,128,181,1.3591160220994476,0.04489174570587618,660,I’m not saying the regurgitation doesn’t take some getting used to.
1860,1345,16,38,141,195,1.358974358974359,0.04507807274783528,660,It's short on amenities but the view is great.
254,1346,9,43,118,170,1.3588235294117648,0.04458563710496658,660,It's the new Millennial housing trend! It's cheaper than a house and environmentally friendly!
1547,1346,14,33,123,170,1.3588235294117648,0.04833163826550019,660,"I was CEO of an oil company, and then I thought, 'Hey, maybe I'm missing something.'"
2014,1346,12,37,121,170,1.3588235294117648,0.046869179306646774,660,"Bit chilly, but a great escape from Trump's voice."
3444,1349,13,40,131,184,1.358695652173913,0.045046268206123195,660,"Finally, I now have a 5th Ave. coop with a great view of the park !"
4247,1349,15,36,133,184,1.358695652173913,0.04634608227005963,660,Yeah I just told my boss I now self-identify as a robin and he gave me the afternoon off
4406,1351,12,47,139,198,1.3585858585858586,0.04222337035533243,660,I used to fly south for the winter but I've had it with hurricanes.
1595,1352,9,39,111,159,1.3584905660377358,0.04660517079406119,660,"Wanna get high, Carl?"
3735,1352,12,33,114,159,1.3584905660377358,0.049100676496802345,660,It's America's New Affordable Housing Plan.
5672,1354,14,34,125,173,1.3583815028901733,0.0477270529459052,660,It's way cheaper this side of 5th Ave.
684,1355,13,41,133,187,1.358288770053476,0.04453797222849813,660,How far along are you?
4577,1355,10,47,130,187,1.358288770053476,0.04255734897081398,660,Finally - a place I can afford with a great view!
5405,1355,7,53,127,187,1.358288770053476,0.04047993246808612,660,"The neighbors can be a pain sometimes, but the view is incredible."
3398,1358,9,35,104,148,1.3581081081081081,0.04889863962028005,660,"Can you believe it? A one-nest, first-branch climb-up with park views for only $2,500 a month!"
4091,1358,10,33,105,148,1.3581081081081081,0.04982976640594712,660,"Yes, I do think my nesting instinct has kicked in. Why do you ask?"
3324,1360,11,36,115,162,1.3580246913580247,0.04765595391242546,660,Yep. Cheapest one bedroom on Central Park West!
4389,1360,9,40,113,162,1.3580246913580247,0.04601877302906031,660,Women are attracted to men with good nesting instincts.
2071,1362,12,39,125,176,1.3579545454545454,0.04574380365261735,660,"It's nice, but I wish it were a little closer to the park."
2095,1363,15,38,137,190,1.3578947368421053,0.04529157922042526,660,"The're in Pompano Beach until mid May.  It's been fabulous.  No cat, no litterbox.  Some people just feed me."
5182,1364,10,34,107,151,1.3576158940397351,0.04913770429420594,660,I needed to spread my wings.
5265,1365,12,35,118,165,1.3575757575757577,0.04782908344636838,660,"The rent is good, but my roommates hate it when I scramble eggs."
1066,1366,14,36,129,179,1.3575418994413408,0.046575435404238724,660,I Marie Kondo-ed my life.
2518,1366,11,42,126,179,1.3575418994413408,0.04450796655859248,660,Working on my Nest Egg.
2833,1366,7,50,122,179,1.3575418994413408,0.04159178155151908,660,You wouldn't believe the deal I got on this studio.
3454,1366,9,46,124,179,1.3575418994413408,0.04307455966002478,660,"It’s an airy loft with a park view, plus regular feedings.  What’s not to love?"
5224,1370,15,39,139,193,1.3575129533678756,0.04478756896274733,660,It’s rent controlled. I’m subleasing from a pair of bald eagles.
5335,1371,11,38,119,168,1.3571428571428572,0.046464474723167254,660,I know we are talking about having a baby. I just want to try out this whole nesting thing first.
4568,1371,11,38,119,168,1.3571428571428572,0.046464474723167254,660,But it‘s $500 for Manhattan.
4099,1371,13,34,121,168,1.3571428571428572,0.04797415356376048,660,". . . and, best of all, it's rent controlled!"
3934,1371,10,40,118,168,1.3571428571428572,0.04569093358501374,660,"Yes, I’m “ Tree Hugger” and you must be “ Looking For Love.” Pleased to meet you."
2168,1371,10,35,109,154,1.3571428571428572,0.0484708636020876,660,Great view. No rent. And my Grubhub is a bird that delivers actual grubs.
1220,1371,10,45,127,182,1.3571428571428572,0.043308092376949686,660,I always thought you were an odd bird.
6,1371,8,39,107,154,1.3571428571428572,0.046686826222018474,660,It's a seasonal gig.
2972,1371,7,46,115,168,1.3571428571428572,0.04328745099426623,660,"Don't worry. When the weather warms up, I'll have plenty of shade."
3550,1379,14,38,133,185,1.3567567567567567,0.045494428983865486,660,"Apparently, there is a difference between AirBNB and IntheAirBNB."
1859,1380,11,39,121,171,1.3567251461988303,0.045898051158710124,660,My '23 and Me' says that I'm 3% Turkey.
2707,1380,10,41,120,171,1.3567251461988303,0.045142348748854096,660,We're all out of bread. Did you pick any up?
5581,1380,13,35,123,171,1.3567251461988303,0.04737330471242616,660,I’m in therapy for empty nest syndrome.
3164,1383,7,42,108,157,1.356687898089172,0.045194282595072695,660,"Great view, zero rent, free bread crumbs. What’s not to like?"
2884,1384,17,33,138,188,1.3563829787234043,0.046837140470251594,660,Guess: who just got off the list of the homeless?
4865,1385,9,44,121,174,1.3563218390804597,0.04386031834866818,660,"Generally it's been great; however, I am not keen on the regurgitated breakfasts and dinners"
4309,1385,14,34,126,174,1.3563218390804597,0.04749664583865804,660,"It's only $4500 a month, and they allow pets!"
3103,1385,12,38,124,174,1.3563218390804597,0.04607656486558384,660,I'm not protesting anything. This is called affordable housing. I live here.
3322,1385,11,40,123,174,1.3563218390804597,0.04534985183831449,660,The only issue I’ve run into so far is finding someone who sells fitted sheets.
3604,1385,20,22,132,174,1.3563218390804597,0.05152257732542681,660,The downside is my mom pukes in my mouth.
1326,1390,13,31,116,160,1.35625,0.049642491531034234,660,I'm not homeless. I'm homefree...
1227,1390,13,31,116,160,1.35625,0.049642491531034234,660,It's empty! It's finally empty!
4625,1390,12,33,115,160,1.35625,0.048844248517174955,660,The ad said $1500 for a single occupancy with a view of the city.
4716,1393,14,40,137,191,1.356020942408377,0.044477486298585965,660,My landlord is a squirrel.
3594,1394,10,43,124,177,1.3559322033898304,0.044096924512836234,660,"If you can handle the worm diet, it’s a pretty nice life."
5408,1394,15,33,129,177,1.3559322033898304,0.047597746043585486,660,What eagle?
1324,1394,11,41,125,177,1.3559322033898304,0.0448189701675368,660,"No one is trying to chop down this tree, I just want my parents to let me move back in."
1044,1397,11,36,116,163,1.3558282208588956,0.04741358762720982,660,And here's the best part. It's rent controlled.
2599,1397,10,38,115,163,1.3558282208588956,0.046608024305307916,660,"My folks were ready for the empty nest, me, not so much"
3502,1397,7,44,112,163,1.3558282208588956,0.044103138703808616,660,You said to find something I'm good at.
1996,1400,9,35,105,149,1.3557046979865772,0.048628781027481326,660,It's a sublet. I don't have to move out until spring.
3658,1400,9,35,105,149,1.3557046979865772,0.048628781027481326,660,"Hey, don't knock it... it comes with our own bench, a view of Central Park and it's in our tax bracket."
1641,1402,13,38,129,180,1.3555555555555556,0.04568413822707755,660,My financial advisor told me I needed a nest egg.
5767,1402,9,46,125,180,1.3555555555555556,0.04288061916329538,660,"The central location and view more
than make up for any inconveniences."
3813,1404,12,41,130,183,1.355191256830601,0.04448595091756656,660,"Susan, come on, we're not that kind of 'empty nesters'."
4687,1404,10,45,128,183,1.355191256830601,0.04311497823594398,660,"Alright, the birds helped but it was all me in the end!"
1123,1406,10,40,119,169,1.3550295857988166,0.04546890448902634,660,"It may not look like much, but it’s free, the view is spectacular, and it came with a half dozen fresh eggs."
5316,1407,9,53,138,200,1.355,0.0400361017987039,660,"It doesn't come with a bedroom, a bathroom or a kitchen, but these views are priceless."
809,1408,20,37,160,217,1.3548387096774193,0.04374060730004122,660,"Cozy loft, great light, huge backyard, only $3150/month."
783,1409,8,45,119,172,1.3546511627906976,0.04338707674947301,660,"New York protects nesting birds, so I should be all right for while."
1439,1409,15,31,126,172,1.3546511627906976,0.04856371712395093,660,"Hi, I'm responding to the ad about a branch opening."
2812,1409,9,43,120,172,1.3546511627906976,0.0441637621231368,660,"With the new tax laws, this is the best nest egg I can get!"
4145,1409,12,37,123,172,1.3546511627906976,0.04641590517141801,660,"Studio for rent - Stunning park views. Available next week: current tenant heading south for winter soon"""
515,1413,11,45,133,189,1.3544973544973544,0.04285248674192988,660,She even chews my food for me!
4011,1414,10,36,112,158,1.3544303797468353,0.047577744900438736,660,"Only $2,000 a month. And the view!"
2608,1415,13,36,126,175,1.3542857142857143,0.04656837609749233,660,And it comes with a parking space.
5703,1415,12,38,125,175,1.3542857142857143,0.04585773879473022,660,"Find your own, buddy."
2193,1417,16,36,140,192,1.3541666666666667,0.0454989388033176,660,"And the best part is it’s only $3,000 a month."
968,1417,8,35,101,144,1.3541666666666667,0.04874966379658141,660,You know I got tired of just hugging them...
43,1417,14,40,138,192,1.3541666666666667,0.0442840647253391,660,"They're twins, I can feel it."
4172,1420,13,48,148,209,1.354066985645933,0.04120221411602953,660,It’s only temporary. I go up before the coop board in a few weeks.
2458,1421,9,39,113,161,1.3540372670807452,0.046131342574406986,660,Get ready for battle.  The squirrels return at dawn.
2971,1421,12,33,116,161,1.3540372670807452,0.04859032848598247,660,"Ironically, now I don't need a nest egg."
2587,1423,12,39,127,178,1.353932584269663,0.04531719786391686,660,"Brooding? 
Nah, I’m really happy! Just waiting
for a few chicks."
3546,1423,9,45,124,178,1.353932584269663,0.04316489900406294,660,It's the cheapest studio in the city and it's IN the park!
4428,1423,9,45,124,178,1.353932584269663,0.04316489900406294,660,"Sure, but you won't find a park view for less."
3280,1426,12,28,107,147,1.3537414965986394,0.05180798031199937,660,"My name's Walter, but all my friends call me Pigeon."
5378,1427,8,42,114,164,1.353658536585366,0.04473131454807574,660,"Short commute, beautiful views, free nuts -- what's not to like?"
2645,1427,13,32,119,164,1.353658536585366,0.04873370493441961,660,"And then I was like, 'Who's homeless now, bird?!'"
1393,1427,9,40,115,164,1.353658536585366,0.045559929766035956,660,"Yeah, but the maintenance is low and it has good light."""
2510,1427,5,48,111,164,1.353658536585366,0.04214783984900274,660,First 'Citi Bikes' and now 'Empty Nester' napping pods. Outdoor urban amenities rock!
264,1431,15,34,132,181,1.3535911602209945,0.046803982973208876,660,Resting on my laurels.
1246,1431,9,46,126,181,1.3535911602209945,0.042688273529462674,660,It's only a sublet for the winter.
1618,1431,14,36,131,181,1.3535911602209945,0.046143531160406356,660,"When my bus comes, would you mind keeping my eggs warm for me?"
4048,1431,7,50,124,181,1.3535911602209945,0.041225162079925846,660,Hatching some new ideas.
4757,1431,16,32,133,181,1.3535911602209945,0.04745524392900599,660,It's installation art.  Next month I'll be in the Boston Garden.
4505,1436,16,21,113,150,1.3533333333333333,0.05445410740772417,660,Why don’t YOU go lay an egg?
3699,1436,10,33,107,150,1.3533333333333333,0.04927816009039002,660,"That's so nice of you to ask, but I've mated for life.  My partner is flying across the ocean right now and will bring back tuition for our young."
3100,1438,10,39,118,167,1.3532934131736527,0.045801934537435904,660,I rent it for peanuts from a very savvy squirrel.
3496,1438,6,47,114,167,1.3532934131736527,0.04253513535655766,660,"Rather than grieving over an empty nest, I decided to fill it."
602,1438,15,29,123,167,1.3532934131736527,0.04958368221335691,660,I never migrate - you lose your spot.
4470,1438,12,35,120,167,1.3532934131736527,0.04735089166168896,660,Twelve hundred a month. What’s not to like?
5574,1442,12,41,131,184,1.3532608695652173,0.04428561116578994,660,"Dude, I’m so high right now."
1184,1443,8,44,118,170,1.3529411764705883,0.04368332447474088,660,The open house is noon to 3 today.
1519,1443,13,28,112,153,1.3529411764705883,0.05119032745195421,660,You’re not my real Dad!
1828,1443,12,36,122,170,1.3529411764705883,0.04676202962086448,660,I'm just trying to get featured on Humans Of New York.
2820,1443,10,40,120,170,1.3529411764705883,0.045248868778280535,660,The pigeon on my window sill turned me on to this place.
3859,1443,14,38,135,187,1.3529411764705883,0.04508691264842461,660,This tree is easier to climb than the social ladder.
335,1448,10,41,122,173,1.3526011560693643,0.04471359225893441,660,"Hardwood floors and sweeping vistas of Central Park for only $1,000 per month -- I'll take it!"
2124,1448,6,49,118,173,1.3526011560693643,0.04159870180901663,660,"I’d like to, but I can’t leave until after the eggs hatch."
5239,1450,9,37,110,156,1.3525641025641026,0.04708587018600659,660,It’s bigger than the place I had in SanFran.
188,1451,10,48,135,193,1.3523316062176165,0.04157203765772334,660,"Go ahead, just ask me, I know you want to!"
5273,1452,13,36,127,176,1.3522727272727273,0.046346762908679416,660,And my parents bring me worms.
3069,1452,16,30,130,176,1.3522727272727273,0.04840276466193369,660,I couldn't afford to fly South this winter.
2308,1452,8,46,122,176,1.3522727272727273,0.042700668700127134,660,I started as a tree huger .
663,1452,11,40,125,176,1.3522727272727273,0.04492385003807234,660,It’s a better hiding spot in summer.
753,1452,11,40,125,176,1.3522727272727273,0.04492385003807234,660,I'm only paying 1200 a month.
1271,1452,13,36,127,176,1.3522727272727273,0.046346762908679416,660,My doctor says it's empty nesters' syndrome.
1971,1458,8,40,111,159,1.3522012578616351,0.045617039804286615,660,"Number One, I'm not homeless; this is my home. Number Two, my friends bring me nuts and worms.  Number Three, I don't get mugged."
5268,1458,12,32,115,159,1.3522012578616351,0.048983265551674905,660,I can’t check out of this AirBnB until the eggs hatch
3923,1460,11,41,127,179,1.3519553072625698,0.04440542259156037,660,And... they’re giving me pick of the litter!
2253,1460,14,35,130,179,1.3519553072625698,0.0464774531514872,660,It's a Marie Condo.
4362,1460,9,45,125,179,1.3519553072625698,0.04296859502310156,660,I couldn't afford to migrate this winter.
607,1460,10,43,126,179,1.3519553072625698,0.04369291540853259,660,You wanna see my nest egg?
1563,1460,9,45,125,179,1.3519553072625698,0.04296859502310156,660,We got in just before it went condo.
953,1465,9,39,114,162,1.3518518518518519,0.04589775548385575,660,"No condo fee, no homeowners association,  and a great view!"
1660,1465,10,37,115,162,1.3518518518518519,0.04672563744409847,660,I told you that I had the nesting instinct.
4018,1465,7,43,112,162,1.3518518518518519,0.04419549169601758,660,I'm giving the birds a parents' night out.
1841,1468,6,39,100,145,1.3517241379310345,0.04645583994933614,660,"And my parents think they're the empty nesters!"""
2128,1469,10,44,128,182,1.3516483516483517,0.04320591185770269,660,Make yourself at home. Your WI-FI password is 'BenchSublet3'.
4980,1469,10,44,128,182,1.3516483516483517,0.04320591185770269,660,"When you said ecotourism, this wasn’t what I had in mind."
237,1471,12,34,119,165,1.3515151515151516,0.047716566332787654,660,"Yes, I’m squatting."
3063,1471,9,40,116,165,1.3515151515151516,0.04533366533349307,660,"Ok. I know it lacks some amenities, but the price is right and we’d have a birds eye view of the park."
3794,1471,12,34,119,165,1.3515151515151516,0.047716566332787654,660,I got a really good deal on a seasonal sublease.
5325,1474,11,43,131,185,1.3513513513513513,0.04341549126037408,660,It was a bargain on Airbnb.
319,1474,10,45,130,185,1.3513513513513513,0.0427334818941673,660,"Its affordable, and I have a view of the park."
3804,1474,9,47,129,185,1.3513513513513513,0.042040409943513046,660,I finally got a rent controlled apartment in NYC!
1052,1477,8,56,141,205,1.351219512195122,0.03872433665910853,660,"Yes, it's a 'fixer upper,' but I really like the open concept!"
4737,1478,14,38,136,188,1.351063829787234,0.044885724623171294,660,This is actually more spacious than my last apartment.
4987,1478,11,44,133,188,1.351063829787234,0.04294252431613958,660,I have finally outsmarted the bed bugs!
988,1480,11,31,109,151,1.3509933774834437,0.049899391491588285,660,My mother left me on a seedling 20 years ago and I stayed. It's my family tree.
1114,1481,10,40,121,171,1.3508771929824561,0.045030803362789334,660,....and birds bring me things to eat!
5755,1481,9,42,120,171,1.3508771929824561,0.0442602959987142,660,Don’t knock it. It’s cheap and close to the office.
952,1483,14,39,138,191,1.350785340314136,0.04438657003938154,660,"I told you that with the baby on the way, I might feel like nesting..."
1017,1483,22,23,146,191,1.350785340314136,0.04910254991135382,660,I WILL SHIT ON YOU.
4793,1485,12,37,125,174,1.3505747126436782,0.04597078225025984,660,"Well, yes it's kind of drafty, but Central Park views, One bedroom, Open-air setting, only $1500/month.  What more could I ask for?"
1989,1485,10,41,123,174,1.3505747126436782,0.04450203685889274,660,"Well, the ad did say it was ""cheep""."
2936,1485,11,39,124,174,1.3505747126436782,0.045242370104201284,660,"I""m just house sitting"
380,1485,10,41,123,174,1.3505747126436782,0.04450203685889274,660,My name is Robin.
235,1485,6,49,119,174,1.3505747126436782,0.041408552406104866,660,The bark is original
2759,1490,8,52,134,194,1.3505154639175259,0.040085956883372534,660,Best of all there was no broker's fee.
4182,1490,11,46,137,194,1.3505154639175259,0.04203726667212813,660,"''I'll send you the link to the live cam."""
578,1492,11,33,113,157,1.3503184713375795,0.048550979585057524,660,"New York City studio apartment, $1600 a month not covering utilities."
1815,1492,12,31,114,157,1.3503184713375795,0.04938478445834081,660,"Yes, there was no pre-nup."
3784,1494,11,40,126,177,1.3502824858757063,0.04471363754208912,660,Did you bring me a worm or not?
4487,1494,16,30,131,177,1.3502824858757063,0.04816965911426197,660,"I've had it with the dating apps. So I'm going with 
'""If you build it, he will come."""
5027,1494,13,36,128,177,1.3502824858757063,0.04612712925189333,660,"It may look rough now, but come spring, I’ll have a tidy little nest egg!"
4445,1497,14,41,142,197,1.350253807106599,0.04343115931019302,660,"$ 2150 a month plus utilities with this view, it's a steal."
5148,1498,10,43,127,180,1.35,0.04349347290086495,660,I told you it was right in Central Park
5123,1498,10,43,127,180,1.35,0.04349347290086495,660,"It's not you Harry, it's instinct."
2313,1498,12,39,129,180,1.35,0.04489798077686624,660,So much for the retirement nest egg.
665,1498,13,30,117,160,1.35,0.04952605565436485,660,My parents told me it's time to leave the nest.
3108,1502,8,48,127,183,1.349726775956284,0.04159258519906689,660,"Well, for one thing, it's safer than a bench."
3704,1502,11,42,130,183,1.349726775956284,0.04370458631165573,660,"Nesting, Bob. It’s the ethical response to IKEA."
755,1504,9,39,115,163,1.3496932515337423,0.04566635098689633,660,"Actually, for egg sitting I charge slightly more than for baby sitting.  No fridge with snacks."
4030,1504,12,33,118,163,1.3496932515337423,0.04808988145727954,660,I'm ovulating. Come on up.
4714,1504,13,31,119,163,1.3496932515337423,0.04887102475510544,660,"If you see my parents, please tell that I am well.  I have flown the nest but found a new one."
3617,1507,11,28,104,143,1.3496503496503496,0.051815024228655325,660,"The view’s great now, but I really enjoy the extra privacy in spring and summer."
4911,1508,10,38,118,166,1.3493975903614457,0.04591169666256938,660,"""Just checking my nest egg."
4071,1508,12,34,120,166,1.3493975903614457,0.047475494633456454,660,I guess my 'nesting instinct' got the better of me.
1190,1508,11,36,119,166,1.3493975903614457,0.046700141761707406,660,"But it's rent-controlled, so no, I won't be leaving any time soon."
543,1508,12,34,120,166,1.3493975903614457,0.047475494633456454,660,My only complaint: When she returns from a long trip she regurgitates her food.
437,1508,10,38,118,166,1.3493975903614457,0.04591169666256938,660,Can't beat these hardwood floors.
730,1513,16,27,126,169,1.349112426035503,0.049796135132177156,660,It's comfy and people feed me.  Beats working for Trump!
805,1513,11,37,121,169,1.349112426035503,0.04612421471882875,660,Just waiting for my mother to bring me lunch.
1887,1513,9,41,119,169,1.349112426035503,0.04457082484270677,660,Her parents gave us their blessings as long as we promise to raise the kids Avian.
2271,1513,9,41,119,169,1.349112426035503,0.04457082484270677,660,I just didn't feel ready to leave the nest
2446,1513,13,33,123,169,1.349112426035503,0.04762696651790864,660,What? You got a man cave.
3511,1518,14,39,139,192,1.3489583333333333,0.044192566967801356,660,"Well the Realestate Ad didn’t lie - “comfortable open plan loft, all natural finishes, 360 deg view”...I’ll take it!"
2955,1519,12,36,124,172,1.3488372093023255,0.046307180201171284,660,Nesting. Why?
4086,1519,12,36,124,172,1.3488372093023255,0.046307180201171284,660,I'ts just a short term nanny position.
5527,1521,13,42,140,195,1.3487179487179488,0.04310422960405288,660,They winter in Boca.
3277,1522,11,31,110,152,1.3486842105263157,0.04962377487511157,660,My Doorman is a Squirrel.
1637,1523,8,45,122,175,1.3485714285714285,0.04278373570979375,660,Because it's rent-free and I get to keep all the eggs.
2591,1523,11,39,125,175,1.3485714285714285,0.04502768455362601,660,"$2,000 a month."
2937,1525,14,41,143,198,1.3484848484848484,0.04324744646524079,660,"Yeah, the webcam's annoying, but you can't beat the rent."
3417,1526,14,34,130,178,1.348314606741573,0.046595683237570476,660,"The food’s a little weird, but otherwise my new mom treats me great!"
3723,1526,11,40,127,178,1.348314606741573,0.04450525564660391,660,she said she'd be right back.
5229,1526,12,38,128,178,1.348314606741573,0.04521280517993085,660,"Oh, so you have a giant, ugly recliner in our living room, but MY chair is ridiculous?!"
5309,1526,9,44,125,178,1.348314606741573,0.04305528813086663,660,It's quite nice now that the squirrels and I have a right of way agreement.
5409,1526,10,42,126,178,1.348314606741573,0.04378627419752401,660,"No, I'm just subletting till the Spring."
4956,1531,10,35,113,158,1.3481012658227849,0.04745155444598154,660,"Hardwood floors, Central Park view, and just 2 grand a month!"
572,1531,12,31,115,158,1.3481012658227849,0.04912129201789022,660,Your place or mine?
4157,1533,8,47,126,181,1.3480662983425415,0.04185384227389876,660,"Like I said, an affordable one bedroom with a park view."
839,1533,13,37,131,181,1.3480662983425415,0.04537268874679529,660,I’m launching phase two of the tiny house craze
323,1535,9,38,114,161,1.3478260869565217,0.04600572942750317,660,"You keep saying it's time for me to leave the nest, Dad, but you've never given me a ladder."
1691,1535,6,44,111,161,1.3478260869565217,0.04340055167274082,660,It actually came feathered.
5024,1535,13,38,133,184,1.3478260869565217,0.04485236547393269,660,I got a great deal... bird's eye views are going for 6K in this part of town.
5333,1535,13,38,133,184,1.3478260869565217,0.04485236547393269,660,This unit fits your budget and has a great view of the city
5444,1535,13,30,118,161,1.3478260869565217,0.04926546606262658,660,How do you like our new love nest?
1980,1540,11,43,133,187,1.3475935828877006,0.04303158022922594,660,I never knew what free as a bird meant until now.
2894,1540,12,41,134,187,1.3475935828877006,0.043694598101961274,660,We're going to have a baby!!
3786,1540,18,29,140,187,1.3475935828877006,0.047478668272157507,660,... and I say 'let's make homelessness great again'.
3243,1543,9,39,116,164,1.3475609756097562,0.045437102849560186,660,She insisted it was only for a few minutes while she did some foraging.”
4401,1543,12,33,119,164,1.3475609756097562,0.04784329015257228,660,Got laid. You?
672,1543,8,41,115,164,1.3475609756097562,0.044606206028693744,660,"Best of all, it's rent controlled."
1806,1543,14,29,121,164,1.3475609756097562,0.049382322857452664,660,"Well, it's cheaper than freezing them!"
3595,1547,8,50,132,190,1.3473684210526315,0.04055919492849605,660,"Yes, but I'm not most birds."
2365,1548,10,38,119,167,1.347305389221557,0.04568388203291401,660,I'm giving this tiny house thing a try.
2713,1548,8,42,117,167,1.347305389221557,0.04407638079302522,660,"Hey, it’s a 5th Avenue address."
5257,1548,9,40,118,167,1.347305389221557,0.044887327952379645,660,It's only $2100 a month AND has a scenic view!
2606,1551,10,39,121,170,1.3470588235294119,0.04513333667116702,660,"It's not the nicest AirBnB, but at least they left some eggs behind for breakfast."
3882,1551,11,37,122,170,1.3470588235294119,0.04589805794744683,660,What if I told you squirrels make the best pillows?
584,1553,10,40,123,173,1.346820809248555,0.04460049222385315,660,It's only a one-floor climb-up!
3715,1553,10,40,123,173,1.346820809248555,0.04460049222385315,660,Maybe we should have read the Air B&B reviews more carefully.
4300,1553,14,32,127,173,1.346820809248555,0.04751901984587583,660,You must have heard my mating call!
5613,1556,14,41,144,199,1.3467336683417086,0.04306519307263799,660,Now you’re the one who’s grounded.
3046,1557,9,34,107,150,1.3466666666666667,0.048222699888011124,660,There are all sorts of rules on using park benches but none for nesting.
1086,1557,6,40,104,150,1.3466666666666667,0.04535385770417178,660,It’s rent stabilized unless the wind blows from the south
2363,1559,13,35,128,176,1.3465909090909092,0.04624116431762747,660,This is nothing - my last AirBnb was a rathole!
3240,1559,10,41,125,176,1.3465909090909092,0.044084465321070056,660,They were grateful; Ive been feeding them for years.
5139,1559,15,31,130,176,1.3465909090909092,0.047624735246717675,660,Cheapest short-term rental I've found yet...!
1140,1562,11,31,111,153,1.34640522875817,0.04935101822127012,660,I am watching the place for an empty nester.
5208,1562,12,29,112,153,1.34640522875817,0.050214761888130455,660,“It actually started with an article on open floor plans...”
191,1564,5,52,122,179,1.3463687150837989,0.03982146604242508,660,The realtor told me that the rent is reasonable and it offers a bird's eye view of the city
263,1564,12,38,129,179,1.3463687150837989,0.04500160050746133,660,Dad said I'd never be able to build a nest egg living in New York.  Joke's on you old man!
5709,1564,13,36,130,179,1.3463687150837989,0.045693705768639736,660,"I'd move, but I can't let the eggs get cold."
2173,1567,10,44,131,185,1.345945945945946,0.04262930818070262,660,"""The best thing is, it's comvenient to all transportation."
3551,1567,13,38,134,185,1.345945945945946,0.04464886488710323,660,The fees were manageable and it came with nuts.
2483,1569,6,43,110,159,1.3459119496855345,0.04369982264421721,660,"I'm taking ""nesting"" to the next level."
4622,1570,10,45,133,188,1.3457446808510638,0.04217282212995261,660,The Airbnb posting did say it had a park view...
1690,1571,9,38,115,162,1.345679012345679,0.04577124757801412,660,During pregnancy you go through a nesting phase
2890,1572,11,44,136,191,1.3455497382198953,0.042384726811569094,660,oh me? just babysitting
435,1573,14,29,122,165,1.3454545454545455,0.04912730303521736,660,"Jane, that's not what they mean by 'nesting' during pregnancy"
950,1573,10,37,118,165,1.3454545454545455,0.04602013237143623,660,"Sure it’s drafty, but it’s also rent controlled!"
1684,1573,10,37,118,165,1.3454545454545455,0.04602013237143623,660,"Full park view and only $2,000 a month."
29,1576,8,42,118,168,1.3452380952380953,0.043861980595407114,660,"“See, Dave, I’m not suffering with empty nest syndrome.”"
3226,1576,10,38,120,168,1.3452380952380953,0.04545817132938031,660,It was the cheapest and most literal AirBnB I could find.
3685,1576,17,24,127,168,1.3452380952380953,0.0506502451782741,660,You should see the boss's windshield.
4954,1579,10,39,122,171,1.345029239766082,0.0449145022957021,660,"Just what I said, ""You hunt, I'll nest."""
1879,1579,6,47,118,171,1.345029239766082,0.04173864777461072,660,"Except for the eggs, it's quite comfortable."
2992,1579,12,35,124,171,1.345029239766082,0.0464210234234386,660,"I'm nesting, Carl."
2950,1582,12,36,126,174,1.3448275862068966,0.04586059275777719,660,This is a single nest. Move along buddy.
4669,1582,11,38,125,174,1.3448275862068966,0.045130402170149186,660,It was cheaper than flying south with the others.
4975,1582,11,38,125,174,1.3448275862068966,0.045130402170149186,660,Millennials really aren’t leaving the nest
4805,1585,9,33,106,148,1.3445945945945945,0.04861837938016613,660,Didn’t you see my tweet? I’m over you.
91,1586,12,38,130,180,1.3444444444444446,0.04479224559218596,660,"It's only $3,500 a month and has two bathrooms, one at each end of the park!"
400,1586,14,34,132,180,1.3444444444444446,0.046157250330281584,660,Found this place last night on Air-BirdNB.
499,1586,8,46,126,180,1.3444444444444446,0.04192913401762013,660,My carbon footprint is a 2 foot diameter.
2275,1586,11,40,129,180,1.3444444444444446,0.044093900017575155,660,"Once the leaves fill in in spring, it’s really quite cozy."
5233,1586,16,30,134,180,1.3444444444444446,0.0474830311891928,660,I've elevated myself to the nest level.
5334,1591,10,32,109,151,1.3443708609271523,0.04886920654135704,660,"It’s Manhattan, it has a view, and it’s only $67,000 a month!"
204,1592,10,43,130,183,1.3442622950819672,0.04290517174397784,660,"Keeping my eggs warm, what else?"
979,1592,9,45,129,183,1.3442622950819672,0.042199579642493185,660,The Airbnb listing described it as “the best perch in the city”!
1412,1592,8,47,128,183,1.3442622950819672,0.04148198743582587,660,"Once I discovered I could fly, this seemed natural."
347,1595,12,29,113,154,1.344155844155844,0.04993831194148001,660,It will be a lot more private in a few weeks.
2783,1596,12,40,134,186,1.3440860215053763,0.043788378649214636,660,I found it on openairbnb.com!
1590,1597,7,41,112,160,1.34375,0.044374474042414076,660,If you wait too long all the good spots are taken.
5620,1597,13,40,139,192,1.34375,0.043474889193664386,660,Kids just left the nest.
570,1599,10,36,117,163,1.343558282208589,0.046363124943781746,660,The owners headed south for the winter so it's all mine until March.
2722,1599,11,34,118,163,1.343558282208589,0.0471728705570442,660,On the park and no HOA fees...
4443,1599,8,40,115,163,1.343558282208589,0.044699649109079774,660,She apologized for calling me bird brained but I quite like it up here.
3437,1602,10,37,119,166,1.3433734939759037,0.04578937718024466,660,It's the last rent-stabilized  space in NY.
2604,1602,11,35,120,166,1.3433734939759037,0.046579892793806366,660,"No, I'm not homeless.  Just communing with nature."
4078,1604,9,51,141,201,1.3432835820895523,0.03968577850838308,660,I owe Big Bird a favor.
477,1605,11,36,122,169,1.3431952662721893,0.04600658533824066,660,"I'm from a different branch of the family"""
5506,1605,11,36,122,169,1.3431952662721893,0.04600658533824066,660,"The best part is, it's in your price range."
5469,1607,16,27,129,172,1.3430232558139534,0.04904973090475007,660,"Guess what George!,I’m pregnant!"
1944,1607,8,43,121,172,1.3430232558139534,0.043149512787441516,660,"What do you mean it’s time for me to leave the nest, dad?"
1892,1607,13,33,126,172,1.3430232558139534,0.04692417003864148,660,"Yes, nesting is a real thing!"
1951,1607,9,41,122,172,1.3430232558139534,0.04393039847073926,660,It”s this week’s Airbnb special
930,1607,13,33,126,172,1.3430232558139534,0.04692417003864148,660,"Just doing some babysitting."""
18,1607,12,35,125,172,1.3430232558139534,0.04619392035550768,660,"Yes, but this was the only place where I could be completely safe from Game of Thrones spoilers."
1128,1607,11,37,124,172,1.3430232558139534,0.04545193969245575,660,Are you looking for a mate?
199,1614,9,42,124,175,1.3428571428571427,0.0434280528877521,660,Rent-free and delivery from grub-hub
2763,1614,14,32,129,175,1.3428571428571427,0.04705744364689122,660,"This empty nester thing isn't so bad."""
2796,1614,12,36,127,175,1.3428571428571427,0.045640334273499394,660,"Sure, the rent's a little high, but it's still way more affordable than Brooklyn."
4951,1617,11,39,128,178,1.3426966292134832,0.044394937561776066,660,Let's head south this year.
20,1617,9,43,126,178,1.3426966292134832,0.04294124517263526,660,"Hey, why don't you stick around for dinner? There's going to be a ton of old people throwing breadcrumbs."
872,1617,11,39,128,178,1.3426966292134832,0.044394937561776066,660,"I told you the nesting instinct was real, Harvey."
1089,1617,10,41,127,178,1.3426966292134832,0.04367414004929214,660,It's like a tree house without the house!
5481,1617,12,37,129,178,1.3426966292134832,0.045104217687294036,660,It's part of a federal program to reduce affordable housing costs.
5764,1622,13,36,132,181,1.3425414364640884,0.045267919079936755,660,It's been newly wrenovated.
325,1622,12,38,131,181,1.3425414364640884,0.044584718723152984,660,"If I can make a nest here, I can make it anywhere."
4229,1624,8,34,104,146,1.3424657534246576,0.04804968708871018,660,"My mom said I should start building up a nest egg, so here I am!"
3091,1625,11,41,132,184,1.3423913043478262,0.04340209234500312,660,It's so much bigger than my last place in Park Slope.
2335,1625,11,41,132,184,1.3423913043478262,0.04340209234500312,660,"Why?  Great view, all natural, and no property taxes."
743,1627,8,35,106,149,1.342281879194631,0.04739907804334821,660,It's so much roomier now that the kids have left!
4781,1627,10,31,108,149,1.342281879194631,0.04927536953178356,660,It’s made entirely out of locally sourced heroin needles.
1629,1629,18,28,141,187,1.3422459893048129,0.04738466706167634,660,The rent is pretty cheep... cheep cheep.
3793,1629,9,46,132,187,1.3422459893048129,0.04156678501084042,660,"Well, you did say we'd need a nest egg."
1038,1631,11,43,136,190,1.3421052631578947,0.042467461914869144,660,"There's no kitchen, but I never cook anyway."
4655,1631,10,32,110,152,1.3421052631578947,0.04859947124817861,660,Any chance you have a spare worm on you?
2550,1633,9,36,113,158,1.3417721518987342,0.04645989975052686,660,"With private outdoor space and a skyline view, this unit is a steal at only $2,200 a month."
1622,1634,11,33,117,161,1.3416149068322982,0.04753683604553272,660,I got the nest when I divorced Big Bird.
3717,1635,7,42,115,164,1.3414634146341464,0.043626412101819036,660,I like to think of it as more of a lifestyle than a stage.
2295,1635,9,38,117,164,1.3414634146341464,0.04530890895896981,660,Would you like to come up for a nightcap?
1139,1635,9,38,117,164,1.3414634146341464,0.04530890895896981,660,"Outdoor AirBnB ! Very small, very cheap, very convenient!"
1525,1638,12,33,122,167,1.341317365269461,0.04711766841023983,660,"Very comfortable, and it even came with instuctions and an allen wrench."
2086,1639,11,36,123,170,1.3411764705882352,0.04577969183689316,660,I warned you two much tweeting would change you!
2875,1639,13,32,125,170,1.3411764705882352,0.047275865652883164,660,You wanted outdoor sex. I wanted to be comfortable. Feels like a good compromise to me.
3353,1639,12,34,124,170,1.3411764705882352,0.046533792333692085,660,I warned you about empty nest syndrome.
2279,1642,9,41,123,173,1.3410404624277457,0.04372071167087783,660,"Just tell Mom, I flew the coop!"
2090,1643,15,30,131,176,1.3409090909090908,0.04751809448435248,660,I'm the love child of Jack Sparrow and Sheryl Crow.
5615,1643,10,40,126,176,1.3409090909090908,0.04396923900579273,660,You wont believe how easy it was to qualify for this.
5626,1643,9,42,125,176,1.3409090909090908,0.043224517508162655,660,Why do you ask?
5328,1646,14,33,132,179,1.3407821229050279,0.04626949929786402,660,I'm planning a natural childbirth.
4888,1646,12,37,130,179,1.3407821229050279,0.044892373160697205,660,I can see the woods from the trees.
3328,1646,9,43,127,179,1.3407821229050279,0.04274357345947645,660,I told you I have a very strong nesting instinct.
732,1646,10,41,128,179,1.3407821229050279,0.04347164329449182,660,"It's called the Birdseed Diet, but it's really more of a lifestyle."
3391,1646,13,35,131,179,1.3407821229050279,0.04558613678123167,660,You should've seen the egg.
1730,1651,10,42,130,182,1.3406593406593406,0.042989184311819015,660,Are you kidding?  For a second floor climb up with a view it was a steal!
4079,1651,12,38,132,182,1.3406593406593406,0.04437899845180964,660,Rent's only three eggs a month.
5411,1651,9,44,129,182,1.3406593406593406,0.04227714749010933,660,"For three thousand a month, it's a bargain!"
4250,1654,7,33,98,138,1.3405797101449275,0.04878333197342628,660,Thought it was time to spread my wings and get my own place.
534,1655,7,34,100,141,1.3404255319148937,0.04809416130862452,660,"Above street level, park view and it’s free.  Beat that in Midtown."
4269,1656,12,41,138,191,1.3403141361256545,0.042929248717817454,660,"I think when they said ""empty nester"" they had something else in mind."
5163,1657,12,25,107,144,1.3402777777777777,0.05230060225054453,660,The landlord is some old crow.
5047,1658,10,48,142,200,1.34,0.04037512543347505,660,Cheapest Airbnb in the city!
3632,1658,8,35,107,150,1.34,0.04713728818419851,660,"This is what I meant when I said, ""I like getting high."""
4259,1660,9,35,112,156,1.3397435897435896,0.04681483762285024,660,The board only requires that you don't eat their young.
2899,1661,7,40,112,159,1.3396226415094339,0.04446086441168413,660,This is only seasonal; I fly south in the winter.
3333,1661,12,30,117,159,1.3396226415094339,0.048732185911717525,660,I'll tweet you an explanation.
4688,1663,12,31,119,162,1.3395061728395061,0.04809345712860434,660,I go both ways.  You can either stare at me through your binoculars or strut around and flash your stuff.
1516,1663,10,35,117,162,1.3395061728395061,0.046471691882024824,660,I’m subletting.  The owner winters in Sao Paolo.
2678,1665,8,40,117,165,1.3393939393939394,0.044253661159434264,660,I just want to see how an empty nest feels
4429,1665,10,36,119,165,1.3393939393939394,0.045893422034413635,660,Eagle cam's got my good side.
1279,1665,6,44,115,165,1.3393939393939394,0.042550756350495565,660,"So I says to this hooded warbler, would you consider subletting for the winter? His attorney draws up some papers and here I am."
1984,1665,5,46,114,165,1.3393939393939394,0.041673217250313754,660,"It's a rent-controlled nest, so I really have no desire to move."
2897,1669,10,37,121,168,1.3392857142857142,0.045334322790178606,660,Of course I am showing off. Do you have any idea what a swanky nest costs in the city?
1054,1669,10,37,121,168,1.3392857142857142,0.045334322790178606,660,Pick up some eggs while your out
688,1669,11,35,122,168,1.3392857142857142,0.04611384631836537,660,I'll be heading north next month.
124,1669,9,39,120,168,1.3392857142857142,0.04454115875697887,660,"Every spring, I migrate south of the 100s."
5397,1673,13,32,126,171,1.3391812865497077,0.04704091617192069,660,"I pictured something else when you said you had a 'love nest'. Thanks! But, no thanks!"
5403,1673,12,34,125,171,1.3391812865497077,0.04630386965135059,660,What kind of nest egg are we talking about?
836,1675,7,45,122,174,1.339080459770115,0.04195818670673937,660,Just getting used to the idea of my little Harold going off to college this year.
1460,1675,14,31,129,174,1.339080459770115,0.04717599822054167,660,"I don’t suppose you’d consider eating my hamburger and fries and regurgitating it for me, would you?"
2416,1675,10,39,125,174,1.339080459770115,0.04426976096483283,660,It's their pied-a-terre. They won't be back for three months.
4632,1675,9,41,124,174,1.339080459770115,0.043512882780024555,660,"If you're looking for a place, all of his friends and relatives need subletters for the winter."
1361,1679,13,34,130,177,1.3389830508474576,0.04591037448690106,660,I found this on Airbnb.
2083,1679,8,44,125,177,1.3389830508474576,0.042270034404866715,660,Hatching some plans...what's up with you?
4806,1681,8,45,127,180,1.3388888888888888,0.04181176886295701,660,I finally got my carbon emissions under control.
4774,1681,14,33,133,180,1.3388888888888888,0.046050662254022705,660,My son’s college is just down the street.
3623,1681,11,39,130,180,1.3388888888888888,0.043982311839439577,660,I’m freezing my eggs.
74,1681,14,33,133,180,1.3388888888888888,0.046050662254022705,660,I saw where you parked.
3995,1681,10,41,129,180,1.3388888888888888,0.04327089678191241,660,"Two birds used to live here, but then.....well I've said too much..."
1013,1686,13,36,134,183,1.3387978142076502,0.04484958732998979,660,I'm your harbinger of spring.
1787,1686,11,40,132,183,1.3387978142076502,0.04349007936203568,660,The landlord can be kinda flighty but she's always building up the place.
2853,1686,6,50,127,183,1.3387978142076502,0.039889106295210676,660,Well you did say that we needed a nest egg
5677,1686,10,42,131,183,1.3387978142076502,0.04279413233772888,660,It's a winter timeshare.
354,1690,13,37,136,186,1.3387096774193548,0.04434327872396561,660,Gentrification.”
5556,1690,9,45,132,186,1.3387096774193548,0.041639354136683016,660,My sublet only lasts through May.
2230,1690,9,45,132,186,1.3387096774193548,0.041639354136683016,660,It’s an “in the” Airbnb.
4578,1693,17,30,142,189,1.3386243386243386,0.04634813199486633,660,POTUS said he wouldn’t allow any liberal sit on the bench
4790,1693,9,46,134,189,1.3386243386243386,0.041204987765740254,660,They only charge me $500 a month for this place and it includes a great view of the Park !
4419,1693,12,40,137,189,1.3386243386243386,0.04320547289134022,660,Who is the empty nester now?
4375,1693,13,38,138,189,1.3386243386243386,0.043852025929188014,660,This is the only pied a terre in the City I could afford.
3646,1697,13,39,140,192,1.3385416666666667,0.04337513663173187,660,If they look like you when they hatch we'll know for sure.
3667,1697,15,35,142,192,1.3385416666666667,0.04461476797486933,660,Spring brings out the nesting instinct in me.
3138,1699,15,36,144,195,1.3384615384615384,0.044126778419226215,660,The  eggs are just about done
3618,1699,8,50,137,195,1.3384615384615384,0.0397126669328948,660,Second floor climb-up with a view.
3420,1701,12,44,145,201,1.3383084577114428,0.041428180639932435,660,and I haven't even mentioned the schools in this area
5322,1702,7,33,99,139,1.3381294964028776,0.04849304182311418,660,"When the tree leafs out in the spring, no one will notice we’ve moved in."
2481,1703,13,22,107,142,1.3380281690140845,0.05371739271649279,660,Guess what darling? I’m pregnant!
1072,1704,10,29,106,145,1.3379310344827586,0.05011546978526813,660,"My roommates get a little chirpy, but you can’t beat this view."
920,1705,5,42,107,154,1.3376623376623376,0.04342987348128073,660,"My parents can stop worrying. I may have left one nest, but I found another."
4280,1706,9,35,113,157,1.3375796178343948,0.04656600643213291,660,Livin' rent-free in my pied-à-tree!
4846,1706,10,33,114,157,1.3375796178343948,0.04743471589843826,660,My wife flew south for the winter.
5467,1708,10,35,118,163,1.3374233128834356,0.04623265155504615,660,I've decided to preserve my eggs.
1952,1709,10,36,120,166,1.3373493975903614,0.045661913659749906,660,Finally! I found a home I can afford!
2219,1709,13,30,123,166,1.3373493975903614,0.04800071259318768,660,It’s what I like to call micromalist living
1868,1709,7,42,117,166,1.3373493975903614,0.04319667011109887,660,I'll head south 20 blocks or so when Spring arrives.
5740,1709,16,24,126,166,1.3373493975903614,0.05023073222477607,660,"Ironically, this all started with predatory lending."
1270,1709,15,26,125,166,1.3373493975903614,0.04949855664268781,660,"This is the only place I could find under $3,000 per month."
293,1709,9,38,119,166,1.3373493975903614,0.04485522276104167,660,The Thanksgiving Day Parade is only four weeks from now.
160,1709,8,40,118,166,1.3373493975903614,0.044033755901749815,660,"It's a bit snug, but at $1800 a month, you really can't do any better in this part of town."
1450,1709,11,34,121,166,1.3373493975903614,0.04645459836440563,660,"That's right Ed, I'm hatching another idea."
1582,1717,12,33,124,169,1.3372781065088757,0.04664540882948909,660,It's only six hundred a month.
505,1717,10,37,122,169,1.3372781065088757,0.045109970168476135,660,My Airbnb host even left me eggs for breakfast.
761,1717,13,31,125,169,1.3372781065088757,0.04739447798008608,660,"You know that little nest egg of mine I mentioned the other night...well, ta da!"
2302,1720,10,38,124,172,1.3372093023255813,0.04457586072926776,660,This was the only place airbnb had that I could afford.
3541,1720,10,38,124,172,1.3372093023255813,0.04457586072926776,660,I'm house sitting for a couple of snowbirds.
5128,1720,9,40,123,172,1.3372093023255813,0.043806482439825316,660,"Yeah, it's REALLY cool, I finally have a zero carbon footprint."
598,1723,12,35,128,175,1.3371428571428572,0.045525059927451796,660,What sold me was the views of the park.
1766,1723,14,31,130,175,1.3371428571428572,0.046945649120889325,660,"Cheap rent, great views, and I've mastered swallowing worms without chewing."
4061,1723,12,35,128,175,1.3371428571428572,0.045525059927451796,660,I don't date much.
4196,1723,12,35,128,175,1.3371428571428572,0.045525059927451796,660,"Great light, great views, only $1950 a month."
4596,1723,12,35,128,175,1.3371428571428572,0.045525059927451796,660,"It’s not just free, it’s my protected habitat. You’ll go to jail if you bother me."
2804,1728,13,34,131,178,1.3370786516853932,0.045691426954511706,660,Because the seas are rising
3170,1728,6,48,124,178,1.3370786516853932,0.040538212746219986,660,"Only $500 a month, and more privacy once spring comes!"
3182,1728,12,36,130,178,1.3370786516853932,0.044991405013298555,660,"Great views, fresh air and rent controlled. Whats not to like?"
3819,1728,10,40,128,178,1.3370786516853932,0.04355762368326631,660,They did tell me to branch out.
4645,1728,10,40,128,178,1.3370786516853932,0.04355762368326631,660,You said we were empty nesters; I'm just disagreeing.
5728,1728,11,38,129,178,1.3370786516853932,0.04428031789635045,660,"It was only rent I could afford, and owner shows up only once a year!"
4338,1734,12,37,132,181,1.3370165745856353,0.044474280215465435,660,Cheap cheap!
5537,1734,12,37,132,181,1.3370165745856353,0.044474280215465435,660,I got tired of hugging.
3710,1734,13,35,133,181,1.3370165745856353,0.04515915139690707,660,My therapist suggested that I try nesting.
2926,1737,11,40,133,184,1.3369565217391304,0.043292248803813216,660,I'm house sitting for Larry Bird.
4685,1737,8,46,130,184,1.3369565217391304,0.04118287523672358,660,I think you'might be taking this nesting phase a little too far
1057,1737,11,40,133,184,1.3369565217391304,0.043292248803813216,660,"Even with a view of the park, it's a cheap sublet until the owners fly home in the Spring."
1383,1740,12,40,138,190,1.3368421052631578,0.04301441193568909,660,"Plus, it's outside the flood zone."
5638,1740,9,46,135,190,1.3368421052631578,0.04102627519727398,660,I found it without a broker fee or anything...
2697,1742,12,41,140,193,1.3367875647668395,0.04255597004433047,660,"Great view, steps to the park, semi private bathroom. Only $2250 a month."
3775,1742,11,43,139,193,1.3367875647668395,0.04191703973642963,660,"No, not the whole nine months. Just the last trimester. Another two weeks or so."
2523,1744,7,35,104,146,1.3356164383561644,0.046894485788636496,660,"I know you said you're nesting, but this seems a bit extreme."
3674,1744,9,31,106,146,1.3356164383561644,0.048867570227705735,660,I found it on Up in the Air BNB
2735,1746,9,33,110,152,1.3355263157894737,0.04754708087318879,660,It's really the egg laying that's hard to get a handle on.
609,1747,7,38,110,155,1.335483870967742,0.04510140262838917,660,"Get a job, Carl."
2250,1747,10,32,113,155,1.335483870967742,0.047806882984902835,660,I’m never going to leave the nest!
4964,1747,9,34,112,155,1.335483870967742,0.046922392097705524,660,I’m house-sitting.
1223,1750,8,37,113,158,1.3354430379746836,0.04544099758325997,660,"You said 'my place' ."""
4775,1750,10,33,115,158,1.3354430379746836,0.0471819411589724,660,I never was really one to leave the nest
3288,1752,12,30,119,161,1.3354037267080745,0.048216723615863835,660,Squatting?! If only...The falcon's charging me 4 pigeons a day to sublet.
1588,1752,12,30,119,161,1.3354037267080745,0.048216723615863835,660,Home tweet home!
1726,1752,4,46,111,161,1.3354037267080745,0.04127631795383693,660,"The roommates in summer are noisy, but you can't beat the rent"
627,1752,10,34,117,161,1.3354037267080745,0.046578674660653574,660,It’s not just the location—it’s still rent-controlled!
31,1752,8,38,115,161,1.3354037267080745,0.044880880450782396,660,"My broker said there was no such thing as a “no fee” apartment in New York, but who looks crazy now?!"
1189,1752,8,38,115,161,1.3354037267080745,0.044880880450782396,660,"$2500 a month, no utilities but the view is great!"
3926,1758,9,37,118,164,1.3353658536585367,0.04517530240472377,660,It's only a four month lease but I actually got a pretty good price for Manhattan.
3810,1758,8,39,117,164,1.3353658536585367,0.04433949986491734,660,I sublet it from a snowbird.
731,1758,10,35,119,164,1.3353658536585367,0.045995919889110566,660,The Airbnb listing described it as park adjacent with all the eggs I could eat.
864,1758,12,31,121,164,1.3353658536585367,0.04759472706739634,660,I'd rather you fertilize my eggs up here.
1557,1758,7,41,116,164,1.3353658536585367,0.04348763673946618,660,"You think this is cramped, you should have seen my studio on West 73rd!"
446,1763,13,30,124,167,1.3353293413173652,0.04775516101065646,660,Empty nest syndrome.
842,1763,10,36,121,167,1.3353293413173652,0.04543259625506297,660,"...and it's only $2,600 a month!"
1508,1763,10,36,121,167,1.3353293413173652,0.04543259625506297,660,I’m egg sitting for a bird I know.
1745,1763,9,38,120,167,1.3353293413173652,0.04463155761994915,660,I'm an extreme birder.
4563,1763,16,24,127,167,1.3353293413173652,0.04996989097278365,660,"When I said you should ‘leave the nest’ and ‘make a home for yourself,’ 
I didn’t mean in Central Park"
945,1768,13,31,126,170,1.3352941176470587,0.04715661610567526,660,It's a BNNB. Bird nest no breakfast.
3628,1768,14,29,127,170,1.3352941176470587,0.047889039318118595,660,"With the new tax laws, this is the only way to protect my nest egg."
68,1770,12,34,127,173,1.3352601156069364,0.04585043266448885,660,The rest of the family flew south for the winter.
1135,1770,11,36,126,173,1.3352601156069364,0.045111515607382746,660,I couldn't afford to fly south this year!
3209,1770,9,40,124,173,1.3352601156069364,0.043596125632259564,660,"I am not coming home any time soon. I don’t have to cook, I don’t have to clean, and I don’t have to do laundry."
3228,1770,12,34,127,173,1.3352601156069364,0.04585043266448885,660,"That's right Mr. Wayne, the name's Robin."
3614,1770,11,36,126,173,1.3352601156069364,0.045111515607382746,660,"Sure, there's room.  Wayne and the kids flew south for the winter."
4516,1770,7,44,122,173,1.3352601156069364,0.04202612877594582,660,I'm thinking of maybe taking a few flying lessons.
1753,1776,6,47,123,176,1.3352272727272727,0.04078037108560411,660,"When your parents kick you out at 30, and the rent is still too damn high..."
4448,1776,9,41,126,176,1.3352272727272727,0.04310271291560162,660,A Man in the tree is better than two in the bush
1353,1776,10,39,127,176,1.3352272727272727,0.0438495031399426,660,Ever read Walden?
198,1776,9,41,126,176,1.3352272727272727,0.04310271291560162,660,"Come on, I'm enjoying it while it's not gentrified."
300,1780,14,32,133,179,1.335195530726257,0.046159473683601675,660,"Dad...Decided to find my own nest, since you and mom wanted your's emptied."
739,1781,16,29,137,182,1.335164835164835,0.046930861587881414,660,I bet you don't even remember where you first got laid
4046,1781,13,35,134,182,1.335164835164835,0.04494849792479853,660,What's a place like that go for?
5164,1781,12,37,133,182,1.335164835164835,0.04426798727975477,660,"Seriously, just apologize to her."
296,1784,8,46,131,185,1.335135135135135,0.041000136718991054,660,"The best part? Free, organic and locally sourced food deliveries."
2751,1784,17,28,140,185,1.335135135135135,0.0470085191236695,660,Honestly Steve you're terrible at Hide and Seek
2928,1784,14,34,137,185,1.335135135135135,0.04509476300479824,660,"There was a pigeon on the bench, so I sat up here."
4039,1787,12,39,137,188,1.3351063829787233,0.04329167767360518,660,"It’s not ideal, but it’s the only rent that I could afford in New York."
5708,1787,12,39,137,188,1.3351063829787233,0.04329167767360518,660,"Laugh all you want, but there's a great view and it was cheap-cheap!"
1208,1789,13,38,140,191,1.3350785340314135,0.04346363056220163,660,"Nice plumage, but can you regurgitate?"
5336,1790,13,42,148,203,1.3349753694581281,0.041675650526114126,660,It’s even got a bird’s eye view
2839,1791,10,43,136,189,1.3333333333333333,0.04177207201259173,660,"Listen, I realize it's $2500 a month but there's no maintenance."
3109,1791,11,37,129,177,1.3333333333333333,0.04437162327312129,660,"Yes, the third night free! I paid with my CapitalOne points."
2714,1791,9,43,131,183,1.3333333333333333,0.041969564977435786,660,"""I got a sublease 'til spring from a red tailed hawk."""
3180,1791,9,37,119,165,1.3333333333333333,0.04494665749754948,660,It's (wren)t-controlled.
2658,1791,13,31,127,171,1.3333333333333333,0.04692102287185246,660,"With all my student loans, this is the only nest egg I can really afford right now."
2594,1791,10,38,126,174,1.3333333333333333,0.04414667820219519,660,It's rent controlled as long as there are no improvements.
2709,1791,8,41,122,171,1.3333333333333333,0.04309971159206156,660,...and it has a great view of the Hudson!
3470,1791,7,46,127,180,1.3333333333333333,0.04093870605712013,660,Nesting is the new meditation.
2581,1791,10,36,122,168,1.3333333333333333,0.04520544196943266,660,The price is pretty reasonable as far as New York apartments go
3589,1791,13,33,131,177,1.3333333333333333,0.04579567253210014,660,I thought assholes flew south for the winter.
3764,1791,9,47,139,195,1.3333333333333333,0.04026522344686992,660,My nesting instinct kicked in.
3883,1791,13,27,119,159,1.3333333333333333,0.04941071956165224,660,"I'm registered at Bed, Bath and BEYOND."
3893,1791,7,37,109,153,1.3333333333333333,0.04543108504242546,660,"What's not to like? Penthouse view, near the park and just peanuts a month."
4733,1791,9,37,119,165,1.3333333333333333,0.04494665749754948,660,I have a view of a corner office from here.
5341,1791,7,41,117,165,1.3333333333333333,0.043271033731437925,660,Yeah ... Life is tweet.
5352,1791,9,40,125,174,1.3333333333333333,0.043387652946810774,660,"Affordable, cozy and free omelettes every morning!"
5509,1791,14,30,130,174,1.3333333333333333,0.047060517087143136,660,'Sup?
3500,1791,10,35,120,165,1.3333333333333333,0.04576146687125984,660,"Don't worry, my company is generous with maternity leave."
2573,1791,14,33,136,183,1.3333333333333333,0.04540584308523244,660,It's the new housing the current administration is offering to the homeless.
1165,1791,10,36,122,168,1.3333333333333333,0.04520544196943266,660,Once you get used to the worms being shoved down your throat it's pretty kushy up here.
2058,1791,10,35,120,165,1.3333333333333333,0.04576146687125984,660,And the best thing is: it's rent-controlled!
78,1791,9,31,107,147,1.3333333333333333,0.04858766979657162,660,Of course I'll be taking flying lessons.
184,1791,11,36,127,174,1.3333333333333333,0.044892872088377854,660,"The commute's a breeze, it's got an open concept living area, and it's a couple hundred a month less than my old place in Bushwick!"
212,1791,11,41,137,189,1.3333333333333333,0.04244046760528202,660,Mother's out for worms.
241,1791,11,38,131,180,1.3333333333333333,0.043866509313534835,660,Aren't I a hoot?
302,1791,7,43,121,171,1.3333333333333333,0.04229403846542066,660,"It's not a lot of space, but it's hard to pass up a park view and no broker's fee!"
350,1791,12,33,126,171,1.3333333333333333,0.04618206294370681,660,So the gynecologist had good news?
574,1791,10,36,122,168,1.3333333333333333,0.04520544196943266,660,Who says you can't find a cheap apartment in New York?
622,1791,10,31,112,153,1.3333333333333333,0.04818694246524267,660,These new Air Tree-n-Trees are great.
764,1791,9,38,121,168,1.3333333333333333,0.04440997617903022,660,I call it Jane’s eyrie.
2177,1791,8,45,130,183,1.3333333333333333,0.0412479713927618,660,Just relaxing before a flight
1031,1791,7,42,119,168,1.3333333333333333,0.04277468860626115,660,The realtor was right about the view!
959,1791,8,37,114,159,1.3333333333333333,0.045203558799061426,660,My rent is guaranteed until Spring.
1293,1791,13,36,137,186,1.3333333333333333,0.044235681357729775,660,I am waiting for my cat.
1750,1791,11,26,107,144,1.3333333333333333,0.05120915564991892,660,"I called the owner...When I asked how much they said, ""cheep."""
1776,1791,9,38,121,168,1.3333333333333333,0.04440997617903022,660,"It has drawbacks, but the eggs are fresh."
1842,1791,11,34,123,168,1.3333333333333333,0.04598715019526058,660,"But Harold, you're the one who is always telling me my ideas are for the birds."
1935,1791,12,32,124,168,1.3333333333333333,0.04675579089814616,660,"No, Herbert. ""nesting instinct"" is NOT just a metaphor."
1940,1791,11,34,123,168,1.3333333333333333,0.04598715019526058,660,"Rent control, baby!"
5589,1830,10,49,149,208,1.3317307692307692,0.03918489012560131,660,I thought this would be the perfect place to put down roots.
421,1831,12,41,143,196,1.3316326530612246,0.04200741180490468,660,"My realtor described it as ""cozy"" and turns out that it is"
1494,1831,9,47,140,196,1.3316326530612246,0.04009534605506304,660,"I got a great deal! No utilities and a great view of the park for only $2,000 a month!"
2598,1831,11,43,142,196,1.3316326530612246,0.04137987461060812,660,And it costs less than 30% of my gross income!
5214,1831,11,43,142,196,1.3316326530612246,0.04137987461060812,660,"It's a long story: squirrel was evicting pigeon, I happened to
Be walking by with a bag of peanuts..."
1744,1835,12,40,141,193,1.3316062176165804,0.04245069846677186,660,How long? Til they hatch stupid.
741,1836,13,37,140,190,1.331578947368421,0.043551128761128634,660,"They were only asking $2,950 a month — I can't believe I got it!"
1280,1836,10,43,137,190,1.331578947368421,0.0415886575734023,660,I love the open-concept floor plan!
2849,1836,12,39,139,190,1.331578947368421,0.04290694610236795,660,I had to taze an eagle yesterday.
2489,1839,10,42,135,187,1.3315508021390374,0.042030246366935975,660,"Sure, the rent is a little high for a micro-apartment, but you can’t beat the location."
1485,1839,11,40,136,187,1.3315508021390374,0.04270881192368788,660,Who says Airbnb is for the birds?
83,1841,10,41,133,184,1.3315217391304348,0.04248501682453197,660,Just waiting for the burst of the real estate bubble.
5115,1842,11,38,132,181,1.3314917127071824,0.043662335563809586,660,"If it fits, I sits."
512,1843,8,43,127,178,1.3314606741573034,0.04194980428591663,660,"It's called an efficiency loft, very adorable"
1037,1843,9,41,128,178,1.3314606741573034,0.04269971957396818,660,"After 2008, this IS my nest egg."
3897,1843,11,37,130,178,1.3314606741573034,0.04416136315641928,660,"My hormone replacement therapy is working really well, Frank"
1908,1846,9,40,126,175,1.3314285714285714,0.04318104205182189,660,"Treebnb is great, but I'm not wild about the suet buffet breakfast."
4661,1846,10,38,127,175,1.3314285714285714,0.04393499559204485,660,I booked on airB’nTree!
5160,1846,9,40,126,175,1.3314285714285714,0.04318104205182189,660,You’ll never get me out of here. It’s rent controlled.
5479,1849,10,37,125,172,1.3313953488372092,0.04444929704768596,660,You get really good rates at Best Nesterns.
1417,1849,12,33,127,172,1.3313953488372092,0.045953660572821915,660,Nothing much.
837,1849,7,43,122,172,1.3313953488372092,0.04209206148456461,660,I know. But the rent is great and you can’t beat the view...
928,1849,11,35,126,172,1.3313953488372092,0.04520773677190416,660,Why the hell not?
1281,1853,9,38,122,169,1.331360946745562,0.04419045263302087,660,"N'est pas nest, pa?"
1545,1853,7,42,120,169,1.331360946745562,0.04256655198206556,660,I’m just keeping it warm until he finds his acorns.
3408,1853,13,30,126,169,1.331360946745562,0.04727119224697008,660,"It's ok. I'm working from home."""
5548,1856,10,35,121,166,1.3313253012048192,0.04552926289742698,660,"Great natural light, close to work, and best of all it's rent controlled."
4057,1856,11,33,122,166,1.3313253012048192,0.046324217533713456,660,I got it on Aerie B&B.
3045,1856,11,33,122,166,1.3313253012048192,0.046324217533713456,660,"Actually, the male of the species makes the nest."
2172,1856,10,35,121,166,1.3313253012048192,0.04552926289742698,660,"No, I won’t be here forever! We’re migrating south for the winter"
1267,1856,10,35,121,166,1.3313253012048192,0.04552926289742698,660,I thought Mom told you it was time to leave the nest and get a job
795,1861,11,32,120,163,1.3312883435582823,0.04691111256737629,660,"Not now, Frank, I'm nesting."
1041,1861,12,30,121,163,1.3312883435582823,0.047711558812807406,660,"Can you believe it? A park view for under $3,000 a month!"
1683,1861,8,38,117,163,1.3312883435582823,0.04442332040935547,660,It's just my way of coping with Empty Nest Syndrome.
5760,1861,11,32,120,163,1.3312883435582823,0.04691111256737629,660,I always wanted a studio with a view of the Park.
5526,1865,10,33,117,160,1.33125,0.04668396607700813,660,There's so much room ever since I pushed the kids out.
4993,1865,9,35,116,160,1.33125,0.045834226692265556,660,It’s perfect! Central Park views and due a full makeover in the spring.
4623,1865,8,37,115,160,1.33125,0.04496843319793042,660,"I'm house sitting until the eagle gets back from Washington, DC."
4606,1865,8,37,115,160,1.33125,0.04496843319793042,660,"My parents wanted an empty nest,so I found one of my own."
3282,1865,13,27,120,160,1.33125,0.04914510906777011,660,It was such a unique Airbnb I had to stay here! And it was only $200 per night!
996,1865,9,35,116,160,1.33125,0.045834226692265556,660,I  told you I needed to branch out.
150,1865,10,33,117,160,1.33125,0.04668396607700813,660,This explains the pickle cravings.
5528,1872,8,34,109,151,1.3311258278145695,0.046721999020400654,660,It's my pied en plein air.
4288,1873,8,32,105,145,1.3310344827586207,0.04800140923637036,660,And it's got wooden floors!
893,1874,16,35,152,203,1.3300492610837438,0.043301396767202134,660,I told them 'no more worms' so they're out getting me a pizza.
4521,1875,8,49,140,197,1.3299492385786802,0.039272790903701255,660,A bargain at only three thousand a month.
2948,1876,13,37,141,191,1.3298429319371727,0.04335728110033291,660,It's affordable but some damn eagle keeps trying to hatch me.
4222,1877,15,32,141,188,1.3297872340425532,0.04511435750870942,660,What did you expect? I did use Airbnb.
1391,1877,13,36,139,188,1.3297872340425532,0.04383522175777939,660,I used to go to Mexico during winter.
1979,1877,9,44,135,188,1.3297872340425532,0.04115786064427782,660,"Miami was great, the flight was good, but I'm glad to be home"""
327,1880,8,45,132,185,1.3297297297297297,0.04087989576774125,660,She said to watch her house for the winter.
1437,1881,11,38,133,182,1.3296703296703296,0.043459953261404484,660,"If Godot is going to keep us waiting, might as well be comfortable."
2273,1881,11,38,133,182,1.3296703296703296,0.043459953261404484,660,I think it’s going to be a girl.
5379,1881,10,40,132,182,1.3296703296703296,0.04275575715138692,660,It's just a sublease but it's really grown on me.
86,1884,9,41,129,179,1.329608938547486,0.04250086221167456,660,It's a mom thing. I offered to watch the stork's eggs while she made some deliveries
1919,1884,9,41,129,179,1.329608938547486,0.04250086221167456,660,You came back!
3988,1884,10,39,130,179,1.329608938547486,0.043233019642093265,660,and you laughed  when I said I'd find an apartment
151,1887,12,34,130,176,1.3295454545454546,0.045185894404434324,660,I'm just subletting.
922,1887,12,34,130,176,1.3295454545454546,0.045185894404434324,660,So what if there’s no bathroom?  It was a steal at $4200 per month.
2990,1887,9,40,127,176,1.3295454545454546,0.042976270875024675,660,"It's spring; I'm nesting ""."
4043,1887,7,44,125,176,1.3295454545454546,0.041437781413263,660,I'm one step from an empty nester
4126,1887,13,32,131,176,1.3295454545454546,0.04589880301340934,660,It’s open and airy like they advertised.
5578,1887,8,42,126,176,1.3295454545454546,0.04221403550228797,660,"So when she threw me out, I vowed to get a place with a view of the park."
5591,1893,6,45,122,173,1.329479768786127,0.04108181093275233,660,I guess the rental market is a little crazy.
5719,1893,8,41,124,173,1.329479768786127,0.04268655361780553,660,"Nest egg, egg nest, what's the diff?"
3785,1893,8,41,124,173,1.329479768786127,0.04268655361780553,660,"You fly south, I'm staying right here"
5259,1893,5,47,121,173,1.329479768786127,0.04025545744850901,660,"Light, a view and just enough room...everything I want in a place!!"
3174,1893,12,33,128,173,1.329479768786127,0.0457274009787189,660,"Migrate? No, I’m too comfortable."
3017,1893,9,39,125,173,1.329479768786127,0.04346671364264241,660,I sacrificed a lot of comforts to get this park view.
1082,1893,13,31,129,173,1.329479768786127,0.046456523066133903,660,"You can sit, but I’m warning you, I haven’t had a poop today."
4755,1900,8,40,122,170,1.3294117647058823,0.04317415544570702,660,This is a comfortable place to rest until the eagles return in the spring.
4234,1900,10,36,124,170,1.3294117647058823,0.04475751319050946,660,Gentrification really has no boundaries.
3363,1900,11,34,125,170,1.3294117647058823,0.04552854743205527,660,I booked at Airybnb.
3296,1900,11,34,125,170,1.3294117647058823,0.04552854743205527,660,It’s part of Osprey rescue. I’m egg sitting while the parents search for food.
2654,1900,12,32,126,170,1.3294117647058823,0.04628673973771737,660,"What can I say, it gives me joy."
2176,1900,8,40,122,170,1.3294117647058823,0.04317415544570702,660,"I love it Dad. Great view, cheap rent, close to work.  Branching out just like you talked about."
1256,1900,9,38,123,170,1.3294117647058823,0.04397296149595056,660,"Could you tell the post office about my new location?"""
606,1907,14,27,126,167,1.3293413173652695,0.048379790457371376,660,I found it on AirBnB in the Migratory Birds section
1945,1907,15,25,127,167,1.3293413173652695,0.04911974136324298,660,My aim has  gotten  much better.  Want to see?
2991,1907,7,41,119,167,1.3293413173652695,0.04284378667263339,660,Get down from there Robin.
3440,1907,12,31,124,167,1.3293413173652695,0.046864852404693666,660,"Thanks, but it's just until the owners get back in a couple months."
3943,1907,7,41,119,167,1.3293413173652695,0.04284378667263339,660,I'm trans-species!
2462,1912,11,32,121,164,1.329268292682927,0.04666793184247682,660,It was the cheapest option on Airbnb!
3720,1912,14,26,124,164,1.329268292682927,0.04901373235855203,660,Found it on Airbnb for only $220 a night!
2346,1914,9,35,117,161,1.329192546583851,0.045595096782268904,660,"Not exactly the nest egg I'd envisioned, Honey"
2537,1914,6,41,114,161,1.329192546583851,0.04296502759135717,660,"...and on top of everything else, it’s rent controlled!"
2919,1916,10,32,116,158,1.3291139240506329,0.047038419554538476,660,"I think I could list it on AirBNB as a ""Hip City Nest"""
4169,1916,10,32,116,158,1.3291139240506329,0.047038419554538476,660,"Honey, I don't think this stops us from being empty nesters."
4573,1918,5,41,109,155,1.3290322580645162,0.04304076595611678,660,Ever since the kids left home I have these impulses that just come over me.
3168,1918,12,27,116,155,1.3290322580645162,0.04938641309124241,660,I think I might be pregnant.
4353,1918,8,35,112,155,1.3290322580645162,0.04586795260062676,660,i think of it as the beginning of the tinier house movement
5492,1921,10,30,112,152,1.3289473684210527,0.04830367135336772,660,She's watching my kids and I'm watching hers.
2947,1921,11,28,113,152,1.3289473684210527,0.049197388568447756,660,"A snowbird sublet it to me cheap, cheap."
4387,1923,6,35,102,143,1.3286713286713288,0.046312059261884586,660,And I only have two roommates.
2332,1924,10,25,102,137,1.3284671532846715,0.05191635551804841,660,It's just such a relief to find a place I can actually afford out here.
1478,1925,14,37,147,198,1.3282828282828283,0.042862509167570735,660,I told you I could get an apartment on the Upper West Side.
4074,1926,10,44,141,195,1.3282051282051281,0.04080697740703644,660,And they sublet it to me for a sack of sunflower seeds!
4540,1926,13,38,144,195,1.3282051282051281,0.04270613173086513,660,I found a place right on the beech.
5702,1926,11,42,142,195,1.3282051282051281,0.04144969842114162,660,Great view and sooooo affordable.
1724,1929,16,31,145,192,1.328125,0.045020393926842726,660,My parents threw me out of their basement.
1432,1929,9,45,138,192,1.328125,0.04055950217425057,660,I won't move back in with my parents.
932,1931,12,38,139,189,1.3280423280423281,0.042987794286918075,660,It's not the biggest place but you know how rent is in New York.
2601,1931,15,32,142,189,1.3280423280423281,0.04490893372864598,660,"Seriously Irma, that isn't what is meant by your family tree !"
984,1933,13,35,138,186,1.3279569892473118,0.04412428078811824,660,It’s cheaper than a studio.
5753,1933,7,47,132,186,1.3279569892473118,0.03997769781342968,660,I've got my choice of lots of chicks.
309,1935,11,37,132,180,1.3277777777777777,0.0437464589721055,660,"It's only $1,500 a month plus utilities."
1198,1935,10,39,131,180,1.3277777777777777,0.043031144839143214,660,Not many amenities but I do like the view!
4121,1935,10,39,131,180,1.3277777777777777,0.043031144839143214,660,I take Twitter really seriously.
5102,1938,12,34,131,177,1.3276836158192091,0.0449684412117038,660,The squirrels have been friendly since I told them I'm nuts!
3370,1938,10,38,129,177,1.3276836158192091,0.04351733027467228,660,"I just wasn't ready to leave the nest, so Mom & Dad set me up here."
2864,1938,10,38,129,177,1.3276836158192091,0.04351733027467228,660,You told me to find a place of my own.
2297,1938,4,50,123,177,1.3276836158192091,0.038840056924626824,660,"Honestly, adding feathers has made all the difference!"
2167,1938,10,38,129,177,1.3276836158192091,0.04351733027467228,660,How´s this for eco-friendly housing?
855,1938,10,38,129,177,1.3276836158192091,0.04351733027467228,660,I flew the coup.
2361,1938,11,36,130,177,1.3276836158192091,0.04424883466965751,660,It's bigger than my nest egg.
322,1945,13,31,130,174,1.3275862068965518,0.04622755798616428,660,Climate change has been rough on us snowbirds.
1110,1945,9,39,126,174,1.3275862068965518,0.04325764724465567,660,I found a sublet on Eggslist.
1711,1945,10,37,127,174,1.3275862068965518,0.04401891426646442,660,"I'm pregnant and all the books say I am supposed to start nesting, so does that answer your question?"
3024,1945,13,31,130,174,1.3275862068965518,0.04622755798616428,660,My parents thought they kicked me out of the nest. But I'm showing them!
4586,1945,12,33,129,174,1.3275862068965518,0.04550325646927813,660,"My parents wanted to be empty nesters, so I moved in here.”"
5711,1945,8,41,125,174,1.3275862068965518,0.04248274093191007,660,It's rent-controlled--and has air rights!
5510,1951,10,36,125,171,1.327485380116959,0.044536684829613496,660,"In this housing market, I'd say I won the lottery"
5020,1951,10,36,125,171,1.327485380116959,0.044536684829613496,660,I guess my nesting instinct is just a lot stronger than yours.
3803,1951,9,38,124,171,1.327485380116959,0.04375747760106747,660,"Sure, it’s a little drafty, but you can’t beat two grand a month."
2846,1951,12,32,127,171,1.327485380116959,0.04605556638258975,660,Mom is jogging around the park she put me here so I could watch her and be safe
476,1951,9,38,124,171,1.327485380116959,0.04375747760106747,660,"Besides the view, we have a very motivated seller."
9,1951,13,30,128,171,1.327485380116959,0.04679652384980678,660,You said you were looking forward to having an empty nest so I made my own.
3175,1951,7,42,122,171,1.327485380116959,0.04215587677654345,660,It's a perfact place to people watch!
16,1958,10,35,123,168,1.3273809523809523,0.04507148569810188,660,"You might say I am a squatter, the occupants left for the winter!"
159,1958,12,31,125,168,1.3273809523809523,0.04662628895691385,660,"Honey, that's not a nest. It's a porcupine!"
1805,1958,11,33,124,168,1.3273809523809523,0.045855477562270736,660,So far it's been great - but I'm dreading the flying lessons.
5543,1958,9,37,122,168,1.3273809523809523,0.044273613175394785,660,Empty nest syndrome? Not me!
3395,1962,9,36,120,165,1.3272727272727274,0.04480691627437607,660,Polly isn't home...I'm the surrogate.
2789,1962,7,40,118,165,1.3272727272727274,0.04312586330734917,660,The AirBirdnB description was perfect.
2284,1962,12,30,123,165,1.3272727272727274,0.04721640854661778,660,I rented it from an empty nester for $1.98 a month plus a handful of worms....
1108,1962,5,44,116,165,1.3272727272727274,0.04137656856228394,660,It’s a time share.
415,1962,12,30,123,165,1.3272727272727274,0.04721640854661778,660,I've got a bird's eye view & I'm tweeting about it!
1972,1962,7,40,118,165,1.3272727272727274,0.04312586330734917,660,"I'm subletting from a Peregrine falcon, but I can't say anything to the arborist or I'll be kicked out."
1756,1968,12,29,121,162,1.3271604938271604,0.04782698199287786,660,This doesn’t change the fact we’re still empty nesters.
3722,1968,8,37,117,162,1.3271604938271604,0.044505002664205734,660,I’m hatching a plan for our future.
5568,1968,11,31,120,162,1.3271604938271604,0.0470184960461895,660,No one looks down on me.
982,1971,11,30,118,159,1.3270440251572326,0.047630633866600894,660,"Hey buddy, could you keep it warm while I grab some coffee?"
5287,1971,9,34,116,159,1.3270440251572326,0.04592879587725082,660,She exhausted her maternity leave and needed someone to cover.
1953,1973,6,39,111,156,1.3269230769230769,0.04377121278334116,660,Think of it as a loft apartment with great views we can afford!
5737,1974,9,31,110,150,1.3266666666666667,0.04776589693252739,660,Just $75 a night during the off-season on this new Nest sharing app.  Prices skyrocket in spring especially for Park views.
5350,1975,9,30,108,147,1.3265306122448979,0.04842430550585128,660,Very cozy. But bathroom trips are a bummer.
865,1976,10,42,138,190,1.3263157894736841,0.04147396409711801,660,I'm thinking of going south this winter.
869,1976,13,36,141,190,1.3263157894736841,0.043441616861481194,660,It's surprisingly affordable.
970,1976,12,38,140,190,1.3263157894736841,0.04279578580891849,660,"Yes, the carbon-neutral concept is called AirB&Tree . Can I give you my kickstarter link?"
4747,1976,8,46,136,190,1.3263157894736841,0.040108603975397075,660,"Its not so bad. Plus, it's rent-controlled!"
2610,1980,7,46,131,184,1.326086956521739,0.040207196283129416,660,"It came open last September."""
4777,1980,9,42,133,184,1.326086956521739,0.041658272833078984,660,All I have to do is keep a few eggs warm for her.  She's cuckoo.
4612,1982,10,39,132,181,1.3259668508287292,0.04283104407362277,660,The view is great and I’m starting to like the worms.
4731,1982,11,37,133,181,1.3259668508287292,0.043541769493690194,660,What empty nest syndrome?
5253,1984,8,42,128,178,1.3258426966292134,0.041819958075079836,660,‘’My tiny house is being renovated.”
4748,1984,9,40,129,178,1.3258426966292134,0.04257216068594883,660,That’s right. Search for ‘urban treehouse’. I’m nearly certain it is available next weekend.
972,1984,13,32,133,178,1.3258426966292134,0.045456668968870746,660,"I usually have flown south, but it's gotten so crowded down there."
1431,1984,6,46,126,178,1.3258426966292134,0.040273427334457275,660,Utilities are included.
22,1988,13,31,131,175,1.3257142857142856,0.046000744519671226,660,Real estate tends to open up when everyone else flies south for the holidays.
2822,1988,9,39,127,175,1.3257142857142856,0.043050467086861006,660,"It's only $2,100/month AND it's got a great view of the park!"
4303,1990,11,34,127,172,1.3255813953488371,0.045078562162536646,660,I could live here but there's no wifi.
2423,1990,13,30,129,172,1.3255813953488371,0.04656259956929364,660,And there’s free WiFi!
5310,1990,10,36,126,172,1.3255813953488371,0.04431791184879234,660,"Yeah, I’m nesting."
1886,1990,12,32,128,172,1.3255813953488371,0.045826588599262245,660,"Yes, actually I am a cuckoo!"
1538,1990,8,40,124,172,1.3255813953488371,0.042756033476325006,660,"Oh baby, nesting is better than I thought."
2258,1990,12,32,128,172,1.3255813953488371,0.045826588599262245,660,Wanna mate for life?
2762,1996,11,33,125,169,1.3254437869822486,0.045624479337524976,660,These days you have to take advantage of empty nest syndrome.
117,1997,9,36,121,166,1.3253012048192772,0.04457979335040287,660,I usually fly south for the Winter.
2074,1997,8,38,120,166,1.3253012048192772,0.04375315560090313,660,Other than the diet of insects and worms it’s actually quite comfy!
5058,1997,10,34,122,166,1.3253012048192772,0.045391379416056615,660,The roommate situation isn’t so bad once you realize it’s the cheapest place you can get with this much natural light.
398,2000,9,35,119,163,1.3251533742331287,0.045123842299755586,660,Attracting nesting females isn't as easy as it used to be.
4815,2000,6,41,116,163,1.3251533742331287,0.042531635964025885,660,I'm fine boss...just waiting for my next big idea to hatch
4925,2000,9,35,119,163,1.3251533742331287,0.045123842299755586,660,Its my Central Park nest egg.
862,2003,10,32,118,160,1.325,0.046539021295517756,660,This is all I could afford with my tax refund this year.
4266,2004,9,46,142,197,1.3248730964467006,0.03981469360262307,660,"... so I said: “No, it’s time for you to leave the nest!”"
5670,2005,9,33,115,157,1.3248407643312101,0.046269065625979565,660,"Hey Dad, have you made my student loan payment yet?"
4727,2005,9,33,115,157,1.3248407643312101,0.046269065625979565,660,It's been quiet since the cats gave up.
2109,2005,7,37,113,157,1.3248407643312101,0.044469178081509325,660,"Great view, affordable rent, and my landlord is the nicest pigeon you'll ever meet!"
2154,2005,10,31,116,157,1.3248407643312101,0.04714324714345959,660,"I'd invite you up, but I'm expecting company."
1736,2009,10,43,141,194,1.324742268041237,0.04086991310704407,660,I'll go out on a limb and say you look up to me.
880,2010,7,36,111,154,1.3246753246753247,0.04502507283575765,660,"You can stay here, but don’t eat my roommate’s acorns."
1768,2011,9,43,136,188,1.324468085106383,0.04103821277190971,660,Last vacation it was swimming with sharks.
4764,2011,10,41,137,188,1.324468085106383,0.0417255820923748,660,The homeowner association dues are only $400 a month.
689,2013,13,34,138,185,1.3243243243243243,0.04421283734960204,660,Any minute now I should be getting a regurgitated hotdog.
1906,2013,11,38,136,185,1.3243243243243243,0.04286334300239983,660,I'm 26 weeks.
2428,2013,12,36,137,185,1.3243243243243243,0.04354331843029274,660,Guess who rolled our life savings into a self-directed account?
5445,2016,11,37,134,182,1.3241758241758241,0.043338891984275485,660,"I'm working on our nest egg"""
5318,2016,8,43,131,182,1.3241758241758241,0.04118399270031298,660,"Even better, DoorDash delivers!"
1858,2018,10,27,108,145,1.3241379310344827,0.049791479579978114,660,"Yes, one should always know one's family tree."
1384,2019,8,42,129,179,1.324022346368715,0.04162549323409649,660,"No, but what I'm really worried about is Brexit."
1510,2019,12,34,133,179,1.324022346368715,0.044539471051341824,660,"The rent is low, plus I get park views and I get fresh eggs every morning."
3635,2019,12,34,133,179,1.324022346368715,0.044539471051341824,660,Just protecting my nest egg!
4500,2019,9,40,130,179,1.324022346368715,0.042372778828154385,660,"Better view, less overhead"
111,2023,10,37,129,176,1.3238636363636365,0.04359635273351086,660,"As your financial planner, we need to talk about growing your nest egg."
5010,2023,9,39,128,176,1.3238636363636365,0.04284515032917535,660,"Hey, Mister. Could you climb up here and egg-sit for me for 30 minutes so I can pick up my mail and take a bathroom break?"
71,2025,9,38,126,173,1.323699421965318,0.043332432464046874,660,The kids finally flew the coop. Now I have room to stretch out.
3071,2025,13,30,130,173,1.323699421965318,0.046330908082552615,660,The squirrels air b&b was $409 cheaper than yours.
4231,2025,7,42,124,173,1.323699421965318,0.04175252127716128,660,It's under market AND has 360 degree views of Central Park!
5402,2028,10,35,125,170,1.3235294117647058,0.04462235955501362,660,I’m spending more of my time on The Internest now.
4223,2028,8,39,123,170,1.3235294117647058,0.04303402936872585,660,"Sounds like fun,but my mate will be returning  soon with bagels and latte"
341,2028,8,39,123,170,1.3235294117647058,0.04303402936872585,660,Two words: Rent Control.
396,2028,9,37,124,170,1.3235294117647058,0.04383538899088996,660,"Don't worry, I'm just babysitting."
2316,2028,8,39,123,170,1.3235294117647058,0.04303402936872585,660,Guess who won the Easter egg hunt!
565,2033,11,32,124,167,1.3233532934131738,0.045952599202686496,660,"''They left me a  nest egg"""
2031,2033,11,32,124,167,1.3233532934131738,0.045952599202686496,660,"This is the only mortgage I could qualify for.  Of course, I had to wait for the family of  Robins to move out!"
1522,2035,10,33,121,164,1.3231707317073171,0.04571736520080191,660,I’ve been looking down on people my whole life.
4114,2035,8,37,119,164,1.3231707317073171,0.04405047199212537,660,You should check out Tiny Nest Living on HGTV.
1987,2037,8,36,117,161,1.3229813664596273,0.04458442030064125,660,"Divorce is not that bad"""
2259,2038,12,27,119,158,1.3227848101265822,0.04857809463183497,660,When I said we need a nest egg I was thinking maybe a Roth IRA or municipal bonds.
5455,2038,9,33,116,158,1.3227848101265822,0.04602123762796011,660,But... I thought you weren't due for another 6 months?
1385,2038,10,31,117,158,1.3227848101265822,0.04688901756160624,660,I’m still on my parents’ insurance.
2059,2038,6,39,113,158,1.3227848101265822,0.04331370854081682,660,"Plenty of space, access to WiFi, great view and only $1k a month!"
3038,2042,13,34,139,186,1.3225806451612903,0.044009048133873505,660,It's only 750K here in Vancouver! And I can have pets.
4148,2042,10,40,136,186,1.3225806451612903,0.04198128632314873,660,You like ‘em scrambled or over easy? Just kidding.”
5190,2042,9,32,114,155,1.3225806451612903,0.046616103119451975,660,"Threesome? Oh, I thought you said  ‘let’s get high and have a treesome.’"
1723,2042,4,42,109,155,1.3225806451612903,0.04188227748387747,660,My nesting instinct suddenly kicked in!
4315,2046,13,33,137,183,1.3224043715846994,0.04450807406070822,660,"It's one whole square foot, only $500/week and I for one am relieved we Millenials can still find affordable housing in NYC."
1491,2047,7,35,110,152,1.3223684210526316,0.04535016704617843,660,"The temperature control isn't great, but it's only $600 per month!"
1593,2047,10,29,113,152,1.3223684210526316,0.048146160577332814,660,Keep staring at me and I'm gonna shit on your head.
5228,2047,13,23,116,152,1.3223684210526316,0.05078846232718948,660,Right in the middle of New York and the rent's only three-hundred grand per month.
3297,2050,11,36,133,180,1.3222222222222222,0.04362212574454302,660,The furniture arrives this afternoon.
2536,2051,9,30,110,149,1.3221476510067114,0.04787186663834796,660,"And I'll tell you, it's a steal on Airbnb this time of year."
768,2051,10,28,111,149,1.3221476510067114,0.048809940965001956,660,Remember when I said park views were affordable?
1060,2051,8,32,109,149,1.3221476510067114,0.046915039101258,660,I'm babysitting.
426,2054,6,45,126,177,1.3220338983050848,0.04032007429315723,660,Don't worry. I'm sure you'll be able to afford an apartment this large someday.
2857,2054,8,41,128,177,1.3220338983050848,0.04188210908945813,660,"What does ""movin' on up"" mean to YOU?"
4923,2054,13,31,133,177,1.3220338983050848,0.04555346022773848,660,I’m reducing my carbon footprint.
4839,2057,10,27,109,146,1.321917808219178,0.0494990793603276,660,"Honey, I don’t think this is what the doctor meant by “nesting” before delivery."
2227,2058,9,38,127,174,1.3218390804597702,0.04312282247903843,660,A little birdy told me I might find you up there.
2288,2058,9,38,127,174,1.3218390804597702,0.04312282247903843,660,"Finally, it’s all mine.  It only took 22 years and $250,000 in tuition."
2696,2060,9,47,146,202,1.3217821782178218,0.039103594959514085,660,Where else can you get an airy one-bedroom with skyline views for only $2500?
1567,2061,8,39,124,171,1.3216374269005848,0.04282344355053144,660,"Hi, dad -- I've finally come home to roost!"
528,2061,10,35,126,171,1.3216374269005848,0.04440097089855535,660,"That word's not even in my vocabulary. I call it ""autumn""."
4543,2061,9,37,125,171,1.3216374269005848,0.04361933937062729,660,The view is amazing and the rent is super cheep!
5396,2061,7,41,123,171,1.3216374269005848,0.04201247276608638,660,"The bed's ok, but the breakfast service is real hit or miss. Watch your step."
2720,2065,8,48,143,199,1.321608040201005,0.038832606231281507,660,"City-skyline views; open air everything, no chance of going co-op and best of all, I don't need a room mate."
4349,2066,6,42,120,168,1.3214285714285714,0.0416386520347698,660,Finally cured my empty nest syndrome!
5186,2066,9,36,123,168,1.3214285714285714,0.04413202172529347,660,"It might be small, but it's a really smart layout."
2876,2068,17,28,148,193,1.3212435233160622,0.04531210776567898,660,Every single twig sparks joy!
4334,2069,11,31,123,165,1.3212121212121213,0.04628703051057582,660,"I figured if the President of the United States tweets so much, so can I."
3362,2069,11,31,123,165,1.3212121212121213,0.04628703051057582,660,Yup. Just got back. Spent the whole winter in Miami Beach !
5442,2069,9,35,121,165,1.3212121212121213,0.044661723359854744,660,I’ve been declared an endangered species
642,2072,16,29,145,190,1.3210526315789475,0.04521546839119001,660,"Plus, the kids aren't yours and I never loved you!"
409,2072,13,35,142,190,1.3210526315789475,0.043328445670529306,660,Listing: One bedroom. Skylight. Prime location by a public park. Teach your kids to fly by pushing them out.
301,2074,9,34,119,162,1.3209876543209877,0.04520936054380973,660,I'm ready to talk about having kids
383,2074,3,46,113,162,1.3209876543209877,0.039796970540118055,660,Wanna nestle?
1112,2074,11,30,121,162,1.3209876543209877,0.04687482003147566,660,I feel free as a bird
1488,2074,10,32,120,162,1.3209876543209877,0.0460496201600155,660,I couldn’t take being an “empty nester” any more.
4164,2074,7,38,117,162,1.3209876543209877,0.04348015419219587,660,"Yeah, it’s rent stabilized."
1349,2079,9,42,136,187,1.320855614973262,0.041098097554625554,660,I sublet it during the off season.
2062,2080,11,29,119,159,1.320754716981132,0.047483235441954395,660,I just felt it was time to fly the coop.
2770,2080,7,37,115,159,1.320754716981132,0.04400240521194316,660,Best night's sleep I've had in a week.
362,2080,9,33,117,159,1.320754716981132,0.045775917863392517,660,Honey I don't think is what the doctor meant when she talked about 'nesting'
774,2080,7,37,115,159,1.320754716981132,0.04400240521194316,660,She had a preening appointment so I said I'd sit in for an hour or two.
819,2084,10,39,135,184,1.3206521739130435,0.04224117649332069,660,Now I am a protected species!
1378,2084,15,29,140,184,1.3206521739130435,0.045621263110009844,660,I'm not a cuckoo; I'm a loon.
2825,2084,14,31,139,184,1.3206521739130435,0.044965577017427115,660,"If you don't have bread crumbs, keep moving--nothing to see here."
4054,2084,8,43,133,184,1.3206521739130435,0.04081083102626945,660,"I wasn't sure about this tiny house thing, but it turns out this is all the space I need!"
2377,2088,9,32,115,156,1.3205128205128205,0.046362454761498015,660,"On the bright side, I'm growing a nice nest egg living here"
1568,2089,8,42,131,181,1.3204419889502763,0.041241612664012335,660,My agent is always telling me that park side real estate is a can't miss.
1902,2089,5,48,128,181,1.3204419889502763,0.038944942579407164,660,At least I can afford the rent.
4426,2089,11,36,134,181,1.3204419889502763,0.04341696301842776,660,"Okay, it's not rent control, but I can afford it."
5699,2092,11,35,132,178,1.3202247191011236,0.04391030624268102,660,"$3500 per month, but utilities are included!"
1844,2092,9,39,130,178,1.3202247191011236,0.042440017085156864,660,And we can afford it.
2680,2092,10,37,131,178,1.3202247191011236,0.04318141987310305,660,"Hey pretty boy, come back when it's mating season."
715,2092,8,41,129,178,1.3202247191011236,0.04168543004599562,660,"Hi Dad, I'm home to roost!"
796,2092,11,35,132,178,1.3202247191011236,0.04391030624268102,660,I’ve taken squatting to the next level
1471,2097,12,41,150,203,1.3201970443349753,0.0407781669718111,660,"Yeah, Mom said she will be taking me for my first flight soon."
4418,2098,7,42,126,175,1.32,0.041356315449834334,660,It's a Nordic thing. You'll read about it next year.
2028,2098,9,38,128,175,1.32,0.04291512224810488,660,My broker told me create a nest egg before it's too late.
2164,2098,8,32,110,150,1.32,0.046650684383699674,660,"It's a little out my budget, but it has a great view and it's in the Village!"
3453,2098,6,44,125,175,1.32,0.04055444960290321,660,And I can Air B&B it on the weekends!
3542,2098,13,30,132,175,1.32,0.0458741048690538,660,"Once you get over birds vomiting in your mouth, it’s a pretty good life"
3709,2098,9,38,128,175,1.32,0.04291512224810488,660,The real-estate agent said it had a birds-eye view
5110,2098,11,34,130,175,1.32,0.04441925942148704,660,"Yes, I could use a roommate, but could you afford it."
2625,2105,13,37,147,197,1.3197969543147208,0.042227914029124486,660,I'm building my nest egg.
2996,2106,6,43,123,172,1.319767441860465,0.04098806464752126,660,Not all of us snowbirds head to Florida for the winter.
2974,2106,9,37,126,172,1.319767441860465,0.04340529704497411,660,"Yeah, the rent’s pretty steep - but it’s got a great view of the park."
1206,2106,10,35,127,172,1.319767441860465,0.044181662118652695,660,This place is for the birds.
1304,2106,7,41,124,172,1.319767441860465,0.04180933986029598,660,I found it on Fresh Airbnb
1977,2110,7,33,107,147,1.3197278911564625,0.04628234241322265,660,"Sweetheart, it’s so comfy and a great view of the park.  And best of all it fits our budget."
3596,2111,14,34,146,194,1.3195876288659794,0.04329566224422362,660,"It’s not a lot of square footage, but at least it’s rent controlled."
2650,2112,9,36,124,169,1.319526627218935,0.04391131738384708,660,"You may think this is for the birds, but it is free and comfortable."
5306,2112,9,36,124,169,1.319526627218935,0.04391131738384708,660,The only draw back is having to get up at the crack of dawn
1370,2112,9,36,124,169,1.319526627218935,0.04391131738384708,660,Winter came so early this year. I'm supposed to be in Florida by now.
1433,2112,12,30,127,169,1.319526627218935,0.04625506381780278,660,The owner wanted to go to South Africa for the winter and a home exchange seemed like a great idea!
2741,2112,7,40,122,169,1.319526627218935,0.04227669615894292,660,"I used to go south when it gets this cold, but park visitors have been feeding me."
2644,2117,13,35,143,191,1.3193717277486912,0.04313376267732791,660,They were right!  Heat rises!
2406,2117,14,33,144,191,1.3193717277486912,0.043767945847344204,660,...and it’s rent-stabilized!
281,2119,5,43,118,166,1.319277108433735,0.041015902335066266,660,"It gets a little cold at night, sure, but it's cheaper than my old apartment and you just can't beat the view."
1323,2119,13,27,126,166,1.319277108433735,0.04760734234739391,660,Marie Condo recommended it.
1798,2119,8,37,121,166,1.319277108433735,0.04360461322776577,660,"According to my realtor, this was a real steal before the spring migration"
2464,2119,9,35,122,166,1.319277108433735,0.04443401450320272,660,I just open my mouth -- she's the mother I always dreamed of having!
2546,2119,6,41,119,166,1.319277108433735,0.04189658213371919,660,"How I got up here? I'm a little cuckoo, so I flew."
2727,2119,11,31,124,166,1.319277108433735,0.04604802216302452,660,"Let me know if you find anything shiny, will ya"
3105,2119,11,31,124,166,1.319277108433735,0.04604802216302452,660,"Once you develop a taste for worms and dead squirrels, it's pretty cushy."
3443,2119,6,41,119,166,1.319277108433735,0.04189658213371919,660,"Laugh now, but wait 'til you see it in summer."
1998,2127,6,48,134,188,1.3191489361702127,0.03877279767158534,660,"Congratulations, I'm on the nest. And yes, you're going to be a dad."
2146,2127,8,44,136,188,1.3191489361702127,0.04021328668676119,660,"Free rent, view of Central Park, short commute. It works you don’t mind eating regurgitated worms."
2476,2127,13,34,141,188,1.3191489361702127,0.04360682163752046,660,"Overall, it's great.  But the HOA board is a bunch of cuckoos."
3752,2127,5,50,133,188,1.3191489361702127,0.038032098888264344,660,Rent goes way down in the winter.
4778,2127,8,44,136,188,1.3191489361702127,0.04021328668676119,660,It redefines “tiny house.”
3390,2132,12,28,123,163,1.3190184049079754,0.04743318406847935,660,This isn't what I meant when I said you need to build your nest egg
3151,2132,5,42,116,163,1.3190184049079754,0.04146956012066838,660,Why are you looking at me like that? I’m house sitting!
2359,2132,6,40,117,163,1.3190184049079754,0.042372925065903344,660,"It’s a “climb up,” cheaper than my old place."
5454,2132,4,44,115,163,1.3190184049079754,0.04054607323234642,660,Just setting up my Twitter.
189,2132,12,28,123,163,1.3190184049079754,0.04743318406847935,660,The rent? Cheap cheap cheap.
171,2132,9,34,120,163,1.3190184049079754,0.04497428003601004,660,"It's not very comfortable, but I need the eggs."
1422,2132,8,36,119,163,1.3190184049079754,0.04412420540608659,660,"I’m an installation exploring the boundaries between performance art and not paying rent. Pretty subversive, isn’t it?"
3394,2139,9,41,135,185,1.318918918918919,0.041343401461563116,660,Think of it like your man cave.
4383,2139,10,39,136,185,1.318918918918919,0.042047963696146724,660,This was the only vacation spot I could afford on my tax refund this year!
1821,2141,9,33,118,160,1.31875,0.04553307164257147,660,My mom comes by and throws up in my mouth.
28,2142,8,42,132,182,1.3186813186813187,0.04105215815330396,660,It isn't as easy to leave the nest as you think
1990,2142,10,38,134,182,1.3186813186813187,0.04250535524888666,660,I never thought my nesting instinct would be so strong once I was pregnant
3907,2142,11,36,135,182,1.3186813186813187,0.043213632024271524,660,These summer home rentals get so affordable once the temperature drops.
4482,2142,9,40,133,182,1.3186813186813187,0.041785074571418064,660,"It's vegan, gluten-free, and environmentally sustainable"
3275,2146,9,32,116,157,1.3184713375796178,0.046111419288204794,660,Just fulfilling my nesting instinct
2142,2146,7,36,114,157,1.3184713375796178,0.04430512785351613,660,"It's the hottest thing in bargain B&Bs, though not everyone cares for the breakfasts."
1021,2146,8,34,115,157,1.3184713375796178,0.045217293942080586,660,Just another example of the Millennial's sense of entitlement.
274,2146,9,32,116,157,1.3184713375796178,0.046111419288204794,660,"No, bro - I asked if you wanted to SIT on chicks with me in the park. Only weirdos still hit on women in public."
5770,2150,8,41,130,179,1.318435754189944,0.04149048215641377,660,"Until April when the Storks are back, then housesitting in Sarasota for the Snowbirds."
714,2150,13,31,135,179,1.318435754189944,0.04511445004387252,660,Waiting for my ex to park his car down there.
2754,2150,11,35,133,179,1.318435754189944,0.04370094055607176,660,The last owner was an empty-nester.
3680,2150,8,41,130,179,1.318435754189944,0.04149048215641377,660,What? Never seen an empty nester before?
4607,2150,7,43,129,179,1.318435754189944,0.04072701082738352,660,The rent’s cheap.
4824,2150,11,35,133,179,1.318435754189944,0.04370094055607176,660,Dad’s will is clear. The nest egg is in my name.
5033,2150,7,43,129,179,1.318435754189944,0.04072701082738352,660,'I call it Central Park North.
5204,2150,6,45,128,179,1.318435754189944,0.03994895132911423,660,"Listen, if you're going to buy, buy now.  The market for trees in this park is hot."
3382,2158,8,33,113,154,1.3181818181818181,0.045792816505496894,660,"Fresh air, great view, rent-free."
4477,2158,10,36,130,176,1.3181818181818181,0.04346285852125068,660,"No, I'm not crazy, hon. Nesting is quite natural for women in my condition."
1767,2158,7,35,112,154,1.3181818181818181,0.044856433269738406,660,Wanna grab some lunch? I'm free as a bird.
5057,2158,13,30,133,176,1.3181818181818181,0.045648934989147856,660,Snowbirds? They're migratory. I house sit for them while they are in Florida.
4358,2162,14,34,147,195,1.317948717948718,0.04310422960405288,660,I'm the anti-empty-nester.
1338,2162,10,42,143,195,1.317948717948718,0.040577114650232074,660,It’s New York—I’m always looking for a cheep apartment.
966,2164,9,37,127,173,1.3179190751445087,0.04319323668380132,660,It's the best new eating experience in New York when the mother eagle comes back.
1764,2164,11,33,129,173,1.3179190751445087,0.04472228041451216,660,my therapist said i need to branch out
2344,2164,10,35,128,173,1.3179190751445087,0.04396440640277733,660,It's a sublet... The renter went south for the winter.
2374,2164,9,37,127,173,1.3179190751445087,0.04319323668380132,660,I live in a tree. I'm interesting.
3486,2164,9,37,127,173,1.3179190751445087,0.04319323668380132,660,"Not only is it free, in spring they come back and feed me worms!"
3540,2164,9,37,127,173,1.3179190751445087,0.04319323668380132,660,Don’t worry—it’s only a sublet
2736,2170,8,45,139,192,1.3177083333333333,0.039638621601899154,660,"Hey, the rent's reasonable and I need the eggs."
3670,2170,12,37,143,192,1.3177083333333333,0.04230095045928142,660,The rent was great for a place with 360 degree views and no roommates!
1507,2170,7,47,138,192,1.3177083333333333,0.03894461195959638,660,What do you pay for rent?
2218,2170,9,43,140,192,1.3177083333333333,0.04032068754762938,660,"It's called ""The Nest."" It's the latest in low-impact micro habitats."
1058,2174,7,40,123,170,1.3176470588235294,0.04206928253093018,660,"Yeah, but you can't beat the rent."
4290,2174,9,36,125,170,1.3176470588235294,0.04369269757311607,660,You'll love being an empty nester!
4417,2176,8,37,122,167,1.3173652694610778,0.04338486622170629,660,How do you like my new Beech house?
5152,2177,7,45,134,186,1.3172043010752688,0.039718914389979085,660,Dogsitting's become too damn competitive.
3902,2178,8,36,120,164,1.3170731707317074,0.0438974509610867,660,I didn't want to move back in with my parents.
4452,2178,8,36,120,164,1.3170731707317074,0.0438974509610867,660,"It only costs me $1,200 a month! And, I have a great yard!"
4752,2178,7,38,119,164,1.3170731707317074,0.04303683889174222,660,Once again my eagle scout training has come in handy!
5438,2178,14,37,154,205,1.3170731707317074,0.04160523752070703,660,Sorry. It's a self love nest.
5486,2182,11,36,136,183,1.3169398907103824,0.04301211020510219,660,"They took me in when I broke my foot. At first I was in a shoe box with a dish of water, but now I can roam round the nest. They say they'll release me soon."
4811,2182,9,40,134,183,1.3169398907103824,0.04159258519906689,660,"""I just figured it was high time for the tree to start hugging me."""
1075,2182,14,30,139,183,1.3169398907103824,0.04505762250082869,660,"I got picked for that reality show Wife Swap, and the other couple are California Condors"
90,2182,11,36,136,183,1.3169398907103824,0.04301211020510219,660,When the leaves grow in I won't have to see you anymore.
2455,2182,12,34,137,183,1.3169398907103824,0.04370458631165573,660,"it's called nesting, it was in all the baby manuals"
5267,2187,11,42,149,202,1.316831683168317,0.040233167352505456,660,I have the empty nest syndrome
1388,2188,10,31,120,161,1.3167701863354038,0.04614179490094294,660,"So while I was searching for an affordable sub-let, a terrific  elephant named Horton made me an offer I couldn't refuse."
3080,2188,11,29,121,161,1.3167701863354038,0.04697557863649451,660,"Well, the last person who sat down there got really pissed off."
4947,2188,11,29,121,161,1.3167701863354038,0.04697557863649451,660,"It's only a winter sub-lease but you can't beat the park views for $2,100 a month!"
5514,2188,11,29,121,161,1.3167701863354038,0.04697557863649451,660,"Empty, shempty.  You can do better than lame nest jokes."
5684,2188,10,31,120,161,1.3167701863354038,0.04614179490094294,660,"What do you think of me now, Dad?"
1029,2193,11,35,134,180,1.3166666666666667,0.04349347290086495,660,"At last, a woman with a nesting instinct!"
3516,2193,10,37,133,180,1.3166666666666667,0.04277392825714615,660,"I'm listing it on Airbnb soon. Just search up ""cozy treetop nook with city view"" and it should come right up."
969,2193,8,41,131,180,1.3166666666666667,0.041297245013268244,660,Cheapest loft in the city!
1084,2193,12,33,135,180,1.3166666666666667,0.04420130576588278,660,"Sustainability, so hot right now."
5073,2197,9,32,117,158,1.3164556962025316,0.04586295975574165,660,"Analyze me all you want, Dr Frick, you did say ""try something new, soar..."""
5082,2197,10,30,118,158,1.3164556962025316,0.046733678783509286,660,Can you believe I'm only paying $500 a month for this neighborhood?
4617,2199,8,40,129,177,1.3163841807909604,0.04174331132881311,660,"One flight walk up they said, and cheap!"
2907,2199,7,42,128,177,1.3163841807909604,0.04096709295649913,660,"OK, we'll take the bowling trophies out and you can have your bedroom back."
262,2201,8,33,114,155,1.3161290322580645,0.045542706778752565,660,It's the latest down-sizing option for empty nesters!
1161,2201,9,31,115,155,1.3161290322580645,0.04645347480325674,660,"So I guess technically, you are not homeless"
224,2201,9,31,115,155,1.3161290322580645,0.04645347480325674,660,"normally people just chain themselves to the tree, dear"
2943,2201,8,33,114,155,1.3161290322580645,0.045542706778752565,660,It was a winter sublet. The spring tenants will be back on the first.
5529,2205,10,35,129,174,1.3160919540229885,0.04374917732409341,660,It's a really reasonable sublet for the months they go south.
772,2205,9,37,128,174,1.3160919540229885,0.042983133302258114,660,I'll leave the nest soon. I just need some time to find myself.
181,2207,16,35,161,212,1.3160377358490567,0.041711107638729025,660,The only downside is how processed the food is.
145,2208,14,26,131,171,1.3157894736842106,0.04726702444951881,660,And it's only $3000 per month!
2519,2208,9,30,113,152,1.3157894736842106,0.047065371940886995,660,"It was the cheapest rent, and it had the best view of the park."
3736,2208,11,32,128,171,1.3157894736842106,0.045030803362789334,660,I was told to start a nest egg  for retirement.
3866,2208,13,28,130,171,1.3157894736842106,0.04653355940294065,660,It's a steal at only $1500 a month!
5291,2208,13,28,130,171,1.3157894736842106,0.04653355940294065,660,Now do you believe I'm in the 'Nesting' mode?
5404,2208,8,38,125,171,1.3157894736842106,0.042677569081251455,660,...that’s not what I meant by ‘tweet it out.’
5748,2208,7,40,124,171,1.3157894736842106,0.04186377256149506,660,Its a snowbird nest sublet until Spring
5757,2208,9,36,126,171,1.3157894736842106,0.04347613543415966,660,And they allow dogs
3191,2216,12,35,140,187,1.3155080213903743,0.04302443390679365,660,I'm the one who didn't fly over the cuckoo's nest.
850,2216,9,41,137,187,1.3155080213903743,0.04097070775807059,660,I never did want to leave the nest.
1237,2216,9,41,137,187,1.3155080213903743,0.04097070775807059,660,Not listening. I'm a bird now.
2123,2219,11,31,126,168,1.3154761904761905,0.04557702861040093,660,"All of a sudden, my nesting instinct kicked in."
678,2220,9,29,111,149,1.3154362416107384,0.04769990567563531,660,It’s rent stabilized!
441,2221,9,40,135,184,1.315217391304348,0.041401768294655285,660,"Yeah, I'm okay. Mom said she'd be right back"
4969,2221,9,40,135,184,1.315217391304348,0.041401768294655285,660,"On the other hand, my Airbnb is booked till September..."
3758,2223,7,38,120,165,1.3151515151515152,0.04281835730789982,660,"Rent is $1,500 plus utilities and the super is a pigeon, but it has great views of the park!"
167,2223,9,34,122,165,1.3151515151515152,0.044511025404519275,660,"Chill dad, you've got a good 10 years before it's an empty nest."
3501,2223,10,32,123,165,1.3151515151515152,0.04533366533349307,660,"And with the HOA fees, it’s only $3,000 a month"
5461,2226,8,41,132,181,1.3149171270718232,0.041105698456263065,660,I confess! I've been feathering my own nest.
255,2226,9,39,133,181,1.3149171270718232,0.04184573813164563,660,"That's what happens when you coddle a millennial, they'll never leave the nest."
3990,2228,10,31,121,162,1.3148148148148149,0.04589775548385575,660,Free housing -- it's a perk of my incubator job.
5136,2228,7,37,118,162,1.3148148148148149,0.04331928265970286,660,My obstetrician calls it the nesting instinct.
3955,2228,10,31,121,162,1.3148148148148149,0.04589775548385575,660,I found it on Airbnb. Could it be any cozier?
1511,2228,5,41,116,162,1.3148148148148149,0.04151141744084609,660,My parents already know.
1654,2228,4,43,115,162,1.3148148148148149,0.04057729096239244,660,"I know it's small, but it's rent stabilized!"
1747,2228,5,41,116,162,1.3148148148148149,0.04151141744084609,660,Best place in the city for people-watching.
1125,2234,9,44,144,197,1.3147208121827412,0.03957956214356836,660,"It's called ""nesting"". I read about it in the Smarter Living section of The New York Times. The Health Section called it ""going insane""."
1305,2235,13,30,135,178,1.3146067415730338,0.04520491670300089,660,My section 8 voucher finally came through!
1607,2235,10,36,132,178,1.3146067415730338,0.04304700428506973,660,Benches are for the birds
3104,2235,11,34,133,178,1.3146067415730338,0.043778128671605236,660,"And, he's flying me south for the winter, too."
5590,2235,11,34,133,178,1.3146067415730338,0.043778128671605236,660,I got this spot on FreshAirBnB for only $55 a night!
828,2239,7,36,116,159,1.3144654088050314,0.04383709991212755,660,Is my chirping bothering you?
2616,2239,7,36,116,159,1.3144654088050314,0.04383709991212755,660,It's an Air without the BNB!
305,2241,9,37,129,175,1.3142857142857143,0.04277496225831017,660,The realtor said I couldn't find a Fifth Avenue apartment for less.
1739,2241,8,39,128,175,1.3142857142857143,0.04200018989490487,660,Of course this is what having a nest egg means! Silly banker.
2609,2241,9,37,129,175,1.3142857142857143,0.04277496225831017,660,I'm trying to get into the New Yorker Magazine
3386,2241,7,41,127,175,1.3142857142857143,0.04121085422817974,660,Rent is cheap and the view is great!
2347,2245,13,34,144,191,1.3141361256544504,0.04301653749697982,660,"When the trees leaf out, we could mate, have a child, and be able to afford the rent."
358,2246,9,31,116,156,1.314102564102564,0.046199201131996555,660,"I've decided to take my ""Free as a bird"" mantra to the next level."
4992,2246,9,31,116,156,1.314102564102564,0.046199201131996555,660,"Then, after you chew up the food, it’s gonna get a little weird…”"
5049,2248,8,38,126,172,1.313953488372093,0.04246842317314245,660,My carbon footprint has been reduced significantly.
5385,2248,11,32,129,172,1.313953488372093,0.04480586272828767,660,Surely you've heard of nesting!
3263,2248,10,34,128,172,1.313953488372093,0.044040502708550075,660,"AirBnB, man. Got it for a song."
3921,2248,11,32,129,172,1.313953488372093,0.04480586272828767,660,"I'm hoping somebody puts me in one of those quirky, only in New York type cartoons."
1774,2248,7,40,125,172,1.313953488372093,0.041660142952332155,660,My girlfriend says I lack the nesting instinct.  What do YOU think?
1284,2248,10,34,128,172,1.313953488372093,0.044040502708550075,660,I'm a little concerned about my nest egg.
1155,2248,8,38,126,172,1.313953488372093,0.04246842317314245,660,"Certified Arborist, why do you ask?"
910,2255,6,47,135,188,1.3138297872340425,0.038637935358027696,660,Dad how you like my new place?
917,2256,7,34,112,153,1.3137254901960784,0.04492721269564549,660,Horton's on vacay.
5022,2256,6,36,111,153,1.3137254901960784,0.043959698913826346,660,"And then they said, “It’s time for you to try your wings.”"
3964,2258,9,35,125,169,1.3136094674556213,0.04376393962400437,660,"I know, but it’s rent controlled!"
4780,2258,9,35,125,169,1.3136094674556213,0.04376393962400437,660,It's the latest affordable housing initiative.
985,2258,5,43,121,169,1.3136094674556213,0.04041674032965494,660,Someone went to a lot of trouble building it - it'd be a shame not to use it.
1705,2261,10,38,137,185,1.3135135135135134,0.041919364783321075,660,"My parents were sad to see me leave the nest, jokes on them."
5344,2261,13,32,140,185,1.3135135135135134,0.04397154038214513,660,...and a dozen fresh worms.
1642,2263,11,30,125,166,1.3132530120481927,0.04590211475770398,660,I'd like to find one with granite countertops.
2993,2263,10,32,124,166,1.3132530120481927,0.04509972049915211,660,"Turns out, the ducks in Central Park go South in Winter, so I got a great deal on a sublet."
3235,2263,13,26,127,166,1.3132530120481927,0.04746622841015487,660,"Hey, Dad."
4171,2263,12,28,126,166,1.3132530120481927,0.046690721662416064,660,I'm hatching a caption.
5687,2263,6,40,120,166,1.3132530120481927,0.041736164037804266,660,A little bird told me about this rent controlled apartment.
4036,2268,11,35,136,182,1.3131868131868132,0.043084136760492345,660,"Hey, Ben from Grindr? Come on up."
2378,2268,8,41,133,182,1.3131868131868132,0.04091582257161089,660,"‘The rent is “cheep”. Get it? Wait, please don’t go. I’m ever so lonely...’"
5634,2268,8,41,133,182,1.3131868131868132,0.04091582257161089,660,"It's not the traditional nest egg, but you can't beat the energy costs and views."
2169,2268,12,33,137,182,1.3131868131868132,0.04378305161009105,660,It’s an Open-Airbnb.
417,2268,10,37,135,182,1.3131868131868132,0.0423736955256645,660,Mom should be home soon.
2214,2268,12,33,137,182,1.3131868131868132,0.04378305161009105,660,"Don't be so surprised Jay - I'm empty nester, sitting in the catbird's seat, with a bird's eye view of the park. Why wouldn't I look happy as a lark?"
2265,2274,9,33,121,163,1.312883435582822,0.04481903525092777,660,"Hell to build, heaven to relax."
3348,2274,9,33,121,163,1.312883435582822,0.04481903525092777,660,Im subletting
3889,2274,5,41,117,163,1.312883435582822,0.04130114372106641,660,I've got the rest of my 20's to live at home.
96,2277,9,38,132,179,1.312849162011173,0.04210295187401207,660,"I found it on ""air"" b & b."
1386,2277,13,30,136,179,1.312849162011173,0.044986012837957536,660,"It's rent controlled, and all the worms I can eat."
4950,2277,8,40,131,179,1.312849162011173,0.04135079029314314,660,It's easier to tweet!
5600,2280,7,36,117,160,1.3125,0.04360657082215849,660,I used to think that your corner office had the softest seat and the best view....not any more.
5599,2280,9,27,108,144,1.3125,0.04874966379658141,660,"It may be drafty, but the view is great and the HOA fee is just nuts."
4122,2280,8,39,129,176,1.3125,0.04179903217670346,660,I'm subletting it until Spring...
2568,2280,5,45,126,176,1.3125,0.0393999225393134,660,... And the rent is pretty reasonable. I just have to put up with the owner's shit.
879,2280,12,31,133,176,1.3125,0.04479843022528078,660,"She is a little flighty, but I love her."
1836,2280,7,41,128,176,1.3125,0.0410149244297003,660,"$2,500/month with killer views of the city."
827,2280,9,22,97,128,1.3125,0.0529052599977835,660,"Powerful instinct, nesting. It came over me today, and here I find myself. Go figure."
486,2280,13,29,134,176,1.3125,0.04551740783024024,660,That guy with the freshly-washed Volvo just made my list.
2506,2280,10,35,131,176,1.3125,0.04332469527624194,660,"They whistle, they hop around, they always seem to have plenty of friends. My life had NONE of that. If you can't beat 'em...."
1360,2289,9,41,139,189,1.312169312169312,0.04060432635653247,660,Florida is so yesterday
5339,2290,8,38,127,173,1.3121387283236994,0.04226120958610719,660,"Love living up to MY standards now-- Pre-war simplex with unobstructed skyline views, high ceiling."
193,2290,12,30,131,173,1.3121387283236994,0.04533059867444544,660,I'm protecting my nest egg.
2856,2290,6,42,125,173,1.3121387283236994,0.04063967477022301,660,I'm colluding with Mother Nature.
3428,2290,8,38,127,173,1.3121387283236994,0.04226120958610719,660,"Once they hatch, we're moving to The Berkshires."
4190,2294,8,33,116,157,1.3121019108280254,0.04505019537444462,660,I am finally comfortable being an empty nester.
2813,2294,8,33,116,157,1.3121019108280254,0.04505019537444462,660,Finally!  The nest to myself!
2564,2294,12,25,120,157,1.3121019108280254,0.04854026547710736,660,"My wife and I were having an argument about who builds the nest, and I won."
913,2297,9,40,137,186,1.3118279569892473,0.04102507313612709,660,It's pure joy surprising an unsuspecting tourist without a hat.
1864,2297,10,38,138,186,1.3118279569892473,0.041727440187391995,660,"Can you believe it? Only $1,000 a month!"
3028,2297,10,38,138,186,1.3118279569892473,0.041727440187391995,660,The rent is super cheep.
4013,2297,12,34,140,186,1.3118279569892473,0.04309784846286386,660,"Yeah, I got this on Airbnb."
4310,2301,10,33,127,170,1.311764705882353,0.04433696501451201,660,House sitting for Big Bird.
3126,2301,10,33,127,170,1.311764705882353,0.04433696501451201,660,"The neighbors are loud, but at least the rent is cheap!"
2695,2301,7,39,124,170,1.311764705882353,0.04191569555518825,660,"You just try to find a place to buy that won't use up your nest egg!"""
3268,2301,7,39,124,170,1.311764705882353,0.04191569555518825,660,My accountant said it was time to start working on my nest egg.
1099,2301,11,31,128,170,1.311764705882353,0.04511518714327072,660,And the best part is it's rent-controlled!
1004,2301,10,33,127,170,1.311764705882353,0.04433696501451201,660,"What do you think? $15 per square foot, and a view of the park. It's got ""home"" written all over it."
303,2301,10,33,127,170,1.311764705882353,0.04433696501451201,660,"No roommate, great view, and only a bag of bird seed per month."
2543,2301,9,35,126,170,1.311764705882353,0.04354483692039487,660,"We moved our youngest into his dorm room this week.
I've never felt better."
2371,2309,8,32,114,154,1.3116883116883118,0.045620974131008275,660,You said I was tweeting too much!
4628,2309,8,32,114,154,1.3116883116883118,0.045620974131008275,660,I picked this up at Ikea.
1575,2311,10,37,136,183,1.3114754098360655,0.04217624561823606,660,Can't wait to see what hatches!
2407,2311,6,45,132,183,1.3114754098360655,0.039225485757876086,660,And it’s got a great view of Hudson Yards.
3133,2311,6,45,132,183,1.3114754098360655,0.039225485757876086,660,Care for a worm?
1174,2314,9,34,124,167,1.311377245508982,0.0440567738610973,660,It’s a BnB! Birds and branches!
1758,2314,14,24,129,167,1.311377245508982,0.0479762822393677,660,"Hawks game, right behind the bench. I knew it was too good to be true."
5187,2314,5,42,120,167,1.311377245508982,0.040649967472028606,660,You wouldn't believe the rate I got on the mortgage.
3607,2317,6,44,130,180,1.3111111111111111,0.039620240180504016,660,They weren’t kidding about the nesting instinct!
3532,2317,9,38,133,180,1.3111111111111111,0.04190445288096708,660,"And all for $2,000 a month!"
1287,2317,10,36,134,180,1.3111111111111111,0.04263867279458846,660,"That’s right, Bill, a Manhattan apartment for only $2900 plus utilities monthly."
2020,2317,7,42,131,180,1.3111111111111111,0.04039599829675723,660,"I'll be coming down as soon as the kids are old enough to leave this nest"""
443,2321,7,37,120,164,1.3109756097560976,0.042874880997631794,660,I’m waiting for a fireman.
653,2321,11,29,124,164,1.3109756097560976,0.04623334529222424,660,We need the eggs”
5698,2321,6,39,119,164,1.3109756097560976,0.04199331758118013,660,I couldn't wait to being transfer to this branch
2212,2324,7,41,129,177,1.310734463276836,0.04082074184541988,660,Nesting is the new yoga.
3961,2325,9,32,120,161,1.31055900621118,0.04513267608592535,660,I always dreamt of living in the upper East side....
5030,2325,8,34,119,161,1.31055900621118,0.04426419206451489,660,Our Airbnb host did say she was flying south for the winter.
457,2327,9,41,140,190,1.3105263157894738,0.040423457298750166,660,More spacious than my last apartment!
4101,2327,11,37,142,190,1.3105263157894738,0.041778528995857114,660,"Yes, I'm supposed to be in South America. But this nest is rent controlled and I'm not risking it."
1856,2329,14,26,134,174,1.3103448275862069,0.04655473848259208,660,I found it on Air Bird and B
2101,2329,8,38,128,174,1.3103448275862069,0.04205590406650257,660,I started by hugging them.  Now I sleep with them.
3347,2329,9,36,129,174,1.3103448275862069,0.04283853212828547,660,"Working on my nest egg, man."
4132,2329,10,34,130,174,1.3103448275862069,0.043607116425664116,660,It was the cheapest one Airbnb had.
4333,2329,9,36,129,174,1.3103448275862069,0.04283853212828547,660,This? It's the latest downtown studio apartment.
4906,2329,8,38,128,174,1.3103448275862069,0.04205590406650257,660,"Okay, I'm homeless, but not treeless!"
3123,2335,7,44,136,187,1.3101604278074865,0.03940602315937993,660,Life was simpler when we were arboreal.
4976,2335,11,36,140,187,1.3101604278074865,0.04222367447662539,660,"Buddy, could you spare a worm?"
2556,2335,10,38,139,187,1.3101604278074865,0.041537184305636514,660,"It was No Fee, so I grabbed it."
3780,2338,6,37,115,158,1.3101265822784811,0.04297069452659355,660,And we've got an extra branch for my parents.
5735,2338,8,33,117,158,1.3101265822784811,0.044807721413442934,660,"I’ve built the nest, wanna help with the rest?"
3497,2338,7,35,116,158,1.3101265822784811,0.04389881824356169,660,Things are great - they're really taking me in as one of their own!
5124,2341,13,27,131,171,1.3099415204678362,0.0463950148173685,660,You looked a lot better on Tinder.
4819,2341,11,31,129,171,1.3099415204678362,0.044887620795660756,660,My folks told me it was time that I left their nest.
2102,2341,12,29,130,171,1.3099415204678362,0.0456475404627614,660,"Go ahead and bark, I guarantee it’s the right tree."
59,2344,9,26,107,142,1.3098591549295775,0.04914928932598675,660,"The Danish have a word for it, but it's really nesting."
815,2345,10,37,137,184,1.309782608695652,0.04198054429803068,660,"Yeah,. . . when I get a raise, I can afford an umbrella."
2797,2345,10,37,137,184,1.309782608695652,0.04198054429803068,660,"Early bird gets the nest, Jim."
5584,2345,8,41,135,184,1.309782608695652,0.04054100439152643,660,"Sure it’s a little small and doesn’t have a dishwasher, but what an amazing view of the park right?"
1939,2348,3,42,110,155,1.3096774193548386,0.040491059837040065,660,"It's bigger than my last NYC apartment, airy and bright and to top it off, it's rent controlled!"
1509,2349,9,34,125,168,1.3095238095238095,0.0438329489448384,660,Millenials call it “nesting”.
4287,2349,10,32,126,168,1.3095238095238095,0.044638698599203386,660,You won't see me here come spring.
424,2349,11,30,127,168,1.3095238095238095,0.04543015971863003,660,It’s a new low-cost startup:  Air Nest and Nothing.
1085,2349,12,28,128,168,1.3095238095238095,0.046208066519710024,660,I find it better then Tinder.  What's your name?
2148,2353,12,32,137,181,1.3093922651933703,0.04385996507286688,660,I thought this would be a good way to do some people watching.
2488,2353,9,38,134,181,1.3093922651933703,0.041707726785069475,660,I'm renting from a snowbird.
2513,2353,9,38,134,181,1.3093922651933703,0.041707726785069475,660,This Bed and Breakfast has the best omelets
2957,2353,7,42,132,181,1.3093922651933703,0.040208951306493115,660,It's both organic and rent controlled.
5346,2353,7,42,132,181,1.3093922651933703,0.040208951306493115,660,I'm warming it up for the owners who get back from Florida tomorrow.
2038,2358,10,40,144,194,1.309278350515464,0.040509580260298376,660,Tell Mom I flew the coop.
583,2359,11,25,116,152,1.3092105263157894,0.04871434636699961,660,"Watch your step, there."
3714,2360,11,33,134,178,1.3089887640449438,0.043641465105936264,660,"Yeah it gets cold at night, but now I can legally poop on people's cars!"
4373,2360,12,31,135,178,1.3089887640449438,0.04436279351733235,660,"Yeah, but it was only 900 K."
1362,2360,11,33,134,178,1.3089887640449438,0.043641465105936264,660,I think my nesting instincts are kicking in big time”
5499,2360,11,33,134,178,1.3089887640449438,0.043641465105936264,660,"Hint, hint."
134,2360,12,31,135,178,1.3089887640449438,0.04436279351733235,660,...and the rent’s only $4500 a month!
15,2360,12,31,135,178,1.3089887640449438,0.04436279351733235,660,I found it through Airbnb.
1356,2360,10,35,133,178,1.3089887640449438,0.04290801212505469,660,"I’ll nest while you hunt and gather, right?"
5196,2367,8,43,140,191,1.3089005235602094,0.03955346971354701,660,Next time bring suet.
3860,2368,7,32,110,149,1.308724832214765,0.04557245061381208,660,It's one way to get free of Alexa.
242,2369,11,28,123,162,1.308641975308642,0.046570895365752325,660,It was the cheap-cheapest apartment I could find.
4958,2369,6,38,118,162,1.308641975308642,0.04225449224236663,660,It's cheaper than living downtown.
2382,2371,10,34,131,175,1.3085714285714285,0.04339346952340768,660,Well this is hawkward
4798,2371,6,42,127,175,1.3085714285714285,0.04025254547617768,660,I'm really enjoying being an empty nester.
106,2373,16,26,146,188,1.3085106382978724,0.04528841562591542,660,It's only $2200 per month!
779,2373,13,32,143,188,1.3085106382978724,0.04336326451733925,660,"I'm sorry, Donald, but I love him!"
4021,2375,8,29,109,146,1.3082191780821917,0.047183366256693095,660,They said perfect for empty nesters.
4527,2376,8,33,118,159,1.3081761006289307,0.04456772136472309,660,"On the plus side, park views!"
742,2376,8,33,118,159,1.3081761006289307,0.04456772136472309,660,"What do you think of millennials now, Dad?"
1329,2378,4,45,123,172,1.308139534883721,0.03897076350774088,660,Mom said I couldn't nest at home anymore
1475,2378,9,35,128,172,1.308139534883721,0.04311284829836726,660,"Well, the rent is really cheep-cheep!"
2405,2378,6,41,125,172,1.308139534883721,0.04067824136298142,660,They said it was great for empty nesters
2659,2378,7,39,126,172,1.308139534883721,0.0415056475240337,660,My realtor only got the first part of the ‘Location’ memo.
3822,2378,9,35,128,172,1.308139534883721,0.04311284829836726,660,"...you have to get used to the size, but the commute is great!"
4466,2378,8,37,127,172,1.308139534883721,0.04231687881204941,660,We’re having a baby in a couple of weeks and I hear that the nesting instinct is normal.
5628,2384,5,42,122,169,1.3076923076923077,0.0402513937286372,660,This is just temporary until I get my old room back.
4085,2384,7,46,142,195,1.3076923076923077,0.03831587537218635,660,"Yeah, we're just about to take off... the wife and I are heading South for the winter."
3612,2384,8,40,134,182,1.3076923076923077,0.040774940806117904,660,I decided to go TOTALLY green
3225,2384,9,34,126,169,1.3076923076923077,0.043611285347218524,660,Trial separation
3113,2384,12,32,138,182,1.3076923076923077,0.043651424596715886,660,"Any guesses on how many submissions will include ""empty nest,"" ""getting chicks"" or ""having a stick up your ass""?"
3106,2384,8,40,134,182,1.3076923076923077,0.040774940806117904,660,"Oh, I just tell them i'm birdwatching."
1501,2384,9,34,126,169,1.3076923076923077,0.043611285347218524,660,"Try and take my eggs, I dare you."
1808,2384,10,36,136,182,1.3076923076923077,0.0422376767061423,660,"When they installed those slanted benches, I had to get creative."
853,2384,5,38,113,156,1.3076923076923077,0.042283247317985134,660,"Fair point, but show me another loft with park views for under three grand, utilities included!"
770,2384,11,30,128,169,1.3076923076923077,0.04519766549176948,660,And she's constantly feeding me.
646,2384,6,40,123,169,1.3076923076923077,0.04111711414037298,660,Much roomier than my old apartment
1888,2384,10,32,127,169,1.3076923076923077,0.04441155916843275,660,"Get on the bus, Gus!
I refuse to come down until this egg hatches!"
2674,2396,13,37,155,205,1.3073170731707318,0.04080696775861802,660,"Yeah, dude, AIR BnB, for real."
3931,2396,10,43,152,205,1.3073170731707318,0.03900944237870322,660,"You Boomers never did take it to the next level, did you?"
101,2398,10,39,143,192,1.3072916666666667,0.04074118058485708,660,"In the New York real estate market, the early bird gets the worm."
1498,2398,8,43,141,192,1.3072916666666667,0.03937980131765418,660,Don't laugh it's rent controlled.
2664,2400,10,35,134,179,1.3072625698324023,0.04270253305302856,660,My nesting instinct just kicked into high gear.
4506,2401,9,33,124,166,1.3072289156626506,0.044126062111565154,660,This time I'm the nest egg.
3788,2401,7,37,122,166,1.3072289156626506,0.0424390228117724,660,This is the best airbnb rental ever
252,2401,10,31,125,166,1.3072289156626506,0.044945841938954595,660,"It's warm, it's comfy and it's a great location. Also, I get to have omelet for breakfast."
1328,2401,10,31,125,166,1.3072289156626506,0.044945841938954595,660,It's a lot roomier than the egg was.
1920,2401,7,37,122,166,1.3072289156626506,0.0424390228117724,660,"Vacationing ""off the grid"" is the best decision I've made since buying the loft in Brooklyn Heights."
507,2406,7,33,113,153,1.3071895424836601,0.04474543459850608,660,Let me go out on a limb here and guess that you are still paying on a mortgage
1865,2406,6,35,112,153,1.3071895424836601,0.04377390324615433,660,I'm house-sitting until the owner returns in the spring.
4224,2406,12,23,118,153,1.3071895424836601,0.04931683766662968,660,I invested my nest egg in New York real estate with a view of the park
2066,2409,12,34,143,189,1.306878306878307,0.04250707942476255,660,"While the early bird is out catching the worm, I catch my beauty sleep."
3834,2409,10,38,141,189,1.306878306878307,0.04116159885820016,660,"I'm about to be an empty nester, so I thought I'd try out an empty nest."
4444,2411,11,32,133,176,1.3068181818181819,0.043927263589059,660,"Everyone keeps telling me I should learn how to tweet, so I finally decided to give it a try."
3515,2411,11,32,133,176,1.3068181818181819,0.043927263589059,660,Horton's on coffee break.
3145,2411,10,34,132,176,1.3068181818181819,0.04318181818181818,660,I was watching Marie Kondo while on ayahuasca.
3460,2411,10,34,132,176,1.3068181818181819,0.04318181818181818,660,"Since my ex changed his HBO login, I have to look into the Johnson's window to watch Game of Thrones."
523,2415,13,24,126,163,1.3067484662576687,0.04793018631560175,660,My ex-wife got the house but I rule the roost.
1529,2415,10,30,123,163,1.3067484662576687,0.04549815022758075,660,It's worth two in the bush.
3711,2415,7,36,120,163,1.3067484662576687,0.04292855213042614,660,"Yeah, the meals are gross but they're free."
5440,2415,9,32,122,163,1.3067484662576687,0.04465804868209733,660,I’m just hanging out til my folks return from Florida
2984,2419,9,28,113,150,1.3066666666666666,0.04724789844566308,660,"It's a steal; cozy, with a park view and only $7500 a month!"
3873,2420,12,33,141,186,1.3064516129032258,0.042968956733824275,660,I couldn't fathom the idea of being an empty nester
803,2420,10,37,139,186,1.3064516129032258,0.04159430207681891,660,"Don’t give me that look .
Just bust out the bread crumbs."
1469,2420,7,43,136,186,1.3064516129032258,0.03944259181334642,660,I thought you meant something else when you said you were nesting.
5367,2420,9,39,138,186,1.3064516129032258,0.04088964815805905,660,"And with the money I’ll save, I can finally work on that nest egg."
1741,2424,9,35,129,173,1.30635838150289,0.04289990827498639,660,"Hi, Horton, thank you for responding to my personals ad."
2104,2424,10,33,130,173,1.30635838150289,0.043676257453311336,660,Rent is for the birds.
2424,2424,11,31,131,173,1.30635838150289,0.04443904589720197,660,Believe me...this will disrupt the hotel and hospitality space.
3522,2424,7,39,127,173,1.30635838150289,0.04130345578460557,660,"No, my mom's out getting us some  ""grub""."
3483,2428,11,27,122,160,1.30625,0.04691494629150278,660,"I think it's time to go buy the car seat, Henry."
4412,2429,6,33,108,147,1.3061224489795917,0.0448776226593899,660,"It's a next-generation 'tiny home'"""
45,2429,11,38,147,196,1.3061224489795917,0.04080324227750138,660,I found it on Airbnb as a Winter rental.
5593,2431,8,40,135,183,1.3060109289617485,0.0405863571449943,660,"Yeah man, chicks dig it!"
4104,2431,11,34,138,183,1.3060109289617485,0.04274810062952923,660,Be right down - I had to stop for a quick lay.
729,2431,7,42,134,183,1.3060109289617485,0.039839718195839695,660,Who said Central Park rents are expensive?
2881,2434,9,23,102,134,1.3059701492537314,0.05105509152021827,660,I just got tired of being an empty nester.
1783,2435,12,28,130,170,1.3058823529411765,0.04573494576830147,660,I tweet from hashtag outonalimb hashtag emptynest hashtag bringmeacovfefe.
1891,2435,14,24,132,170,1.3058823529411765,0.0472325370161082,660,"Move on, Loser!I'm Federally protected."
2333,2435,12,28,130,170,1.3058823529411765,0.04573494576830147,660,"Sure, you could take the bench. You know, like a pussy."
2628,2435,10,32,128,170,1.3058823529411765,0.04418662666328943,660,Looking down on people feels good to me.
4402,2435,7,38,125,170,1.3058823529411765,0.04175664070609713,660,This empty nest is so much more comfortable than mine!
4941,2435,13,26,131,170,1.3058823529411765,0.046489772087027426,660,"Just so you know, the view is terrible from the bench."
5230,2441,7,34,116,157,1.305732484076433,0.043957446408297324,660,"Even better, I get a Paleo smoothie every few hours."
4922,2441,6,36,115,157,1.305732484076433,0.04301857479520009,660,"Pregnant? No, why do you ask?"
4529,2441,8,32,117,157,1.305732484076433,0.044876680047285566,660,You said we were out of eggs.
2692,2441,7,34,116,157,1.305732484076433,0.043957446408297324,660,It has that Craftsman style I've been looking for.
2103,2441,6,36,115,157,1.305732484076433,0.04301857479520009,660,"Eating like a bird hasn’t been working, so I thought I’d sleep like one too."
311,2446,8,39,133,180,1.3055555555555556,0.041012346343385846,660,Sitting on benches is so yesterday.
3349,2446,8,39,133,180,1.3055555555555556,0.041012346343385846,660,I've decided nesting is better than sex.
4010,2446,9,37,134,180,1.3055555555555556,0.041762253279973086,660,"No, I am not a street person."
2196,2449,9,33,125,167,1.3053892215568863,0.043899603152382664,660,I was committed to living in Manhatten but this is all I could afford.
2251,2449,10,31,126,167,1.3053892215568863,0.04471375653900493,660,I just took an Intro to Philosophy class so I'm trying to look at things from a new perspective.
3434,2449,10,31,126,167,1.3053892215568863,0.04471375653900493,660,"Sure it’s small, but you can’t beat the park view"
3748,2449,6,39,122,167,1.3053892215568863,0.04136109955330641,660,"Thanks to Global Warming, I didn't have to fly south this winter."
4251,2449,7,37,123,167,1.3053892215568863,0.04222422791657942,660,"And, best of all, it costs less than a rent-controlled apartment!"
2135,2454,13,32,145,190,1.305263157894737,0.04296668252675139,660,This is the only place that’s in our budget.
4614,2455,6,35,113,154,1.3051948051948052,0.043534451386341426,660,"It’s not much, but it’s cheap."
215,2456,9,36,132,177,1.305084745762712,0.042218516976333616,660,Just people-watching before my flying lesson in 15 minutes.
2228,2456,9,36,132,177,1.305084745762712,0.042218516976333616,660,"Say what you want - It's got fresh air, a great view and you can't beat the rent."
2570,2456,10,34,133,177,1.305084745762712,0.042972136449899084,660,"What'd I tell you, Bill? A one bedroom near Cenrral Park. Only $3,200 a month!"
3872,2456,8,38,131,177,1.305084745762712,0.041451198297433975,660,"It's free, but you have to reserve online."
3998,2456,12,30,135,177,1.305084745762712,0.044441052888565744,660,One flew over the cuckoo's nest but I decided to land here
4047,2456,11,32,134,177,1.305084745762712,0.043712765257491105,660,Just bedsitting for my cuckoo friend.
4256,2456,10,34,133,177,1.305084745762712,0.042972136449899084,660,"What's it like being an empty nester, Tom?"
4398,2456,9,36,132,177,1.305084745762712,0.042218516976333616,660,"Ill ovulate, you get the pizza."
5508,2456,13,28,136,177,1.305084745762712,0.045157596451007816,660,I was never vaccinated.
4776,2465,8,34,122,164,1.3048780487804879,0.043574095963438635,660,"Don't worry, honey.  My psychiatrist assures me it's  seasonally apropos and  much cheaper than a new kitchen."
3529,2465,12,26,126,164,1.3048780487804879,0.04688249817767718,660,Like my new penthouse? It's the only one I could afford in Manhattan.
1298,2465,6,38,120,164,1.3048780487804879,0.04182186558316698,660,On this week’s episode of Tiny House Hunters...
1332,2465,6,38,120,164,1.3048780487804879,0.04182186558316698,660,"I kondo'ed the house, and now I live here."
2217,2469,8,30,113,151,1.304635761589404,0.04602847519024936,660,"As pleasant as the eggs feel, it’s those chewed up worms that keep me coming back."
179,2470,9,35,130,174,1.3045977011494252,0.042688969041639234,660,I got it from an empty nester.
356,2470,11,31,132,174,1.3045977011494252,0.04421797840187394,660,Nesting is the new planking.
388,2470,3,47,124,174,1.3045977011494252,0.03773199530247984,660,Living here's really helped me build my nest egg.
2744,2470,8,37,129,174,1.3045977011494252,0.041903547699243246,660,"... Darling, I know you are ovulating, but this is not the time or place for it!"
4162,2470,6,41,127,174,1.3045977011494252,0.04028679403566629,660,"You know, I think birds are onto something."
5612,2470,8,37,129,174,1.3045977011494252,0.041903547699243246,660,"Come on up, I'll give you the grand tour."
3871,2476,6,37,118,161,1.3043478260869565,0.04229763500582682,660,I responded to a Leaf-let.
3903,2476,11,34,139,184,1.3043478260869565,0.04254765532856652,660,What.... how do your ideas hatch?
3141,2476,8,33,120,161,1.3043478260869565,0.0440950045945313,660,"The amenities are few, but it's great for people-watching."
1817,2476,10,36,138,184,1.3043478260869565,0.041843833986812434,660,I decided to embrace my inner “squirrel”
1769,2476,9,31,121,161,1.3043478260869565,0.044966756406755994,660,"So I thought, 'what's easier than housesitting for an empty-nester?'"
2902,2476,12,32,140,184,1.3043478260869565,0.04324002203053405,660,"Ill mate in the spring,"
1653,2482,9,41,144,194,1.3041237113402062,0.039715046201601725,660,I'll be flying down south for the winter.
3890,2482,8,43,143,194,1.3041237113402062,0.03903676401538284,660,"Except for the Wi-fi reception, it's really a good fit for me."
4948,2484,11,30,130,171,1.304093567251462,0.04473948383619634,660,I told you I was leaving you.
1523,2485,7,41,133,181,1.3038674033149171,0.040061069410471384,660,I got tired of being an empty nester.
1949,2486,5,38,115,158,1.3037974683544304,0.04183648072973545,660,Don’t be such a fuddy-duddy! This was the cheapest Airbnb in New York with a view!
4735,2486,9,30,119,158,1.3037974683544304,0.045527944607497005,660,It's the latest in a plant-based lifestyle.  I'm a treegan.
3821,2488,8,42,141,191,1.3036649214659686,0.03941828125474732,660,Hi there you gorgeous hunter-gatherer!
2746,2488,8,42,141,191,1.3036649214659686,0.03941828125474732,660,They moved to Jersey.
4889,2488,12,34,145,191,1.3036649214659686,0.04212181502554702,660,Mating season is right around the corner!
3366,2491,7,37,124,168,1.3035714285714286,0.04201148614394804,660,"Can you believe I got this park side view for only $1,800 a month?!"
3380,2491,7,37,124,168,1.3035714285714286,0.04201148614394804,660,I don't even have to chew my food anymore!
3545,2491,8,35,125,168,1.3035714285714286,0.04285149901056963,660,It's available on AirBnB til spring.
5423,2491,8,35,125,168,1.3035714285714286,0.04285149901056963,660,Horton promised he would be right back with the lease agreement.
3816,2495,7,30,108,145,1.303448275862069,0.046242052160669976,660,. . . and she says she’ll be back by Spring!
4885,2496,8,38,132,178,1.303370786516854,0.041253289055961054,660,You always said I was a little Cuckoo
5359,2496,10,34,134,178,1.303370786516854,0.04276439876897956,660,"Hey Dad, could you regurgitate a slice of pizza for me?"
3962,2496,9,36,133,178,1.303370786516854,0.04201563792212953,660,"To watch the bird, first you must become the bird."
4820,2496,13,28,137,178,1.303370786516854,0.04493588452761042,660,"Only $ 17,000 per month, and it has a Central Park view."
1331,2496,8,38,132,178,1.303370786516854,0.041253289055961054,660,So we can keep an eye on the park bench we adopted.
375,2496,9,36,133,178,1.303370786516854,0.04201563792212953,660,Just house sitting until the owners return in the spring.
3008,2496,12,30,136,178,1.303370786516854,0.04422390469203195,660,Just keeping the kids warm till my wife comes back to regurgitate.
1018,2503,10,27,118,155,1.303225806451613,0.04700871533023784,660,"The view is fantastic, and you can't beat the rent!"
1502,2503,10,27,118,155,1.303225806451613,0.04700871533023784,660,"Not on your life, buster - but you can do your little dance and I'll add you to the list."
4709,2503,6,35,114,155,1.303225806451613,0.0432974663779977,660,This'll get tons of likes on Twitter!
92,2506,11,35,142,188,1.303191489361702,0.041899273584764064,660,Trust your nest egg to no one.
4063,2506,9,39,140,188,1.303191489361702,0.04051876775101826,660,I'm working on my retirement nest egg.
399,2508,16,18,131,165,1.303030303030303,0.0497029181809437,660,I’m gonna shit on your head
3641,2509,15,23,137,175,1.302857142857143,0.04688965190510922,660,"The rent's chirp, chirp...cheap."
2257,2509,9,35,131,175,1.302857142857143,0.04248000454133184,660,It beats the hell out of my futon.
1778,2509,9,35,131,175,1.302857142857143,0.04248000454133184,660,"Up to code? No, but it's rent-controlled."
1337,2509,6,41,128,175,1.302857142857143,0.04009372084075266,660,"It's cute, it's cozy, and there's no HOA."
2113,2509,9,35,131,175,1.302857142857143,0.04248000454133184,660,"Sweetheart, we are NOT doing the empty-nest thing."
2517,2514,9,25,108,142,1.3028169014084507,0.048952096211255416,660,....bird's eye view of the park....and the rent is reasonable.
1609,2514,7,29,106,142,1.3028169014084507,0.04686712581054992,660,Nothing else sparks joy in me anymore.
2675,2516,7,42,136,185,1.3027027027027027,0.03947684049698285,660,"Sure it's a fixer upper, but I didn't have to put anything down."
2873,2516,7,42,136,185,1.3027027027027027,0.03947684049698285,660,"It's a new dating app for women in their 30s called ""Nest."""
780,2516,9,38,138,185,1.3027027027027027,0.040938120972819604,660,I’ll be down soon. I just needed to get out for a little aerie.
1800,2516,10,36,139,185,1.3027027027027027,0.0416495396777168,660,"How can you think outside the box, when you live in one?"
3728,2516,8,40,137,185,1.3027027027027027,0.040214118692378654,660,"Rent's only $3000 a month, and it has a view! Now if only I could get my super to install some stairs..."
2739,2521,6,34,112,152,1.3026315789473684,0.043823326425791564,660,I'll tweet you when the buds come out.
3672,2521,9,28,115,152,1.3026315789473684,0.046710802457713245,660,And it's only half as much as I was paying at the last place!
3249,2523,6,47,142,195,1.3025641025641026,0.037482472050839655,660,And it has a view!
352,2524,6,37,119,162,1.3024691358024691,0.04207768855708624,660,"Sorry Dad,us Millenials REALLY aren't ready to leave the nest."
670,2524,10,29,123,162,1.3024691358024691,0.045576932967382196,660,Hun...I'm expecting!
1456,2524,10,29,123,162,1.3024691358024691,0.045576932967382196,660,I even got breakfast in bed!
4242,2524,6,37,119,162,1.3024691358024691,0.04207768855708624,660,I'm house sitting for the snow birds.
248,2528,7,38,127,172,1.302325581395349,0.04134579417903897,660,Life is good with 'Cats' no longer on Broadway.
504,2528,10,32,130,172,1.302325581395349,0.04374326307339804,660,The previous owner got too big & moved to Sesame Street so I got a great deal on this!
992,2528,10,32,130,172,1.302325581395349,0.04374326307339804,660,"Is about as large as my place in 
The City."
2460,2528,11,30,131,172,1.302325581395349,0.04451373406391403,660,"I should be flying South, but my mother begged me not to come."
1853,2532,6,43,133,182,1.3021978021978022,0.039106622666069395,660,I got a great deal on this winter sublet!
4960,2532,10,35,137,182,1.3021978021978022,0.042097256536818235,660,"No, not street person, a tree person."
3153,2534,7,31,111,149,1.3020134228187918,0.04537836777761066,660,They say the nesting instinct kicks in around now.
3643,2534,10,25,114,149,1.3020134228187918,0.04828333487717794,660,"I heard something, somewhere about the importance of sitting on a nest egg."
4686,2536,9,43,150,202,1.301980198019802,0.038626742271147506,660,And they called me an Empty Nester! Ha!
490,2537,6,36,117,159,1.3018867924528301,0.04256215522796323,660,"You try and find a living space in this city for under $2,000."
3792,2537,7,34,118,159,1.3018867924528301,0.04348733785309519,660,Mom's not home. Can I take a message?
856,2539,10,31,128,169,1.301775147928994,0.04425642967059917,660,The doctor said I would start nesting soon.
901,2539,9,33,127,169,1.301775147928994,0.04345329894327938,660,Great bird ‘s eye view!!
1983,2539,9,33,127,169,1.301775147928994,0.04345329894327938,660,"Yeah, it's cold water only, but you can't beat the natural light."
2352,2539,7,37,125,169,1.301775147928994,0.041800770719983546,660,My roommate flew the coop.
3659,2539,8,35,126,169,1.301775147928994,0.042635042053683014,660,...utilities included and the view of the park is second to none!
4153,2539,10,31,128,169,1.301775147928994,0.04425642967059917,660,It's yoga with birds. The New Yorker featured an article about its benefits.
5063,2539,10,31,128,169,1.301775147928994,0.04425642967059917,660,Hey Pops I'm empty nesting too!
5351,2546,11,32,136,179,1.3016759776536313,0.04328976123161862,660,"Simple, really. I chose low maintenance and a view over amenities."
5055,2546,11,32,136,179,1.3016759776536313,0.04328976123161862,660,it's my turn today
4931,2546,9,36,134,179,1.3016759776536313,0.04181461503128779,660,"I'm very comfortable here, but my realtor says I can get 2.6 mil, so . . ."
461,2546,7,40,132,179,1.3016759776536313,0.040285489111329495,660,It's only $1200 a month!
4434,2546,10,34,135,179,1.3016759776536313,0.04255857996753034,660,Our marriage councilor suggested we try nesting
2679,2546,7,40,132,179,1.3016759776536313,0.040285489111329495,660,"Yeah, my roommate is a robin, but she makes great grub."
4638,2546,6,42,131,179,1.3016759776536313,0.03949873332527477,660,Looks relaxing. Is it rent controlled?
428,2553,11,35,143,189,1.3015873015873016,0.04170785664485794,660,That is so beneath me
789,2553,8,41,140,189,1.3015873015873016,0.03963184874464589,660,"We don't have to move to the suburbs to start nesting, Jim"
1466,2553,9,39,141,189,1.3015873015873016,0.04033572517320513,660,"Lowest rent in the city, and literally right next to the bus stop."
3014,2553,10,37,142,189,1.3015873015873016,0.041027527534305275,660,I'm dealing with an empty nest syndrome.
2787,2557,13,34,152,199,1.3015075376884422,0.04151511886809534,660,"Now that I've moved out, my parents are empty nesters."
5126,2558,5,37,114,156,1.3012820512820513,0.04209158531797022,660,I heard a lot of millennials were nesters so I thought I'd give it a try
3575,2558,7,33,116,156,1.3012820512820513,0.04401281093565317,660,"I've got it made man, I keep the eggs warm while the owner is at work in exchange for room and board"
2006,2558,11,25,120,156,1.3012820512820513,0.047623308056168476,660,That’s a silly question.  I just flew in from Caracas
1503,2561,9,32,125,166,1.3012048192771084,0.04396377372758592,660,You should try it. 10 million birds can't be wrong...
4702,2561,8,34,124,166,1.3012048192771084,0.04312532956677074,660,Dog-walking was too much for my knees.
4924,2561,9,32,125,166,1.3012048192771084,0.04396377372758592,660,Told you I'm not homeless.
4978,2561,9,32,125,166,1.3012048192771084,0.04396377372758592,660,Mom wants to know what you want for Christmas.
5631,2561,9,32,125,166,1.3012048192771084,0.04396377372758592,660,"It was listed as 'sublet one bedroom, shared bath, great view.' But the owner's are back soon."
5688,2561,6,38,122,166,1.3012048192771084,0.041397528307702415,660,My mom said she would be back soon.
5034,2567,8,37,131,176,1.3011363636363635,0.04149783781226765,660,"Early bird gets the worm, Jim!"
4898,2567,9,35,132,176,1.3011363636363635,0.042272989106855646,660,"Can you believe it? A studio with park views, and it only costs $500 a month!"
2811,2567,8,37,131,176,1.3011363636363635,0.04149783781226765,660,Well the rent is better than my studio in Brooklyn.
1811,2567,8,37,131,176,1.3011363636363635,0.04149783781226765,660,"Hi I'm Jane.  What's your name? ... and please don't say 'Tarzan"", like almost every other guy did."
489,2571,7,42,137,186,1.3010752688172043,0.039297738641229006,660,A chaque oiseau son nid est beau...
4599,2571,11,34,141,186,1.3010752688172043,0.042152138941998464,660,Empty nest syndrome strikes again.
1261,2573,7,29,107,143,1.3006993006993006,0.04658638267160267,660,The landlord's a guy named Nutkin.
2646,2573,2,39,102,143,1.3006993006993006,0.0409612715772756,660,Rent's cheap since the parents are empty nesters
2076,2575,9,31,123,163,1.3006134969325154,0.04449125800158343,660,I used to be a tree-hugger until we decided to spend more time together.
2134,2575,7,35,121,163,1.3006134969325154,0.04275501507993653,660,I must be preggers - I had such an urge to nest.
2596,2575,8,33,122,163,1.3006134969325154,0.04363177370362716,660,"I just flew in from Tucson, but I think I'm early."
3255,2575,6,37,120,163,1.3006134969325154,0.04185989670850455,660,My parents threw me out of their basement... but I’m still not ready to leave the nest yet.
5162,2579,8,36,129,173,1.300578034682081,0.041952106474934296,660,The funny thing is the 401k was supposed to help feather the nest.  Maybe you're right I should have gone south.
3949,2579,13,26,134,173,1.300578034682081,0.04578259399938659,660,"Squatter’s right...when they hatch,they’re mine"
1318,2579,7,38,128,173,1.300578034682081,0.041143236413273755,660,It's rent controlled. I'm never moving!
3924,2579,6,40,127,173,1.300578034682081,0.04031814191443905,660,Didn't you say we should downsize?
2417,2583,8,39,136,183,1.3005464480874316,0.04044056652645883,660,It was really hard to find a place with a view and outdoor space for my budget.
769,2583,7,41,135,183,1.3005464480874316,0.03969118517509691,660,"I don’t know, I reached a certain age and it just felt right."
1100,2583,12,31,140,183,1.3005464480874316,0.04330861787784712,660,"The views are great and it has a south-facing garden"""
1327,2583,3,49,131,183,1.3005464480874316,0.03654029582659938,660,I thought I’d start small. And it’s rent-controlled!
1824,2583,9,37,137,183,1.3005464480874316,0.04117631189601676,660,Empty nest? At least I didn't go back and live with my folks.
1967,2583,9,37,137,183,1.3005464480874316,0.04117631189601676,660,Ceapest airbnb I could find.
5624,2583,8,39,136,183,1.3005464480874316,0.04044056652645883,660,I found this bargain on airbnb!
3554,2590,14,30,149,193,1.3005181347150259,0.043016754586493275,660,23 and Me said I’m from The Canary Islands!
3462,2590,9,40,144,193,1.3005181347150259,0.039756500656017636,660,It is a little chilly but the park views are great!
2683,2592,11,35,144,190,1.3,0.0415181144684701,660,This is the only way I can live in New York City with a rent under $2000.
5650,2592,9,36,135,180,1.3,0.04161542472952781,660,"Man Cave"" was so 20th century.  It's all about Man Nests now"
5472,2592,7,43,140,190,1.3,0.038742414210647676,660,It's a sublet for the Winter.
4567,2592,8,38,134,180,1.3,0.04086282331151638,660,I was adopted
2162,2592,7,37,126,170,1.3,0.04159205525356738,660,"You said you were having trouble adjusting to ""the empty nest syndrome""."
1543,2592,11,29,130,170,1.3,0.04481465873252761,660,I'll be heading down to Boca as soon as they hatch/
2337,2592,6,33,111,150,1.3,0.04411698907260348,660,My parents told me to leave the coop.
847,2592,10,34,136,180,1.3,0.042354655255943036,660,Decision trees always help me arrive at the right answer
717,2592,8,38,134,180,1.3,0.04086282331151638,660,"Great view, location, and only $6,000/month!"
603,2592,9,33,128,170,1.3,0.04323339390753816,660,"It's airy, has spectacular views, and is only $1,000 a month!"
510,2592,9,33,128,170,1.3,0.04323339390753816,660,Just like yesterday - pastrami on rye and black coffee.
132,2592,9,36,135,180,1.3,0.04161542472952781,660,It's $4000 a month with scenic view -- half that if you're from the Manhattan housing board.
1315,2592,6,39,125,170,1.3,0.04074660005376552,660,My back feels terrific and the daily food delivery is dependable although a bit heavy on the worms.
993,2605,8,43,146,197,1.299492385786802,0.03853271673461441,660,I've found the cure for empty nest syndrome!
1272,2606,9,38,140,187,1.2994652406417113,0.04056340415802884,660,Maybe you can't pick your own family but you can pick your own tree.
4907,2606,9,38,140,187,1.2994652406417113,0.04056340415802884,660,"Actually the rent here is still outrageous"""
1613,2608,14,25,138,177,1.2994350282485876,0.045724333492199565,660,"I'm sorry Johnny, I'm not coming back home. I've fallen in love and no, it's not a Lark."
2962,2608,5,43,129,177,1.2994350282485876,0.03889604934714962,660,It’s affordable and has a great view.
4631,2610,10,30,127,167,1.2994011976047903,0.04455405539933768,660,Empty nesting ain't half bad.
5095,2610,6,38,123,167,1.2994011976047903,0.04118840109735226,660,The renters are snowbirds.
3969,2610,8,34,125,167,1.2994011976047903,0.04290424359829468,660,I Kondo’d everything!
2051,2610,8,34,125,167,1.2994011976047903,0.04290424359829468,660,"Fine, I fully support your decision to home-birth. Can you come back home now?"
1694,2610,7,36,124,167,1.2994011976047903,0.04205507403214372,660,"Working on your retirement nest egg, dear?"
1414,2610,8,34,125,167,1.2994011976047903,0.04290424359829468,660,...and it's Rent Controlled too!
1035,2610,6,38,123,167,1.2994011976047903,0.04118840109735226,660,Because you have a family and a bar mitzvah party next week.
2452,2617,7,33,117,157,1.2993630573248407,0.04377365966524655,660,Its my husbands turn to hunt for prey... I'm warming the eggs!
1784,2618,8,28,111,147,1.2993197278911566,0.046711807034701285,660,I thought I'd save the stork the trouble of trying to get past our doorman.
3929,2618,9,26,112,147,1.2993197278911566,0.04769885613474102,660,This city's for the birds
2544,2620,8,42,144,194,1.2989690721649485,0.03890075007987242,660,Public housing is exempt from property taxes.
4354,2620,10,38,146,194,1.2989690721649485,0.04025046902561554,660,"Aw, honey, can’t you see I’m in my “nesting” phase?"
2930,2622,11,33,140,184,1.298913043478261,0.04240896732862619,660,I'm making my nest egg.
1424,2622,8,39,137,184,1.298913043478261,0.04025333422404605,660,My parents forced me out of my last nest.
355,2624,7,38,129,174,1.2988505747126438,0.04094255660269385,660,"Sure the neighbors sing a bit loud in the morning, but at least I don't have to pay for utilities!"
4283,2624,9,34,131,174,1.2988505747126438,0.04253439169983917,660,But is it wren-t controlled?
5366,2624,11,30,133,174,1.2988505747126438,0.044068764600178036,660,I'm a Twitter follower.
4656,2627,10,29,125,164,1.298780487804878,0.045094442642119315,660,Yea.  I’m an empty-nester now.
148,2627,7,35,122,164,1.298780487804878,0.04253303022289477,660,"Aside from meal times, it's great!"
568,2627,9,31,124,164,1.298780487804878,0.044257113079324915,660,That got it right when they named me Robin
894,2627,10,29,125,164,1.298780487804878,0.045094442642119315,660,It's actually quite comfortable except for the eggs.
1106,2627,6,37,121,164,1.298780487804878,0.041644230823181784,660,I'm an egg-sitter.
3664,2627,10,29,125,164,1.298780487804878,0.045094442642119315,660,Annnnnnd she chews up my avocado toast before she feeds it to me!
5739,2633,9,28,117,154,1.2987012987012987,0.04618532925956254,660,"For God’s sakes, you’ve been gone all day and no worms to show for it?!!!"
5587,2633,11,24,119,154,1.2987012987012987,0.047988014279207604,660,It's rent-free and I've gotten used to the worms they feed me.
2997,2633,7,32,115,154,1.2987012987012987,0.04430936428303814,660,It's affordable housing Dave!
3086,2633,5,36,113,154,1.2987012987012987,0.04235038237749155,660,"Sorry, I’ve decided to branch out, instead!"
776,2637,4,49,138,191,1.2984293193717278,0.03636467903604596,660,I'm an empty nester. I find it rewarding to help out where I can.
2370,2637,14,29,148,191,1.2984293193717278,0.04328401426987484,660,Our economy has forced me to live on my nest egg.
4336,2637,11,35,145,191,1.2984293193717278,0.04133002647396566,660,I’m trying to scare my parents into giving me some money.
449,2640,7,40,134,181,1.298342541436464,0.03990839063154781,660,I found it on the new rustic Airbnb app.
2740,2640,12,30,139,181,1.298342541436464,0.0435845891781187,660,I got tired of the empty nest syndrome
3331,2640,12,30,139,181,1.298342541436464,0.0435845891781187,660,It will all be worth it once the idea actually hatches.
5044,2643,9,33,129,171,1.2982456140350878,0.04301561451371009,660,"One bed, one bath!"
4107,2643,10,31,130,171,1.2982456140350878,0.043808019147143704,660,You can get some pretty good deals on Airbnb these days.
5343,2645,6,36,119,161,1.2981366459627328,0.04211482427449895,660,It's an attractive offer but my husband could fly in any minute.
916,2645,10,28,123,161,1.2981366459627328,0.045653230223973267,660,You said you were worried about our nest egg
186,2645,8,32,121,161,1.2981366459627328,0.043919675850096124,660,Now who’s the birdbrain?  You have to cover the bills without my income.
216,2645,7,34,120,161,1.2981366459627328,0.04302671466919966,660,"I am 3 months pregnant, how did you know?"
318,2645,5,38,118,161,1.2981366459627328,0.0411827472628907,660,"It's a great deal, and the assessment includes the property tax."
3425,2650,6,33,112,151,1.2980132450331126,0.04386886135544158,660,Told you I lived on Central Park Center.
4988,2651,12,35,151,198,1.297979797979798,0.04095310920110653,660,"Hey, you can't beat the rent..."
2786,2652,9,38,141,188,1.297872340425532,0.04037849602989724,660,What? I told you I was ovulating.
1009,2653,7,39,132,178,1.297752808988764,0.04031989030686663,660,"Oh, no...I sub-lease it in the spring..."
1011,2653,7,39,132,178,1.297752808988764,0.04031989030686663,660,"And you said millennials are making poor home ownership decisions. Well, look at me now!"
825,2653,7,39,132,178,1.297752808988764,0.04031989030686663,660,And only $2300 a month.
1122,2656,8,34,126,168,1.2976190476190477,0.04268531597293645,660,I can sublet from the winter snow birds and save a bundle.
1670,2656,10,30,128,168,1.2976190476190477,0.04432390098545984,660,And the sublet ends this spring?
561,2656,10,30,128,168,1.2976190476190477,0.04432390098545984,660,"I meant what I said and I said what I meant, an honest man's faithful … oh, hell, never mind.  I'm homeless."
2486,2659,9,29,120,158,1.2974683544303798,0.045351070969297406,660,"...but the rent's controlled and you can't beat the view, so I'm not complaining."
4852,2659,11,25,122,158,1.2974683544303798,0.04709533892254248,660,The owners are snowbirds. I'm just squatting.
3412,2661,8,42,145,195,1.2974358974358975,0.038731102236204816,660,"So, they sold you the eco-house of the 2020"""
185,2662,10,35,140,185,1.2972972972972974,0.041508231401128234,660,My real estate agent told me to branch out
596,2662,7,30,111,148,1.2972972972972974,0.045438618903242536,660,"It cost almost my whole nest egg, but it was worth it."
793,2662,8,28,112,148,1.2972972972972974,0.04643917259374186,660,"I feel a like I have a new purpose, now that the kids are out of the house."
2877,2662,6,43,136,185,1.2972972972972974,0.0385735096630788,660,It's half my old rent and the view of the park is amazing!
3479,2662,9,37,139,185,1.2972972972972974,0.040794348474624695,660,Are you high?
3896,2662,8,28,112,148,1.2972972972972974,0.04643917259374186,660,Hey can’t beat it  - $500 a month! Room with a view! Prime East Williamsburg location!
5407,2668,9,34,132,175,1.2971428571428572,0.042325104805933045,660,Right in the middle of New York and the rent’s just three-hundred grand a month.
4411,2668,11,30,134,175,1.2971428571428572,0.04384948559352545,660,Birding is a feeling you cannot explain.
1141,2668,9,34,132,175,1.2971428571428572,0.042325104805933045,660,It beats paying all those coop fees.
3352,2668,10,32,133,175,1.2971428571428572,0.04309403603545398,660,"Or you can let me fly south NEXT winter.  Which is it,honey"
2140,2672,7,35,123,165,1.2969696969696969,0.04231323244132485,660,"Don't worry, I moved the eggs."
2474,2673,11,35,146,192,1.296875,0.04114357238027794,660,"Hey, what do you expect for $650?"
238,2674,6,42,134,182,1.2967032967032968,0.038950635734268005,660,"If you think you're surprised, wait till my folks get back from Florida."
1103,2674,8,38,136,182,1.2967032967032968,0.04047934732544254,660,It’s rent controlled with a killer view!
1345,2674,7,40,135,182,1.2967032967032968,0.039722346254957346,660,"Now the cheeping's stopped, it's not bad."
2883,2674,13,28,141,182,1.2967032967032968,0.04406973337075292,660,I'm only nest sitting. I'll have to find my own place once my parents migrate back from Florida
5617,2678,8,35,129,172,1.2965116279069768,0.04199803241262013,660,"Stabilized, with Central Park views! Only in New York, kids. Only in New York."
3452,2678,7,37,128,172,1.2965116279069768,0.041180520522780414,660,"I know, I know, but with with my enormous student loans and my part-time job at  Starbucks, I just don’t feel quite ready to leave the nest."
2151,2678,8,35,129,172,1.2965116279069768,0.04199803241262013,660,It's the new thing in Manhattan real estate.
846,2678,9,33,130,172,1.2965116279069768,0.042799932038916175,660,"I sit on the eggs, and she takes the kids to soccer.  Deal!"
5482,2682,9,38,142,189,1.2962962962962963,0.040195195035130436,660,I guess I should have warned you before that I’m a very unconventional homeless...
5181,2682,9,38,142,189,1.2962962962962963,0.040195195035130436,660,"Well Dear, if you get a man cave..."
3999,2682,9,38,142,189,1.2962962962962963,0.040195195035130436,660,"Yes, I'm fine thank you. My mother will be back soon."
2548,2682,9,30,123,162,1.2962962962962963,0.04455549350299086,660,First one in line for the cherry blossoms
2514,2682,9,30,123,162,1.2962962962962963,0.04455549350299086,660,I built it myself!
3629,2682,9,38,142,189,1.2962962962962963,0.040195195035130436,660,"100 percent repurposed timber, and the saliva was locally sourced!"
1820,2682,7,34,121,162,1.2962962962962963,0.04279987767613371,660,It's for sale and the maintenance is very reasonable.  Of course you'll need board approval.........
1158,2682,8,40,141,189,1.2962962962962963,0.03948881377785779,660,I’ve yet to develop a taste for worms but you can’t beat the rent.
786,2682,8,32,122,162,1.2962962962962963,0.04368650552737693,660,I’m helping out a feathered friend
771,2682,4,40,118,162,1.2962962962962963,0.040022316534496484,660,It's more comfortable than the bench and the birds will feed me if I make squeaky noises.
37,2682,6,36,120,162,1.2962962962962963,0.041894490007523454,660,And I’m about to go south for the winter
2194,2682,7,34,121,162,1.2962962962962963,0.04279987767613371,660,"I HAD a nest egg, but now I can only afford this nest!"""
5614,2694,9,43,154,206,1.296116504854369,0.03798652913888061,660,"If you want ""the worm,"" it's not enough to just be early!"
1876,2695,11,31,137,179,1.2960893854748603,0.04314370351400262,660,The rent is birdseed!
4427,2695,5,43,131,179,1.2960893854748603,0.03853251822911275,660,It's not bad if you don't mind the occasional squirrel.
2626,2697,5,35,112,152,1.2960526315789473,0.04261291541603195,660,The rent was surprisingly reasonable.
3155,2698,16,26,154,196,1.2959183673469388,0.04365458787744172,660,Why don't you come up and see me sometime?
194,2699,5,40,124,169,1.2958579881656804,0.039902980303822146,660,"Yeah, housing crisis sucks."
4810,2700,7,28,107,142,1.295774647887324,0.04665275031992182,660,"Finally, I've found my niche."
3978,2701,6,43,137,186,1.2956989247311828,0.03839884568058554,660,"Yeah but with the money I save on rent, I can go to Hawaii every weekend to warm up!”"
3885,2701,12,31,143,186,1.2956989247311828,0.04269903022561781,660,I feel free as a bird today.
2358,2701,11,33,142,186,1.2956989247311828,0.04201290924752085,660,"Wait, you thought a RABBIT laid Easter eggs?"
82,2701,9,37,140,186,1.2956989247311828,0.04060590186050327,660,I just flew down from Miami.
1098,2705,6,35,118,159,1.2955974842767295,0.04237351316828499,660,Great birds eye view - super for people watching!
2054,2705,5,37,117,159,1.2955974842767295,0.04142346101332932,660,It's only a little more expensive than a studio in Crown Heights.
4756,2705,9,29,121,159,1.2955974842767295,0.0451037593324863,660,An Airbnb with a park view for under $100? Who could resist?
3064,2708,11,38,154,203,1.2955665024630543,0.03958831018837023,660,"Oh, just egg-sitting until the birds come home ... you know ... to roost."
2757,2709,8,36,132,176,1.2954545454545454,0.041339724785446764,660,It’s just a winter rental.
2440,2709,7,38,131,176,1.2954545454545454,0.04054673575519263,660,When should I come back for the eggs?
3149,2709,10,32,134,176,1.2954545454545454,0.0428817324184391,660,Upgraded from a tiny house
1580,2709,7,38,131,176,1.2954545454545454,0.04054673575519263,660,I don't know why we ever came down from the trees.
1014,2709,11,30,135,176,1.2954545454545454,0.043632305006058025,660,it's my nesting instinct
1978,2709,13,26,137,176,1.2954545454545454,0.04509598840264848,660,"I miss you most of all my darling
When autumn leaves start to fall
but now they have fallen, so I don't miss you one bit."
537,2715,12,33,148,193,1.2953367875647668,0.041612379285515574,660,Tiny house living is so two thousand eighteen.
2342,2715,7,43,143,193,1.2953367875647668,0.038232555225343565,660,Zero bedroom! Zero bath!  Park views!
4787,2717,6,32,111,149,1.2953020134228188,0.04416153143175798,660,Do you know what a 1 bedroom apartment downtown is going for?
898,2718,5,39,122,166,1.2951807228915662,0.040323692379948664,660,I am waiting for the television camera so that the entire world can follow me on Facebook.
1755,2718,9,31,126,166,1.2951807228915662,0.043795862449138565,660,My dad told me it's time to leave the nest and build your own.
3524,2718,5,39,122,166,1.2951807228915662,0.040323692379948664,660,my wife will be flying in any second
3713,2718,6,37,123,166,1.2951807228915662,0.041219164441804415,660,"No, it’s not really very affordable."
4518,2718,6,37,123,166,1.2951807228915662,0.041219164441804415,660,"Birds are cute, the homeless, not so much; I adapt. Now, give me bread, man!"
1917,2723,9,36,138,183,1.2950819672131149,0.04102861876924943,660,"Nine months’ll go by fast, you’ll see."
3555,2723,6,42,135,183,1.2950819672131149,0.03877112117260835,660,Still beats Airbnb.
328,2725,4,33,102,139,1.2949640287769784,0.04386360672825866,660,This was the only affordable New York apartment.
2750,2726,8,30,118,156,1.294871794871795,0.04475643922134656,660,I'm trying to hatch our nest egg.
5320,2726,8,30,118,156,1.294871794871795,0.04475643922134656,660,"By saving on rent, I'll be able to pay off my student loans by 2050."
5768,2726,5,36,115,156,1.294871794871795,0.0418927188656658,660,Do you have any that are southern facing?
1512,2729,5,41,127,173,1.2947976878612717,0.039303195273753706,660,"If you want to date me just know, I’m a nester..."
2408,2729,8,35,130,173,1.2947976878612717,0.041789725580624264,660,It helps to have a taste for regurgitated​ food.
3451,2729,10,31,132,173,1.2947976878612717,0.04336828143188591,660,"Imagine no possessions
I wonder if you can"
1053,2732,11,21,114,146,1.2945205479452055,0.04972081547657818,660,"No, Janet, it's not good luck if you poop on me."
2885,2733,8,32,123,163,1.294478527607362,0.04345569856989565,660,I Marie Kondo-ed my condo. This tree sparks joy.
5659,2733,5,38,120,163,1.294478527607362,0.040757534911729384,660,Instinct.
1801,2733,6,36,121,163,1.294478527607362,0.041676336380730136,660,It's time for me to just rest on my laurels!
2647,2733,6,36,121,163,1.294478527607362,0.041676336380730136,660,"My name is Holden, and I finally figured out where the ducks go!"
39,2737,10,33,137,180,1.2944444444444445,0.04220580228924804,660,I'm just waiting for a hot chick.
1954,2737,9,35,136,180,1.2944444444444445,0.04146391805471725,660,"In Denmark, they call it ""hygge""."
2829,2737,7,39,134,180,1.2944444444444445,0.039938828320153934,660,"The rent is pretty steep, but you can't beat the view."
3869,2737,12,29,139,180,1.2944444444444445,0.043651761015343606,660,That must be one of those new gentrified trees I heard about.
5462,2737,8,37,135,180,1.2944444444444445,0.04070851574323876,660,Man nest. I’m watching the game on my phone.
3953,2742,9,32,129,170,1.2941176470588236,0.043069697861686136,660,It's got great views!  And it's rent stabilized!
5312,2742,9,37,141,187,1.2941176470588236,0.04041911751172696,660,"When you think about it, apartment living is for the birds."
5112,2742,7,36,127,170,1.2941176470588236,0.041421873271840035,660,CouchSurfing is so 2011..
4407,2742,8,29,116,153,1.2941176470588236,0.04531959754911555,660,"But on the plus side, it's rent controlled."
3783,2742,4,37,112,153,1.2941176470588236,0.04135055832744927,660,...and it's recyclable!
1416,2742,12,31,144,187,1.2941176470588236,0.04249950681160455,660,My poli sci professor assigned me the Hatch Act.
1777,2742,8,29,116,153,1.2941176470588236,0.04531959754911555,660,No egg.  Just the nest.
675,2742,9,32,129,170,1.2941176470588236,0.043069697861686136,660,I'm in the center of the city and I got it below market rate!
481,2742,10,35,142,187,1.2941176470588236,0.04112427588048697,660,I'm keeping my nest egg warm.
284,2742,9,27,117,153,1.2941176470588236,0.046258677391591126,660,My shoulder has been acting up so I couldn't fly south this winter.
105,2742,7,41,139,187,1.2941176470588236,0.03897054076981192,660,"The view is great, but Uber Eats says I need a real address."
1145,2753,11,35,148,194,1.2938144329896908,0.04077548624872847,660,I'm in my nesting phase.
4657,2754,4,44,129,177,1.2937853107344632,0.03788988546703703,660,I'm trying out this empty nest thing
4343,2754,9,34,134,177,1.2937853107344632,0.041912409828642215,660,For the first time I feel like I've found my people
4176,2754,9,34,134,177,1.2937853107344632,0.041912409828642215,660,This was the last loft left.
3665,2754,4,44,129,177,1.2937853107344632,0.03788988546703703,660,"Actually, I am loving the empty nest situation!"
3365,2754,11,30,136,177,1.2937853107344632,0.04341719438678202,660,Ever heard of Scientology?
591,2754,8,36,133,177,1.2937853107344632,0.041139382132651045,660,"There's no wi-fi, but the view is priceless."
332,2754,10,32,135,177,1.2937853107344632,0.04267143579763681,660,"haha yeah, it's definitely interesting. she can't cook worth a damn and i keep finding her feathers everywhere, but the sex is GREAT."
152,2761,11,25,124,160,1.29375,0.046578596422113115,660,Its rent controlled.
737,2761,7,33,120,160,1.29375,0.043070874565639565,660,I decided it was time to get out and spread my wings.
1910,2761,9,29,122,160,1.29375,0.04485903409851324,660,What do you think it is? The original Air BnB!
3625,2761,3,41,116,160,1.29375,0.039250921352804266,660,I don't like sleeping on benches....
4854,2761,7,33,120,160,1.29375,0.043070874565639565,660,I am an exotic species.
5470,2761,8,31,121,160,1.29375,0.04397404448137918,660,I decided it was not yet the right time to leave the nest
3242,2767,9,36,139,184,1.2934782608695652,0.040836529922145794,660,"...and when I saw unlimited free bread crumbs were included, how could I refuse?"
2274,2767,5,44,135,184,1.2934782608695652,0.037815817472481104,660,It's been good so far but I'm a little worried about winter.
720,2769,7,35,125,167,1.2934131736526946,0.04188007969615104,660,I can’t abide an empty nest.
2145,2769,8,33,126,167,1.2934131736526946,0.042732726829078936,660,"Yeah, apparently in AirBnB the ""N""  stands for nest."
3197,2769,9,31,127,167,1.2934131736526946,0.043568690698039154,660,I found a solution to my Empty Next Syndrome.
3584,2769,7,35,125,167,1.2934131736526946,0.04188007969615104,660,You guess right- I got the test results this morning!
1137,2773,13,30,148,191,1.293193717277487,0.04251048266243823,660,"Yeah it’s cozy, but you can’t beat $1100 a month."
3345,2773,14,28,149,191,1.293193717277487,0.04315382644894274,660,It's better than a coop.
4572,2775,11,29,134,174,1.293103448275862,0.04391469650730437,660,Poems are made by fools like me.
3909,2775,8,35,131,174,1.293103448275862,0.0415833892938372,660,"Yeah, this gives new meaning to empty nesters."
3196,2775,8,35,131,174,1.293103448275862,0.0415833892938372,660,Found it on Craigslist for $350 a month.  Can't wait to flip it on Air BnB
1870,2775,5,41,128,174,1.293103448275862,0.03911337317334032,660,I'll have to speak to the co-op board if you're interested.
1073,2775,9,33,132,174,1.293103448275862,0.04237474522894614,660,"Now get up here and puke in my mouth, daddy."
260,2775,12,27,135,174,1.293103448275862,0.04466476617406532,660,only $1800.00 per month!
3067,2781,7,32,118,157,1.2929936305732483,0.043583131406531896,660,"Ohhh dude, my bad, I thought this was Berkeley?"
3848,2781,8,30,119,157,1.2929936305732483,0.044510096163984346,660,She hunts while I protect the brood.
3760,2783,10,38,150,198,1.292929292929293,0.03954896876496624,660,...prime location and rent is only $5000 a month.
3592,2784,7,39,135,181,1.292817679558011,0.039750859696826096,660,Winter rental.
3852,2784,8,37,136,181,1.292817679558011,0.040515653775322284,660,Only fifteen hundred a month. And the air conditioning is free!
4131,2784,9,35,137,181,1.292817679558011,0.041266276244008505,660,I'm not fledging until there's a guaranteed annual income.
4721,2787,6,36,122,164,1.2926829268292683,0.04146033383208245,660,You do what you can in this gig economy.
5311,2787,9,30,125,164,1.2926829268292683,0.04408411708007125,660,"I know the children won't be leaving for awhile, but I felt I had to try out an empty nest."
4415,2787,7,34,123,164,1.2926829268292683,0.042352992580866784,660,"You'd be surprised how comfortable it is, and it's rent controlled!"
4850,2787,4,40,120,164,1.2926829268292683,0.03961471801355208,660,You’ve got to read Marie Kondo’s new book: The Life-Changing Magic of ThrowingOutEverythingThatDoesn‘tSparkJoyAndEndingUpLivinginaTree
3770,2787,7,34,123,164,1.2926829268292683,0.042352992580866784,660,Just Google 'Latest nester craze'.
4298,2787,6,36,122,164,1.2926829268292683,0.04146033383208245,660,Gentrification is even starting to affect the pigeons.
1969,2787,10,28,126,164,1.2926829268292683,0.04492467114867582,660,The most affordable apartment in the city with a view.
5429,2794,10,35,143,188,1.2925531914893618,0.04093485109319708,660,You won't believe my mortgage payment.
581,2795,5,40,126,171,1.2923976608187135,0.03951029656790155,660,"Thanks for checking on me dad. Mom and my stepdad, Robin, do take pretty good care of me."
1027,2795,6,38,127,171,1.2923976608187135,0.04037156158099333,660,Where else am I going to get this view without roommates?
1552,2795,10,30,131,171,1.2923976608187135,0.04364700199218211,660,I'm finding out what it is like to be free as a bird!
1734,2795,8,34,129,171,1.2923976608187135,0.04204119270069229,660,I'm building my own nest egg.
2895,2795,7,36,128,171,1.2923976608187135,0.04121483269518802,660,Wanna get high with me buddy?
3294,2800,10,25,119,154,1.2922077922077921,0.04691060391649483,660,Son. This is not what i meant when i said it was time to start nesting.
5360,2801,11,30,137,178,1.2921348314606742,0.04320412575285299,660,Their mother's name is Gloria. We met on hatch.com.
4866,2801,10,32,136,178,1.2921348314606742,0.042463119409665635,660,Aren't you taking empty nesting a little too far?
4670,2801,7,38,133,178,1.2921348314606742,0.040158144800190726,660,You can’t beat the location and I don’t have to deal with the condo board.
468,2801,8,36,134,178,1.2921348314606742,0.04094089112198094,660,I'm subletting until the snowbird owners return.
3655,2801,8,36,134,178,1.2921348314606742,0.04094089112198094,660,Is that how you deal with our empty nest crisis?
3193,2801,9,34,135,178,1.2921348314606742,0.04170895033359998,660,It cost me $199 but I finally found out about my family tree
4163,2801,8,36,134,178,1.2921348314606742,0.04094089112198094,660,I'm waiting for my nesting instinct to kick in.
2942,2808,7,45,150,202,1.2920792079207921,0.03706092032712696,660,"Yes, I’m  “root stabilized “ NOT  “controlled “"
3669,2809,6,35,120,161,1.2919254658385093,0.041925465838509306,660,"Yep, if you think this nest is the best, when when spring comes, I have a Palmetto Palm on Hilton Head."
704,2809,4,39,118,161,1.2919254658385093,0.04003080292312934,660,"House-sitting is the best gig, pal. You should see the view!"
2861,2809,9,29,123,161,1.2919254658385093,0.04461685713308811,660,I decided that hugging just didn’t quite express my feelings.
5384,2809,6,35,120,161,1.2919254658385093,0.041925465838509306,660,Just waiting to hear from the condor board.
4533,2813,11,32,142,185,1.2918918918918918,0.0420668421435111,660,Living with my mom has its perks. She’s out getting me a breakfast worm as we speak.
143,2814,7,35,126,168,1.2916666666666667,0.04166666666666666,660,"Yeah, but it's rent-controlled."
3509,2814,8,33,127,168,1.2916666666666667,0.042513493276144954,660,Nothing like a bird's eye view.
4855,2814,5,32,107,144,1.2916666666666667,0.04393587720031666,660,"Men have nesting instincts too, you know."
142,2817,8,35,132,175,1.2914285714285714,0.04137899757485986,660,It's my safe space.
1506,2817,6,39,130,175,1.2914285714285714,0.03976001195066066,660,"Honey, I don't think this is what they meant when they said you'd start 'nesting'."
2969,2817,8,35,132,175,1.2914285714285714,0.04137899757485986,660,"I'm above the next waterline, don't you know."
5689,2817,7,37,131,175,1.2914285714285714,0.040577579958746536,660,"It’s not the biggest, but the rent’s only twelve hundred a month!"
2732,2821,9,26,116,151,1.2913907284768211,0.04659667154406444,660,To be free as a bird you have to live like a bird
4872,2822,11,31,140,182,1.2912087912087913,0.04252300982644097,660,I’ve evolved.
4630,2822,12,29,141,182,1.2912087912087913,0.04323099735831552,660,It is called the Empty Nest Syndrome
2480,2822,5,43,134,182,1.2912087912087913,0.037999075743089666,660,"When all the birds fly south for the winter, it leaves a fair amount of unused real estate"
4438,2822,7,39,136,182,1.2912087912087913,0.03956457118583799,660,It's my nesting instinct kicking in!
1499,2826,9,28,121,158,1.2911392405063291,0.045167856347019135,660,"It was affordable, and the view can't be beat!"
1446,2827,7,41,141,189,1.291005291005291,0.03861948064857136,660,"I'm a single mother, and all my kids have... well, you can tell that much already."
2183,2827,8,39,142,189,1.291005291005291,0.03934147399240681,660,What? You never heard of the nesting instinct?
2503,2827,9,37,143,189,1.291005291005291,0.04005045400772712,660,Why? Seriously?
2866,2827,7,41,141,189,1.291005291005291,0.03861948064857136,660,It’s my new hunting mantra: ‘Be the squirrel.’
5716,2831,8,32,125,165,1.290909090909091,0.04300104144408387,660,"Rent-controlled, great view, concierge and the best part of all: No common charges!"
3738,2831,8,32,125,165,1.290909090909091,0.04300104144408387,660,Surprisingly cozy for only $1600 a month!
3993,2831,9,30,126,165,1.290909090909091,0.043852017003590725,660,"Some call it flying south, I call it gentrification."
5017,2831,12,24,129,165,1.290909090909091,0.046311217704843206,660,You've never heard of a pied-a-tree?
5563,2835,11,35,150,196,1.2908163265306123,0.04041369967727917,660,Only two more days and I'll break the record .
3831,2836,7,27,107,141,1.2907801418439717,0.04671477520129208,660,It was an unbeatable Air BnB deal and the owners are away until Spring
3863,2837,10,30,132,172,1.2906976744186047,0.04342578573955151,660,So I got in early on this IPO....
4232,2837,8,34,130,172,1.2906976744186047,0.04183061026435942,660,I'm just here until my coop board package gets approved.
4918,2837,10,30,132,172,1.2906976744186047,0.04342578573955151,660,"I wanted to be sure my ""empty nest"" was going to STAY empty."
5245,2837,8,34,130,172,1.2906976744186047,0.04183061026435942,660,"It is part of a time sharing, seasonal role reversal and zero maintenance investment scheme."
1697,2841,7,29,112,148,1.2905405405405406,0.04522967310855908,660,The amenities aren't great but at least it's rent controlled.
1802,2842,9,34,136,179,1.2905027932960893,0.041507382557178375,660,The only downside is you get shit on all the time.
3446,2842,6,40,133,179,1.2905027932960893,0.03917334183898954,660,The hot tub comes in on Tuesday.
3644,2842,7,38,134,179,1.2905027932960893,0.03996650359328677,660,Don't you think this could be the perfect love nest?  Come on up.
4070,2842,6,40,133,179,1.2905027932960893,0.03917334183898954,660,It's given me a different perspective on affordable housing
5039,2842,9,34,136,179,1.2905027932960893,0.041507382557178375,660,"I'm a grad student on a project called ""Nests for the Homeless"" . The Cornell Lab of Ornithology wants to learn if birds are more accommodating about sharing their space with the homeless than the people of this city are."
3651,2847,9,36,141,186,1.2903225806451613,0.04045749009336217,660,Check out this view! Who else has this proximity to the park with only 1 roommate? I'd be a fool not to take it!
1862,2847,9,27,119,155,1.2903225806451613,0.04573813181316198,660,And they say that I'm cuckoo.
1678,2849,12,32,149,193,1.2901554404145077,0.04147775460629647,660,"Poached is trickier, but I'll try."
2771,2849,11,34,148,193,1.2901554404145077,0.04082195195028793,660,"No, I am not nuts. They don't come until the fall."
1235,2851,7,33,122,162,1.2901234567901234,0.042614230097606544,660,"What do you mean, why? At just $4,500 a month, why not?"
1539,2851,8,31,123,162,1.2901234567901234,0.04350464162492643,660,"With winter ending and spring coming, I decided to branch out."
4352,2851,7,33,122,162,1.2901234567901234,0.042614230097606544,660,"There's no dishwasher, but you can't beat the view."
4930,2851,7,33,122,162,1.2901234567901234,0.042614230097606544,660,"Mom said it was time to leave the nest. I said, No Way. I'm good here."
1055,2855,4,41,124,169,1.2899408284023668,0.03882289016545469,660,I actually prefer public housing.
3432,2855,9,31,129,169,1.2899408284023668,0.04312109334736757,660,The best part is it's rent-controlled.
4062,2855,6,37,126,169,1.2899408284023668,0.04059681708050928,660,Would you happen to know where the nearest restroom is?
5730,2858,9,33,134,176,1.2897727272727273,0.04195761269760439,660,Nesting in the Park with George.
5307,2858,10,31,135,176,1.2897727272727273,0.04272442308817333,660,"I don't care if it is tiny, its rent stabilized"
3854,2858,9,33,134,176,1.2897727272727273,0.04195761269760439,660,"Cheap...
Cheap...
Cheapest rent on the Upper West Side!"
3660,2858,11,29,136,176,1.2897727272727273,0.04347771145256271,660,"Sorry, the doctor said I should be nesting; you will have to cook and clean the house."
5250,2858,10,31,135,176,1.2897727272727273,0.04272442308817333,660,"It's the only B&B that serves eggs, any style."
1253,2863,7,39,137,183,1.289617486338798,0.03937994205413442,660,I should be a Mom by early spring.
1275,2863,10,33,140,183,1.289617486338798,0.04160441752168046,660,This place was a steal on Airbnb!
2184,2863,8,37,138,183,1.289617486338798,0.04013513518806301,660,I've gotten into nesting this winter.
3060,2863,10,33,140,183,1.289617486338798,0.04160441752168046,660,My parents are empty nesters now.
3189,2863,4,45,134,183,1.289617486338798,0.037022049039128785,660,It's actually rent-controlled. I'm thinking of staying forever.
2844,2868,12,31,147,190,1.2894736842105263,0.041911626591735286,660,"Got a good deal on Aeriebnb.*

*C'mon New Yorker readers.  Time to raise the bar.  An Aeirie is a large nest of a bird of prey, especially an eagle, typically built high in a tree or on a cliff."
539,2868,7,41,142,190,1.2894736842105263,0.038446202424694216,660,"It’s $4,500 a month but that’s fair for a studio on Central Park West."
4326,2868,7,41,142,190,1.2894736842105263,0.038446202424694216,660,"No stairs or elevator is inconvenient, but you can't beat the rent."
3815,2871,11,35,151,197,1.2893401015228427,0.0402351210981322,660,The best part is regurgitated avocado toast
4123,2872,7,32,120,159,1.2893081761006289,0.04311151787474359,660,"Housing is too expensive. I'll have more privacy though, when the leaves develop."
5319,2872,10,26,123,159,1.2893081761006289,0.04579778882396355,660,"Believe it or not, there's actually room for two up here."
1921,2874,5,38,123,166,1.2891566265060241,0.04013507766085721,660,And the best part? No hidden cameras.
2319,2874,7,34,125,166,1.2891566265060241,0.041914951498225626,660,And federal law says there's not a damn thing they can do to remove me.
4570,2874,6,36,124,166,1.2891566265060241,0.04103466594199133,660,Real estate in the city is crazy these days.
4458,2877,5,40,128,173,1.2890173410404624,0.03912485870592334,660,The crane got a better deal uptown.
5376,2877,8,34,131,173,1.2890173410404624,0.04162204432912362,660,"Hey, get me a copy of the Mueller report!"
2005,2877,8,34,131,173,1.2890173410404624,0.04162204432912362,660,The view is great and I can afford the rent.
2995,2877,8,34,131,173,1.2890173410404624,0.04162204432912362,660,I will come down as soon as you start doing the the housekeeping.
5729,2877,8,34,131,173,1.2890173410404624,0.04162204432912362,660,But what if I told you it includes a free egg breakfast?
4871,2882,9,34,137,180,1.288888888888889,0.04130768178085716,660,Got a good deal at only $1800 a month
5513,2882,10,32,138,180,1.288888888888889,0.04205232241552596,660,Did you bring the olive branch?
4594,2882,5,42,133,180,1.288888888888889,0.03818417981815775,660,"I'm free as a bird George, free as a bird!"
4200,2882,11,30,139,180,1.288888888888889,0.04278400480284817,660,Interested in being on HGTV's newest hit: Tiny Tree House?
4181,2882,8,36,136,180,1.288888888888889,0.04054936901701148,660,Only until I'm 59 and a half.
3745,2882,7,38,135,180,1.288888888888889,0.03977660218328084,660,"I found the perfect Brooklyn sublet--
it's only 2 grand a month and it's organic!"
2614,2882,11,30,139,180,1.288888888888889,0.04278400480284817,660,This bird's-eye view is great!
1639,2882,6,40,134,180,1.288888888888889,0.03898852183420389,660,...And rent is only $1500 a month.
518,2890,9,36,142,187,1.2887700534759359,0.04027049629634417,660,I'm not sure that's what they mean by 'nesting'.
3102,2890,8,38,141,187,1.2887700534759359,0.03955011840293604,660,"Sorry, but the landlord won't allow me to sub-let."
4166,2890,7,40,140,187,1.2887700534759359,0.038816373599534645,660,Just trying to confuse some birders.
4342,2890,7,40,140,187,1.2887700534759359,0.038816373599534645,660,It was my IRA that got me this nest egg.
4724,2890,8,38,141,187,1.2887700534759359,0.03955011840293604,660,Nope. The rent is not “too damn high.” The room service however...it’s for the birds.
192,2895,8,27,114,149,1.2885906040268456,0.045964779232922755,660,I’m working on my nest egg
3397,2896,8,29,119,156,1.2884615384615385,0.04456351624034515,660,"I don't mind keeping the chicks warm, but regurgitating worms in their mouths is kind of a drag.jj"
34,2897,8,31,124,163,1.2883435582822085,0.04327353850880402,660,Laugh now. The rent's affordable and by summer I'll be all settled in.
123,2897,12,23,128,163,1.2883435582822085,0.04664290496129788,660,It was the best deal  I could find on Airbnb.
525,2897,4,39,120,163,1.2883435582822085,0.039618653269857904,660,My parents moved to Florida even though the nest wasn’t quite empty yet.
5567,2897,9,29,125,163,1.2883435582822085,0.044139998834525074,660,Three summers actually but I lose my privacy in the fall.
520,2901,8,33,129,170,1.2882352941176471,0.04208144796380091,660,"Trust me, I'll leave once I build up my nest egg"
3035,2901,5,39,126,170,1.2882352941176471,0.039522238422276264,660,"It's a ""climb up"" with great view of the park."
3375,2901,4,41,125,170,1.2882352941176471,0.038631511562880534,660,"Well, at least my nest egg is safe. Is yours?"
3478,2901,7,35,128,170,1.2882352941176471,0.04124602548677637,660,The blinds won’t arrive until spring.
4801,2901,9,31,130,170,1.2882352941176471,0.042900604972475165,660,"So, now how do you and mom like being empty nesters?"
4803,2906,10,31,136,177,1.2881355932203389,0.042513889670317544,660,I'm house sitting for a vacationing bald eagle family
3400,2906,10,31,136,177,1.2881355932203389,0.042513889670317544,660,Bring me some worms.
338,2908,7,39,138,184,1.2880434782608696,0.03919695185915761,660,I giving the bird a break.
1164,2908,6,41,137,184,1.2880434782608696,0.03843181629596165,660,It's drafty but it's rent controlled.
5119,2908,8,37,139,184,1.2880434782608696,0.03994743504020871,660,Go get some take out and we'll switch.
5308,2908,9,35,140,184,1.2880434782608696,0.040684076707408146,660,AIRBNB Cheep!
439,2912,7,41,143,191,1.287958115183246,0.03827440180719458,660,Last time I tried this I got a free meal out of it.
2292,2912,6,43,142,191,1.287958115183246,0.037547546294086534,660,"Cheap rent, and no neighbors."
5345,2912,5,45,141,191,1.287958115183246,0.03680633955875757,660,Folks pay millions of dollars for this view.
5762,2915,7,28,111,146,1.2876712328767124,0.04554701289352375,660,Jealous?
2029,2916,7,30,116,153,1.2875816993464053,0.044157443605784004,660,"A room of my own, Fred.  Finally!"
4734,2916,6,32,115,153,1.2875816993464053,0.04317268249474997,660,Great location and just what I needed when I wanted to downsize after becoming an empty nester.
232,2916,4,36,113,153,1.2875816993464053,0.04113249189851598,660,"As you can see, I give lot of importance to retirement planning"
3850,2916,6,32,115,153,1.2875816993464053,0.04317268249474997,660,"My roommates are a little loud in the morning, but that's just New York real-estate on a budget."
4662,2920,4,38,118,160,1.2875,0.040034870806624864,660,"When you said ground floor with city views, I certainly had something else in mind."
70,2920,6,34,120,160,1.2875,0.04195263501742959,660,I prefer when the birds watch ME.
506,2920,10,26,124,160,1.2875,0.045546558527628525,660,"You're sitting on a nest egg, you say?"
2353,2920,3,40,117,160,1.2875,0.03904067786683379,660,I'm sure they will be quintuplets.
4261,2920,7,32,121,160,1.2875,0.04287936493357752,660,Yeah...so I thought I was going to have enough for first month and last month with my tax return...
5096,2920,9,28,123,160,1.2875,0.04467519044737731,660,Paying rent is for the birds!
3312,2926,9,30,128,167,1.2874251497005988,0.04339482258815329,660,Where did you migrate from?
4908,2926,10,28,129,167,1.2874251497005988,0.044218271046593614,660,You liked me much better when I was a bird in the bush.
2400,2926,6,36,125,167,1.2874251497005988,0.04082494368372279,660,It's not so bad. I can actually afford to build a nest egg here!
4502,2926,8,32,127,167,1.2874251497005988,0.04255544337173069,660,I wasn’t about to let my finances affect my plans of retiring young.
782,2926,8,32,127,167,1.2874251497005988,0.04255544337173069,660,I met this really cool girl named Robin online
636,2926,9,30,128,167,1.2874251497005988,0.04339482258815329,660,"Location, location, location and this was the only tree in the foreground."
2210,2926,7,34,126,167,1.2874251497005988,0.04169917137871996,660,I have this desire to nest
1624,2933,7,36,131,174,1.2873563218390804,0.040605420938043604,660,"The neighborhood is a little seedy, but I've got great commuting options."
2041,2933,9,32,133,174,1.2873563218390804,0.042209972111649965,660,It is a tiny house!
2112,2933,9,32,133,174,1.2873563218390804,0.042209972111649965,660,This must be the nesting period they mentioned.
3698,2933,7,36,131,174,1.2873563218390804,0.040605420938043604,660,I started wondering what would happen if Lyft merged with Twitter to create a new platform ...
3825,2933,10,30,134,174,1.2873563218390804,0.04298979546033624,660,it`s covered by rent control
3916,2933,8,34,132,174,1.2873563218390804,0.041415467854546674,660,"See honey, I told you an Airbnb would be more authentic than a hotel."
3958,2933,11,28,135,174,1.2873563218390804,0.043755722846009815,660,And the omelets are to die for.
5487,2933,9,32,133,174,1.2873563218390804,0.042209972111649965,660,"Yeah, well the ad said loft, but now I know they used it in the same way they use the word character when what they really mean is old."
1299,2941,8,38,142,188,1.2872340425531914,0.039369158531500636,660,"Best place I could find for $3,000 a month!"
844,2942,6,44,145,195,1.2871794871794873,0.03704593768937325,660,"We'll leave our apartment and move to the Hamptons, yes?"
3456,2942,9,38,148,195,1.2871794871794873,0.03912806897357123,660,The tree is hugging me.
4524,2942,10,36,149,195,1.2871794871794873,0.03979791295665836,660,"I like a birdseye's view of the city,"
433,2942,11,34,150,195,1.2871794871794873,0.04045666780409581,660,Are you sure you don't want to stay for dinner? My mom regurgitates the best meals!
2798,2946,6,31,113,150,1.2866666666666666,0.043695782427356215,660,It’s a great deal on air b &b
3184,2946,9,25,116,150,1.2866666666666666,0.046666666666666676,660,They built a wall. I built a nest!
3553,2946,4,35,111,150,1.2866666666666666,0.04159748171119138,660,"Keeping the eggs warm? Ah, yep, let's go with that"
219,2949,7,31,119,157,1.286624203821656,0.04338577281631521,660,"Oh, I definitely got the better part of the deal this time - SHE has to take MY kids to a birthday party!"
4939,2949,8,29,120,157,1.286624203821656,0.044316865866135244,660,And you can follow me on Twitter!
4838,2951,10,27,127,164,1.2865853658536586,0.04474915864064111,660,It was the only place I could find that was affordable.
3211,2951,8,31,125,164,1.2865853658536586,0.04304478831253317,660,"After taxes, this is the only 'crow's nest' I could afford."
3040,2951,9,29,126,164,1.2865853658536586,0.043905244560963654,660,Wanna see my nuts?
1015,2951,10,27,127,164,1.2865853658536586,0.04474915864064111,660,"You always told me I was a nester, Phil, and besides, I've met ten firemen this week!"""
1672,2951,7,33,124,164,1.2865853658536586,0.042166777227855064,660,This was my parent's idea.
1355,2956,8,33,130,171,1.286549707602339,0.04186857758562124,660,It's time you know George that we are expecting our first child. The doctor said I have classic nesting instincts
2323,2956,8,33,130,171,1.286549707602339,0.04186857758562124,660,I’m actually subletting for the winter.
3687,2956,11,27,133,171,1.286549707602339,0.04426484087689004,660,This one's under nest control.
4843,2956,7,35,129,171,1.286549707602339,0.04103874193294408,660,"I got it rent-controlled,
with one previous owner"
5220,2956,5,39,127,171,1.286549707602339,0.03932657422443476,660,"For a New York City apartment, the rent's not too bad.  -Tom Potter"
5387,2956,9,31,131,171,1.286549707602339,0.04268228249107103,660,"It gets a little chilly during the winter, but the rent is only $2500 a month!"
575,2962,7,37,134,178,1.2865168539325842,0.03999128660310702,660,It's close to everything and right here at my usual bus stop.
1749,2962,8,35,135,178,1.2865168539325842,0.04077723600540698,660,"You said that I couldn't make it without you, but here I am, living comfortably. Best of all I'm finally using my Master of ornithology degree!"
2264,2962,7,37,134,178,1.2865168539325842,0.03999128660310702,660,They should redesign those benches. This is far more comfy.
5413,2965,8,37,140,185,1.2864864864864864,0.03976141250126382,660,I know longer feel the need to migrate now that I live in a sanctuary city.
834,2965,9,35,141,185,1.2864864864864864,0.040493509735217474,660,"Really, Dad, it's just till Spring, then I 'll move out."
2660,2967,11,35,153,199,1.2864321608040201,0.03988250052190909,660,Freshairbnb
5727,2968,6,34,121,161,1.2857142857142858,0.04172947056216268,660,Would you like to be my wingman?
5721,2968,6,38,131,175,1.2857142857142858,0.039584992310630805,660,I'm the seat warmer for the NBC peacock
5680,2968,7,36,132,175,1.2857142857142858,0.040406101782088436,660,Just hedging in case the  pied-à-terre tax or the Green New Deal passes.
5338,2968,5,36,120,161,1.2857142857142858,0.04078858862286861,660,"The lease looked fine. Just don""t deal with the branch office>"
5146,2968,7,42,147,196,1.2857142857142858,0.03758820082744411,660,No wonder geese fly south for the winter.
4799,2968,6,34,121,161,1.2857142857142858,0.04172947056216268,660,Nearly everyday an eagle brings me a Filet-O-Fish.
4431,2968,8,30,123,161,1.2857142857142858,0.04355029525162823,660,Mama will be back any minute now if you want to stay for lunch.
4369,2968,9,32,134,175,1.2857142857142858,0.04200018989490487,660,"Basically, I’m a birdbrain."
4270,2968,7,44,152,203,1.2857142857142858,0.0367657253951811,660,"Sure, it's low on amenities, but it's got the best view of Central Park for under $500 a month."
1898,2968,7,30,117,154,1.2857142857142858,0.0439094972056236,660,"your nest egg is all grown up, dad"
1932,2968,7,32,122,161,1.2857142857142858,0.04264960099404445,660,"No, it's at least another two weeks until they hatch - how about late May?"
1341,2968,10,34,145,189,1.2857142857142858,0.040600658892644165,660,"Even here, the rent is high."
1259,2968,11,28,136,175,1.2857142857142858,0.04353594883761751,660,I've been into this ever since I found out I have eggs.
759,2968,10,36,150,196,1.2857142857142858,0.03962144258751637,660,Who says I am out of my tree?
724,2968,10,30,135,175,1.2857142857142858,0.04277496225831017,660,I will not come home unless you stop talking endlessly about a woman's nesting instinct.
699,2968,10,22,115,147,1.2857142857142858,0.04826695559996328,660,It’s rent-controlled at $400 a month.
138,2968,11,26,131,168,1.2857142857142858,0.04479053134576749,660,"First, we introduced you to minimalism in “Small Space, Big Style” then made it  desirable in “Tiny House Hunters”, and for those seeking adventure “Treehouse Masters”. Now we are bringing these all together, new from HGTV “Nesting in the City”."
3424,2968,6,34,121,161,1.2857142857142858,0.04172947056216268,660,"The rent's not great, but it's only four blocks to the L train."
961,2986,11,33,149,193,1.2849740932642486,0.040681274916656955,660,It's called 'nesting!'  I saw it on HGTV.
3814,2987,10,33,143,186,1.2849462365591398,0.04101936000069687,660,"The sublease from the eagles is
half the price that my studio was..."
807,2987,13,27,146,186,1.2849462365591398,0.04309241013415437,660,"Hi, I’m Robin.  Want to fertilize my eggs?"
1803,2987,9,35,142,186,1.2849462365591398,0.04030465551395981,660,Now I'm empty nesting. Happy?
13,2990,8,35,136,179,1.2849162011173185,0.04058037068504375,660,"Now the kids are gone, I'm an empty-nester."
182,2990,9,33,137,179,1.2849162011173185,0.041346549838812835,660,"It’s called a drey, Einstein. Squirrels don’t make nests."
746,2990,13,25,141,179,1.2849162011173185,0.044278888627933485,660,I'm pregnant!
2150,2990,9,33,137,179,1.2849162011173185,0.041346549838812835,660,"Well, yeah, but I self-identify as an Avian-American.. no rent, and all the bread i can eat."
2404,2990,7,37,135,179,1.2849162011173185,0.039799444547602446,660,It came out of my new fledge fund.
5570,2995,10,29,133,172,1.2848837209302326,0.04325931980487248,660,The guys told me this was the best way to become an Eagle Scout.
4926,2995,8,33,131,172,1.2848837209302326,0.041657770439277333,660,"No, Harold, I'm not 'hinting' at anything. I simply find this empty nest a delightful place to rest."
5327,2995,8,33,131,172,1.2848837209302326,0.041657770439277333,660,... then my mum said “you are what you eat” so that’s why I’m up here.
1033,2995,4,41,127,172,1.2848837209302326,0.03825404572008195,660,"No, I'm not egging you on."
378,2995,6,37,129,172,1.2848837209302326,0.03999213580146507,660,I'm sitting on my nest egg.
2738,2995,9,31,132,172,1.2848837209302326,0.042466095817438654,660,How else am I gonna protect my nest egg?
344,3001,7,33,125,165,1.284848484848485,0.04194641692134844,660,"What can I say, I like to get a birds-eye view of the city."
2575,3001,7,33,125,165,1.284848484848485,0.04194641692134844,660,"Judging by their indignant tweets, they don't like getting pooped on either."
3354,3001,8,31,126,165,1.284848484848485,0.04281835730789982,660,It's the latest Silicon Valley innovation! They call it Nexst.
4348,3001,5,37,123,165,1.284848484848485,0.04014576232337362,660,"The former tenants flew South, so I installed a space heater and moved right in."
4965,3001,9,29,127,165,1.284848484848485,0.0436728926515564,660,"This is empty nesting, Audubon Society style."
228,3006,6,27,104,137,1.2846715328467153,0.04627482577821218,660,I am a surrogate incubator for a gay couple
3841,3007,7,40,143,190,1.2842105263157895,0.03829149639483411,660,My sleep number is the same as my carbon footprint.
1785,3007,10,34,146,190,1.2842105263157895,0.04041439191385028,660,The previous tenant was Gwyneth Paltrow!
331,3007,13,28,149,190,1.2842105263157895,0.04243120846001184,660,Spare worms?
502,3007,8,38,144,190,1.2842105263157895,0.039011965968052564,660,Most affordable rent I could find.
903,3011,9,34,140,183,1.284153005464481,0.04071954000040328,660,For God's sake Harry...can't you guess?
1923,3011,7,38,138,183,1.284153005464481,0.03921711943896727,660,"Yep, I'm on paternal leave. They're due to hatch any day now."
2690,3011,8,36,139,183,1.284153005464481,0.03997538864685788,660,It's got a good view and it's rent controlled!
3218,3011,9,34,140,183,1.284153005464481,0.04071954000040328,660,"Aren't you taking 'oh, go lay an egg' to the extreme?"""
376,3015,10,30,136,176,1.2840909090909092,0.04256219839241481,660,Homelessness doesn’t preclude comfort.
1142,3015,7,36,133,176,1.2840909090909092,0.04020865002944122,660,"When we broke up I didn't LITERALLY mean you needed to ""branch out."""
1350,3015,6,38,132,176,1.2840909090909092,0.03939289875415388,660,"Just until they hatch, then I have a gig as Birdman in Times Square."
5092,3015,9,32,135,176,1.2840909090909092,0.04179241159660702,660,The rent’s only a thousand a month!
5619,3015,10,30,136,176,1.2840909090909092,0.04256219839241481,660,I was tired of being empty nested.
4294,3020,9,30,130,169,1.2840236686390532,0.04294674859024001,660,Wanna join me? I'm looking for a roommate
3936,3020,10,28,131,169,1.2840236686390532,0.04375917723870009,660,"I didn't know 'eggsitter' was a job until the read the parents' tweet."""
295,3020,6,36,127,169,1.2840236686390532,0.04041158348876254,660,Best deal in Bed Stuy.
859,3020,8,32,129,169,1.2840236686390532,0.042118651881780315,660,I told my gyno I wanted to preserve my eggs.
5197,3024,12,22,128,162,1.2839506172839505,0.0467231048205868,660,"I found bird-watching rather voyeuristic, so now I'm giving back."
5006,3024,7,32,123,162,1.2839506172839505,0.04242219164031854,660,"Yeah, as a Millennial,  it's hard to get by. I started at my third job this week, but hey! I just found this sick pad. 100% hardwood, great views,  so things are looking up!"
3120,3024,8,30,124,162,1.2839506172839505,0.04331655087457262,660,"Okay, okay, we'll redo the nursery from top to bottom. Just come home now."
2852,3024,9,28,125,162,1.2839506172839505,0.04419281407390758,660,Come on down! Tax season is over.
4658,3024,5,36,121,162,1.2839506172839505,0.04057437456529503,660,"It does need some renovation, but at least the rent is free!"
2447,3024,5,36,121,162,1.2839506172839505,0.04057437456529503,660,"A dinner date is fine, but I'd rather we take a walk in the park and nibble on dropped potato chips and popsickle wrappers."
824,3024,6,34,122,162,1.2839506172839505,0.04150856667564403,660,It's a nest-share I got on chirp.com.
135,3024,6,34,122,162,1.2839506172839505,0.04150856667564403,660,"Now that the kids are out, this nest is MINE!"
10,3024,6,34,122,162,1.2839506172839505,0.04150856667564403,660,Outta jail and as free as a bird dude.
2637,3024,10,26,126,162,1.2839506172839505,0.04505203715563248,660,It's a Red-tailed hawk sublet.
2290,3034,8,28,119,155,1.2838709677419355,0.04461334957357563,660,I'm a substitute hatcher.
2719,3034,6,32,117,155,1.2838709677419355,0.04269398785603557,660,Regurgitated is such an ugly word
5167,3034,8,28,119,155,1.2838709677419355,0.04461334957357563,660,I’m having the bidet installed next Thursday.
165,3037,8,26,114,148,1.2837837837837838,0.04602266935891564,660,The birds were right.
3597,3038,11,35,155,201,1.2835820895522387,0.0395358080956892,660,"I'm just not an ""empty nester!"""
1751,3039,11,33,150,194,1.2835051546391754,0.04049768392199635,660,"No, it has nothing to do with saving the trees or the forest...I just like looking down at people...."
4243,3040,7,39,141,187,1.2834224598930482,0.03865761476001332,660,"And get this, great natural lighting"
2115,3040,7,39,141,187,1.2834224598930482,0.03865761476001332,660,Are you finally gonna ask me to come home now?
5193,3042,4,43,133,180,1.2833333333333334,0.03718442636703988,660,"Dad, you are an Empty Nester!"
2119,3042,10,31,139,180,1.2833333333333334,0.041894164782586854,660,It is only $600 per month with a great view of the buildings.
139,3042,9,33,138,180,1.2833333333333334,0.04114666203229312,660,I'm totally into natural birthing.
866,3042,7,37,136,180,1.2833333333333334,0.03960935878726359,660,Apartment living is for the birds.
3631,3046,5,39,129,173,1.283236994219653,0.03894071728155637,660,Maybe you shouldn’t sit there... it doesn’t fall far from the tree...
3928,3046,10,29,134,173,1.283236994219653,0.043040052718724076,660,"Dad, in case you were wondering where I live after moving out of your basement..."
4175,3046,10,29,134,173,1.283236994219653,0.043040052718724076,660,It's a new first step to freezing your eggs.
4974,3046,8,33,132,173,1.283236994219653,0.0414489983929548,660,"I’m sub-letting. Hey - don’t knock it, it’s rent-controlled!"
580,3050,7,33,126,166,1.283132530120482,0.041728258712600705,660,Beige.  I think I'll paint the leaves beige.
1700,3050,10,27,129,166,1.283132530120482,0.04427533879677363,660,I'm honoring my inner eagle.
2648,3050,6,35,125,166,1.283132530120482,0.040843949675049215,660,"JUST UP HERE, SITTING ON MY NEST EGG."
710,3053,7,31,121,159,1.2830188679245282,0.042913624078767434,660,It is a little drafty at times but it is centrally located and it's still under rent control!
958,3053,7,31,121,159,1.2830188679245282,0.042913624078767434,660,I’m re-wilding. Follow my journey on Instagram.
3630,3053,7,31,121,159,1.2830188679245282,0.042913624078767434,660,Border Patrol - we hear there's a flock of migrants heading this way.
5475,3056,10,34,147,191,1.2827225130890052,0.04022977004306894,660,It’s Airbnb week at home.
1376,3056,12,30,149,191,1.2827225130890052,0.041577128324383164,660,Apartments are too expensive so I'm nesting.
2665,3056,12,30,149,191,1.2827225130890052,0.041577128324383164,660,"Guess I'm a bit early for the Biden, Warren, Gillibrand, Booker, Harris, O'Rourke, Klobuchar, Buttigieg, Swalwell, Castro, Delaney, Gabbard, Hickenlooper, Inslee, Ryan, Sanders, Weld, Williamson, Yang, or Whoever for President rally."""
3565,3059,8,36,140,184,1.2826086956521738,0.0397875191549893,660,"All of the pregnancy books said I'd be nesting, so it felt right."
5761,3059,10,32,142,184,1.2826086956521738,0.041253360384261924,660,Mom said I could stay as long as I pay utilities.
1845,3059,9,34,141,184,1.2826086956521738,0.040527067643134705,660,I let the birds watch me!
1788,3062,4,42,131,177,1.2824858757062148,0.037529181512956,660,What’s not to like?  No condo fees and free AC in the summer...
5212,3062,9,32,136,177,1.2824858757062148,0.04158661012839684,660,I outgrew the cradle waiting for the bough to break.
312,3062,12,26,139,177,1.2824858757062148,0.043841192366706985,660,No eggs yet but I'm working on it.
635,3065,8,32,130,170,1.2823529411764707,0.04190348200105059,660,Where's David Attenborough when you need him?
722,3065,6,36,128,170,1.2823529411764707,0.04020789120637658,660,I needed a chick hangout.
797,3065,6,36,128,170,1.2823529411764707,0.04020789120637658,660,It’s my version of your man cave.
3392,3065,8,32,130,170,1.2823529411764707,0.04190348200105059,660,My birdbathroom is one tree over.
4116,3065,5,38,127,170,1.2823529411764707,0.03933269468253526,660,It's got a great view of the park and it's rent controlled.
4214,3065,11,26,133,170,1.2823529411764707,0.044325418628989886,660,"It's only $2,600 a month, includes utilities, and has a park view!"""
4517,3065,6,36,128,170,1.2823529411764707,0.04020789120637658,660,I’ve decided to not fly south this year.
5256,3065,4,40,126,170,1.2823529411764707,0.03843757571329466,660,"Some people like to watch, I like to be."
5595,3073,6,34,123,163,1.2822085889570551,0.04128989153621762,660,Can you help me move it up here tomorrow?
1598,3073,10,26,127,163,1.2822085889570551,0.04480866647455978,660,Why not? Birds do it.
3927,3073,7,32,124,163,1.2822085889570551,0.04219710304169643,660,Heat is extra but at least it's rent controlled.
447,3076,9,26,121,156,1.2820512820512822,0.045286398422963496,660,I believe I've found the last rent controlled spot in the city!
1533,3076,6,32,118,156,1.2820512820512822,0.04245843761029148,660,"Better view, and people feed me plenty of popcorn and nuts."
1576,3076,7,30,119,156,1.2820512820512822,0.043421560430802184,660,We are trying out this house swap thing
735,3079,10,33,145,188,1.2819148936170213,0.04063808341998782,660,Who doesn't like empty nesting?
4722,3079,6,41,141,188,1.2819148936170213,0.0377345551227252,660,I am no longer an Empty Nester.
2203,3081,10,22,117,149,1.2818791946308725,0.04769352484413388,660,I’m building our nest egg...beats betting on the market!
3832,3082,6,39,136,181,1.281767955801105,0.038634549695131686,660,"Nope, not empty yet."
5476,3082,9,33,139,181,1.281767955801105,0.04094863236740271,660,Whan the Aprill with his shoures soote
707,3082,7,37,137,181,1.281767955801105,0.0394210068916388,660,"But hey, it's rent controlled."
2444,3082,9,33,139,181,1.281767955801105,0.04094863236740271,660,"It's like, totally hygge!"
1960,3086,7,35,132,174,1.2816091954022988,0.04042871601361234,660,"On the plus side, the rent is low, and my roommate and I get along great… we’re both early birds!"
2269,3086,9,31,134,174,1.2816091954022988,0.04204001206731359,660,Come on up! I’m just babysitting for the neighbor!
2388,3086,6,37,131,174,1.2816091954022988,0.03959848873952181,660,Terrible plumbing and no elevator but the view and location are great.
4017,3086,7,35,132,174,1.2816091954022988,0.04042871601361234,660,You may be wondering why I’m in a human sized birds nest right now.
4837,3086,12,25,137,174,1.2816091954022988,0.04434732143868114,660,Help me get down once labor starts!
5571,3091,6,46,154,206,1.2815533980582525,0.03564961664929657,660,This makes the migration all worth it.
5660,3092,5,37,125,167,1.281437125748503,0.03973636839233475,660,I plan to fly south in the next couple of weeks.
1579,3092,7,33,127,167,1.281437125748503,0.04151227176145364,660,"Don't worry, I'm just pregnant."
4486,3092,5,37,125,167,1.281437125748503,0.03973636839233475,660,Don't have to pay utilities!
554,3092,10,27,130,167,1.281437125748503,0.04404206293391515,660,I’ve lived here since I was a yolk.
1441,3092,7,33,127,167,1.281437125748503,0.04151227176145364,660,Audrey's adjusted better to empty nesting than I have.
757,3097,10,25,125,160,1.28125,0.04536008534788372,660,I am loving this empty nest phase of life.
4226,3097,5,35,120,160,1.28125,0.04079773990996323,660,"There's no room for a home gym, but otherwise, the empty nest is surprisingly cozy."
5497,3097,6,33,121,160,1.28125,0.04175011298143113,660,"Quite literally, the best Airbnb ever."
289,3100,9,34,142,185,1.281081081081081,0.04033634434600251,660,not resting.nesting
1688,3100,9,34,142,185,1.281081081081081,0.04033634434600251,660,Joyce Kilmer ain't got nothin' on me.
1994,3100,7,38,140,185,1.281081081081081,0.03885243701543445,660,I got it for a birdsong.
4127,3100,7,38,140,185,1.281081081081081,0.03885243701543445,660,"Yous did say you wanted an open concept 
with a great view of the park."
4938,3100,13,26,146,185,1.281081081081081,0.043151341827587036,660,The imprinting study exceeded our expectations.
1863,3105,5,33,115,153,1.2810457516339868,0.04194439569918863,660,"I'm taking ""tree hugging"" to the next level: ""tree nesting"" is much more comfortable, and sustainable at that!"
2060,3106,7,36,135,178,1.2808988764044944,0.03981925144316555,660,Is it rent-controlled?
1612,3106,7,36,135,178,1.2808988764044944,0.03981925144316555,660,I consider it more of an Open Air bnb.
820,3106,6,38,134,178,1.2808988764044944,0.03901400791286675,660,The nesting instinct peaks in Spring.
986,3106,5,40,133,178,1.2808988764044944,0.038191790235028486,660,"I tell ya, this nesting thing isn't  just for the birds"
5298,3110,7,27,112,146,1.2808219178082192,0.045322703395465715,660,One lay over the cuckoo's nest
2402,3111,9,30,132,171,1.280701754385965,0.04250753824948501,660,Yes! My aerie is airy.
3052,3111,7,34,130,171,1.280701754385965,0.04085696891379272,660,It’s called pigeon paleo.
3730,3111,6,36,129,171,1.280701754385965,0.04000615526663642,660,"Yes it’s a climb up, but it’s also rent controlled."
5315,3111,9,30,132,171,1.280701754385965,0.04250753824948501,660,You can think of it as a skyscraper for us environmentalists.
5630,3111,7,34,130,171,1.280701754385965,0.04085696891379272,660,I think 'a bird's eye view' is hyperbole.
3307,3116,6,34,124,164,1.2804878048780488,0.04107341384083192,660,"When my kids grew up and moved out, I promised myself  ""No more empty nest."""
3085,3116,8,30,126,164,1.2804878048780488,0.042856256517744475,660,I don’t miss the vacuuming one bit.
1212,3116,8,30,126,164,1.2804878048780488,0.042856256517744475,660,Got tired of them pooping on me...
283,3116,6,34,124,164,1.2804878048780488,0.04107341384083192,660,I'm just keeping the eggs warm 'til she gets back.
2369,3116,3,40,121,164,1.2804878048780488,0.038243629891506564,660,"Believe it or not, it's still cheaper than my old place!"
1048,3121,10,33,146,189,1.2804232804232805,0.04045000657759937,660,I get all squirrelly when it snows.
4238,3121,6,41,142,189,1.2804232804232805,0.03756399700256161,660,The realtor said she will throw in the nest.
5302,3121,10,33,146,189,1.2804232804232805,0.04045000657759937,660,Early bid gets the nest.
852,3124,6,32,119,157,1.2802547770700636,0.04222536894060715,660,"Mr. Bezos, this is my Plan B as my old neighborhood is being gentrified."
3826,3125,7,37,138,182,1.2802197802197801,0.03923436676499211,660,"Hey John, the doctor said it’s gonna be three girls and a boy!"
2442,3125,8,35,139,182,1.2802197802197801,0.04000060378725558,660,"Yes, the building super is a bit hawkish,  but a penthouse with a  Park view ?"
5101,3125,11,29,142,182,1.2802197802197801,0.04221595204457991,660,I'm filing late and I need some dependents.  It's worth a shot.
762,3125,10,31,141,182,1.2802197802197801,0.04149064761045774,660,"Thanks, but I already ordered in."
2401,3125,9,33,140,182,1.2802197802197801,0.04075243638409971,660,Sure buddy!  I'm always willing to go out on a limb for you.
4814,3130,7,35,133,175,1.28,0.040229228237659495,660,The downside is they missed me when counting the city's homeless.
4331,3130,10,29,136,175,1.28,0.042607923436528444,660,You must be the one who's been pooping on everyone's windshields.
4067,3130,4,41,130,175,1.28,0.03770074892654429,660,She’ll be home soon. She flew to the grocery for a few things.
1403,3130,9,24,117,150,1.28,0.0464584681381658,660,I saw it on HGTV!
2056,3130,11,27,137,175,1.28,0.04337184091740699,660,Jacque I’m pregnant.
2459,3130,12,25,138,175,1.28,0.044122534260360086,660,"Them ain’t eggs, mister."
1088,3136,9,36,148,193,1.2797927461139897,0.039182599643145535,660,And it is only costing me $500 a month!
3937,3136,8,38,147,193,1.2797927461139897,0.03848770905947114,660,It beats being homeless.
2539,3138,10,27,131,168,1.2797619047619047,0.043811162582012286,660,I'm working on the nest egg I've never had.
4765,3138,8,31,129,168,1.2797619047619047,0.04215265078174906,660,"When I turned 30, my parents told me to find another nest."
4447,3140,10,32,144,186,1.2795698924731183,0.0408648034255157,660,I think I'm ovulating.   Give me a call.
3619,3140,14,24,148,186,1.2795698924731183,0.04361677101846536,660,Banks are closed so I'm going out on a limb and starting my own branch
3339,3140,10,32,144,186,1.2795698924731183,0.0408648034255157,660,"This one is $2,500 a month but at least it’s furnished."
1562,3140,10,32,144,186,1.2795698924731183,0.0408648034255157,660,"Throw some breadcrumbs, I dare you."
1772,3140,11,30,145,186,1.2795698924731183,0.04156987849120851,660,Just wait till you hear my tweets.
2953,3145,5,35,121,161,1.279503105590062,0.04058116256326702,660,The bird wouldn’t stop building nests in my rafters so I am fighting fire with fire.
3755,3145,7,31,123,161,1.279503105590062,0.04245126921650158,660,The critical step in the retirement plan was to  figure out the exact moment the shrub was strong enough to hold me.
4929,3145,11,23,127,161,1.279503105590062,0.04596378209311191,660,"It's called a 'gravity weighted composting Nester.' Kind of a cure-all for everything from restless leg syndrome to Trump anxiety disorder.
Comes with a lifetime guarantee"
1143,3148,9,39,156,204,1.2794117647058822,0.03776881481134359,660,Guess whose egg I'm sitting on?
1565,3149,8,34,137,179,1.2793296089385475,0.04041151058135504,660,... and the rent's only 40 acorns a month.
1043,3150,8,27,119,154,1.2792207792207793,0.04465939650873419,660,"Great view, and the rent is only $5,000 a month!"
2816,3150,9,25,120,154,1.2792207792207793,0.04559982603418519,660,"My neighbors certainly squak a lot, but otherwise, the living is easy!"
1647,3152,5,45,147,197,1.2791878172588833,0.03585710026127952,660,Can't imagine giving birth in one of these things!
1238,3152,10,35,152,197,1.2791878172588833,0.039302906796009424,660,"Finally, I’m an empty nester!"
483,3152,8,39,150,197,1.2791878172588833,0.037962135677915475,660,"It's only a one bathroom, but it's dirt cheep."
2745,3155,10,28,134,172,1.2790697674418605,0.04308762336435586,660,Can't complain. Rent's cheap and every couple days the landlord regurgitates worms into my mouth.
3613,3155,6,36,130,172,1.2790697674418605,0.03980634953334929,660,"It's not only affordable, it's also quite comfortable once you found the right position!"
4260,3155,7,34,131,172,1.2790697674418605,0.04065150574302912,660,Hatching them here is a lot cheaper than in the hospital.
4649,3155,3,42,127,172,1.2790697674418605,0.03715571416563167,660,Spring is here and I’m the first Robin.
5465,3155,9,30,133,172,1.2790697674418605,0.04229117911792285,660,"I promised my wife I wouldn't brag, but c'mon, not every day you find something for 5.2 this close to Central Park"
488,3160,4,45,141,190,1.2789473684210526,0.03587463453936351,660,Want to come up and flock together?
1925,3160,8,37,145,190,1.2789473684210526,0.038855740547317906,660,It was more affordable than a sixth-floor walkup.
3415,3160,11,31,148,190,1.2789473684210526,0.04094939500274916,660,"It's a great life! Well, except for the regurgitated worms …"
4031,3163,8,30,127,165,1.2787878787878788,0.04262963689095248,660,No one is going to accuse me of being an empty nester
4267,3163,7,32,126,165,1.2787878787878788,0.04175375565679171,660,"Sorry, I’m just the nest sitter. The Featherstones are still in Florida."
949,3163,5,36,124,165,1.2787878787878788,0.03994441702456406,660,"The kids are gone, Phil. Time for this girl to nest."
3124,3163,11,24,130,165,1.2787878787878788,0.04515545849038219,660,Failure to launch
1046,3167,8,35,140,183,1.278688524590164,0.03981088017671821,660,I’m off the grid!
1667,3167,4,43,136,183,1.278688524590164,0.03667027705017482,660,"I'd love to move out to Long Island, but I'm building a nest egg"
2578,3167,7,37,139,183,1.278688524590164,0.039049416641838655,660,"It's not much on amenities, but the view is stunning."
3610,3167,10,31,142,183,1.278688524590164,0.04129170208648746,660,"I may be homeless, but I still have the nesting urge!"
5083,3167,12,27,144,183,1.278688524590164,0.04272122589478738,660,"Finders keepers, losers weepers"
3084,3172,10,24,124,158,1.2784810126582278,0.0456734195462213,660,They will want you to leave that nest as well.
3884,3172,10,24,124,158,1.2784810126582278,0.0456734195462213,660,"I got the better of the deal; for the next 24 hours, the bird has to do everything my wife says."
4355,3172,9,26,123,158,1.2784810126582278,0.04478209014730891,660,My financial adviser said that I needed to work on my next egg.
2938,3175,10,29,137,176,1.2784090909090908,0.042395001905186094,660,And don’t think this means you can worm your way into my good graces.
5031,3175,6,37,133,176,1.2784090909090908,0.039212191048199195,660,"Well, no tax, no rent, no HOA no utilities, but I do have a bird that comes by to see me."
2534,3175,5,39,132,176,1.2784090909090908,0.03837526367160762,660,I just got back from down South.
711,3175,9,31,136,176,1.2784090909090908,0.041622122982924205,660,"Not doing too bad, though the regurgitation thing is a bit hard to get used to."
1775,3175,10,29,137,176,1.2784090909090908,0.042395001905186094,660,"They told me I needed Nest, and I never looked back!"
1244,3175,10,29,137,176,1.2784090909090908,0.042395001905186094,660,"Well, you and mom said I could not move back in with you and I have to nest somewhere."
2044,3175,6,37,133,176,1.2784090909090908,0.039212191048199195,660,"It's only $800 a month, and the sticks are furnished."
3177,3182,8,38,148,194,1.2783505154639174,0.03831595757942172,660,And I still have my nest egg.
1881,3183,9,24,118,151,1.2781456953642385,0.04618700867327866,660,Not an empty nester anymore!
4396,3184,7,33,129,169,1.2781065088757397,0.04108669081830849,660,"It started with a hug...Then one thing led to another, and here I am!"
1581,3184,7,33,129,169,1.2781065088757397,0.04108669081830849,660,Ready for commitment now?
2224,3184,4,39,126,169,1.2781065088757397,0.03842901284179986,660,I really don't understand why they all fly south for the winter
35,3184,5,37,127,169,1.2781065088757397,0.039334862477577115,660,There's a lot of great stuff leftover since they stopped filming Sesame Street up here.
777,3184,2,43,124,169,1.2781065088757397,0.03655002423700765,660,Because it's SO much quieter than my place in Kips Bay.
2010,3189,6,40,141,187,1.2780748663101604,0.037739939058891094,660,"As soon as I hit my ninth month, my nesting instincts​ kicked in."
4356,3190,7,36,137,180,1.2777777777777777,0.03943703430102607,660,Stop taking yourself so seriously and climb on up here.
58,3190,5,30,109,144,1.2777777777777777,0.043457376303801656,660,I fly up here for the winter.
1657,3190,10,35,153,198,1.2777777777777777,0.039129317358701274,660,I'm taking advantage of their 'empty nest syndome'.
1875,3190,6,33,123,162,1.2777777777777777,0.04130565945798412,660,"My stock adviser advised me ""to get ahead in this world, I should feather my own nest""!"
2994,3190,8,34,138,180,1.2777777777777777,0.04021632654645493,660,Did ya hear? The Mueller report is 400pgs! That's enough bedding to last a lifetime!
4959,3190,6,33,123,162,1.2777777777777777,0.04130565945798412,660,"I'm flying south,but I needed a break."
2501,3196,8,37,146,191,1.2774869109947644,0.0386793538514311,660,"Well, climate change and 
scary planes kept us from flying south this year."
2106,3196,6,41,144,191,1.2774869109947644,0.0372272643687419,660,My wife just left to go get some lunch.
5496,3198,7,34,132,173,1.277456647398844,0.04044802232383075,660,Well since money doesn’t grow on trees I thought I’d try a nest egg!
4802,3198,10,28,135,173,1.277456647398844,0.04286819934737377,660,It may look ridiculous but it's easier than childbirth.
3010,3198,5,38,130,173,1.277456647398844,0.0387506882475361,660,I see no reason to leave the nest.
2592,3198,8,32,133,173,1.277456647398844,0.04127052029033314,660,"My parents can not believe that I pay $3000 a month for this apartment, but I love the view!!"
2576,3198,8,32,133,173,1.277456647398844,0.04127052029033314,660,"It feels empty now, but we have space for the grandchicks."
4346,3198,9,30,134,173,1.277456647398844,0.042076943569614084,660,"Mine, right after tonight's condo board vote!"
2485,3198,8,32,133,173,1.277456647398844,0.04127052029033314,660,I 'm not making the mistake of leaving it again!
2285,3198,8,32,133,173,1.277456647398844,0.04127052029033314,660,I'm nesting... remember that chapter in 'What to Expect When You're Expecting'?
1301,3198,8,32,133,173,1.277456647398844,0.04127052029033314,660,I looked it up. Your winter range is southern California.
1,3198,7,34,132,173,1.277456647398844,0.04044802232383075,660,It’s as comfy as my realtor said it was.. not to mention the view.
2553,3198,8,32,133,173,1.277456647398844,0.04127052029033314,660,Once you're up you don't want to come back down.
1463,3209,5,33,117,155,1.2774193548387096,0.0414802398138193,660,What housing affordability crisis?
3315,3210,9,38,155,202,1.2772277227722773,0.037950047253155504,660,You ever have an itch you can't scratch?
392,3211,8,35,141,184,1.2771739130434783,0.03962288464373303,660,It feels great to be an empty nester.
4836,3211,11,29,144,184,1.2771739130434783,0.041811034204122494,660,"If “nest egg” is a metaphor, this has all been a waste of time."
3640,3213,5,36,125,166,1.2771084337349397,0.03973856332851152,660,"Saving for my nest egg, how about you?"
2098,3213,7,32,127,166,1.2771084337349397,0.04153543205107765,660,Just because I'm nesting doesn't mean I'm pregnant.
5547,3215,8,33,136,177,1.2768361581920904,0.04063371444544116,660,Views are  good and I get plenty of light
4359,3215,6,37,134,177,1.2768361581920904,0.03902173854222927,660,I found it on-line under 'Nests for the Weary.'
1411,3215,5,39,133,177,1.2768361581920904,0.03819024408759815,660,I found this cool abandoned house. Much better than the park bench.
2127,3215,7,35,135,177,1.2768361581920904,0.03983588098995524,660,I’m hatching our nest egg.
310,3219,5,34,120,159,1.2767295597484276,0.0408023479306168,660,It helps with my empty nest syndrome.
1025,3220,5,47,154,206,1.2766990291262137,0.03482922558379516,660,"I got this at least $200 under the going studio rate."""
379,3221,6,40,142,188,1.2765957446808511,0.037567787283613596,660,My interior designer is really into twine and shiny objects.
474,3221,7,38,143,188,1.2765957446808511,0.03831746253109429,660,My mom let me stay in the nest a little too long.
3564,3223,8,31,131,170,1.276470588235294,0.041719849626640736,660,Trying to catch myself one of those cute bird watchers!
5715,3223,8,31,131,170,1.276470588235294,0.041719849626640736,660,"When I agreed to work outside, and wasn't afraid of heights, the city hired me on the spot."
5393,3223,6,35,129,170,1.276470588235294,0.04001647865968418,660,I've moved back home -- just until I land on my feet.
3733,3223,6,35,129,170,1.276470588235294,0.04001647865968418,660,"We’re expecting and, I dunno, I just have this instinct!"
3647,3223,8,31,131,170,1.276470588235294,0.041719849626640736,660,I am the emcee for tonight's Celebrity Roost.
3464,3223,9,29,132,170,1.276470588235294,0.04254596922322716,660,Me?...just nesting while homesteading.
2662,3223,5,37,128,170,1.276470588235294,0.03913700192971713,660,"I know it doesn’t have a bathroom, but my realtor got me a great deal."
666,3223,6,35,129,170,1.276470588235294,0.04001647865968418,660,"Great view, close to the park, and the rent is reasonable... Whad da ya say?"
590,3223,11,25,134,170,1.276470588235294,0.044151860500916025,660,Watch out below. I don’t soil my own nest.
2166,3232,10,22,120,152,1.2763157894736843,0.04685784627092812,660,"Thanks but, no, I’m not expecting."
1045,3233,5,40,136,181,1.276243093922652,0.03765202265241412,660,It was the least expensive Airbnb in the city.
1551,3233,7,36,138,181,1.276243093922652,0.03924856071536858,660,I can't sleep on that new bed you bought me.
4360,3233,13,24,144,181,1.276243093922652,0.04368951411332216,660,"He was a big bird, but I thought if you the whole time."
3387,3236,6,33,124,163,1.2760736196319018,0.041086825264947884,660,I have ordered takeout if you want to join me.
5028,3236,7,31,125,163,1.2760736196319018,0.04199842345125934,660,Tweet me if you like what you see
2778,3238,7,39,146,192,1.2760416666666667,0.0377896722363948,660,It's called 'reverse empty nesting'.
444,3238,8,37,147,192,1.2760416666666667,0.038504504276112385,660,I'm an exotic escapee
4532,3238,7,39,146,192,1.2760416666666667,0.0377896722363948,660,And how much do you pay in rent?
5134,3241,6,36,132,174,1.2758620689655173,0.039412426161213016,660,"Yeah I know, but it's rent controlled."
5330,3241,9,30,135,174,1.2758620689655173,0.04186480192332103,660,"Can you believe it’s only $3,000 a month plus utilities?"
5093,3241,11,26,137,174,1.2758620689655173,0.043422841641116275,660,That’s when I decided to stop working corporate and started working on my personal nest egg for retirement.
4475,3241,8,32,134,174,1.2758620689655173,0.041063619811502555,660,The Airbnb rate is fantastic!
4337,3241,10,28,136,174,1.2758620689655173,0.04265093677909294,660,Last trimester: I’m nesting.
4120,3241,6,36,132,174,1.2758620689655173,0.039412426161213016,660,"...a coffee and a bagel,  make that a sesame seed."
3385,3241,7,34,133,174,1.2758620689655173,0.04024649182187619,660,"My accountant won't stop talking about 'fostering a nest egg', so here I am."
1167,3241,10,28,136,174,1.2758620689655173,0.04265093677909294,660,I'm investing in my nest egg!
1717,3249,10,31,144,185,1.2756756756756757,0.04089931337951772,660,"It’s a great location, I only wish utilities were included..."
2309,3249,11,29,145,185,1.2756756756756757,0.04161139557256511,660,'Depends.'
3681,3249,7,37,141,185,1.2756756756756757,0.03868450096840487,660,"I was hesitant at first too, but they say earthworms have a lot of protein."
4022,3249,10,31,144,185,1.2756756756756757,0.04089931337951772,660,"Close to the L train, $2,200 a month!!!"
4302,3249,5,41,139,185,1.2756756756756757,0.037134644228988246,660,You have to find your own materials. After that you just chill.
5023,3249,7,37,141,185,1.2756756756756757,0.03868450096840487,660,...And it's $200 a month cheaper than my last place!
1814,3255,8,38,150,196,1.2755102040816326,0.037976847507581825,660,"Not to brag, but I've been hit on by several pigeons. Must be the sweet pad."
2306,3256,5,36,126,167,1.2754491017964071,0.03953472879564609,660,"Can't beat the rent, but the super is a little flighty.."
3691,3256,8,30,129,167,1.2754491017964071,0.04218328320109104,660,"yes, but where do you find a place for a $600 a month at such a location?"
4465,3256,5,36,126,167,1.2754491017964071,0.03953472879564609,660,I couldn't afford to go to Florida this year.
5174,3256,9,28,130,167,1.2754491017964071,0.04302992271101786,660,It's all in the positioning.
511,3260,4,41,133,178,1.2752808988764044,0.0371624275519406,660,"...and with the real estate prices in the city, this studio apartment is SUCH a steal."
2482,3260,8,33,137,178,1.2752808988764044,0.04043471169463785,660,Nothing in The Park’s rules and regs handbook about nesting.
2768,3260,10,29,139,178,1.2752808988764044,0.04197530052264197,660,I've always wanted to be and empty-nester
927,3263,5,31,113,149,1.2751677852348993,0.04243950934928181,660,At least it's not empty.
4111,3264,10,32,147,189,1.2751322751322751,0.04029509579822173,660,"Sticks and stones may make my homes, but birds will never hurt me."
3974,3264,8,36,145,189,1.2751322751322751,0.0388731290833164,660,"Anyway Frank, I decided to turn on, tune in, and drop out. Now I'm the Birdman of Central Park West!"
2438,3264,9,34,146,189,1.2751322751322751,0.03959049702969164,660,"I go,t good deal from an empty nester couple."
195,3264,8,36,145,189,1.2751322751322751,0.0388731290833164,660,The nesting syndrome kicked in early during this pregnancy!
989,3268,6,32,122,160,1.275,0.04154069006188522,660,It's spring and the urge to nest was irresistible.
1872,3268,10,24,126,160,1.275,0.04516740350764742,660,"Park view and air conditioning, only three grand a month."
2793,3268,6,32,122,160,1.275,0.04154069006188522,660,"I'll come down again after the egg is hatched and I get the little one to fly the coup."""
3234,3268,4,36,120,160,1.275,0.03960298254443841,660,Just keeping it warm for a friend. I can meet you at 6.
5700,3268,12,20,128,160,1.275,0.04687565513169022,660,Come on up.   I'm an empty nester.
728,3273,3,41,127,171,1.2748538011695907,0.03713226822894415,660,My tiniest house concept
3176,3273,5,37,129,171,1.2748538011695907,0.03894103546434098,660,"And then I thought, ""Just because the kids are gone, I don't have to be an empty nester."""
4135,3273,7,33,131,171,1.2748538011695907,0.04066943744685766,660,Im just hoping Mom comes back with a worm soon
1813,3276,10,30,142,182,1.2747252747252746,0.04132751601954009,660,Did you clean my mess off your car yet?
46,3276,7,36,139,182,1.2747252747252746,0.039061813535217205,660,You’ve heard the expression “Free as a bird?” It occurred to me last night that free is even better than rent control or stabilization.
80,3276,12,26,144,182,1.2747252747252746,0.04277135859585851,660,"You, Sir, look like a man who wants to expand his horizon."
3493,3279,5,46,153,204,1.2745098039215685,0.03496470981703406,660,"Sure, there's no kitchen, but I'm only paying $2000/month for this!"
3520,3279,9,24,120,153,1.2745098039215685,0.045653243262321286,660,I read that nesting is the new Marie Kondo-ing.
5088,3281,13,19,132,164,1.274390243902439,0.04684112445928405,660,Walk under me and find out...
339,3281,8,29,127,164,1.274390243902439,0.04266154527409851,660,"It's not rent controlled, but who cares?"
719,3281,7,31,126,164,1.274390243902439,0.041775480201748975,660,"I always thought, “it’s for the birds” was a bad thing"
4882,3281,7,31,126,164,1.274390243902439,0.041775480201748975,660,No more empty nest syndrome!
4498,3285,9,30,136,175,1.2742857142857142,0.0416547250070347,660,"Oh... well, my advisor said I was getting too old not to have a nest egg, so..."
5538,3285,4,40,131,175,1.2742857142857142,0.03750611804029755,660,It's not cultural appropriation if you do it this way
1818,3285,5,38,132,175,1.2742857142857142,0.03837173875972424,660,Finally!  An affordable nest egg not for the birds.
3796,3285,3,42,130,175,1.2742857142857142,0.03662004158191172,660,It's part  of my spring ritual.
4668,3289,6,39,141,186,1.2741935483870968,0.03774219628968227,660,"With the TZ going down, the peregrines have been scrambling. I’m just keeping the eggs warm a few hours each day."
156,3290,7,40,150,197,1.2741116751269035,0.03711815487184838,660,I'm nesting.
2244,3290,9,36,152,197,1.2741116751269035,0.03848833795421494,660,So they're free range and local?
4512,3292,7,26,113,146,1.273972602739726,0.04509010340583965,660,"Honey, you just have to accept that we are now empty nesters!"
214,3293,7,29,121,157,1.2738853503184713,0.042970184931970835,660,My utility bill savings make it all worth it.
3356,3293,4,35,118,157,1.2738853503184713,0.04001823135901251,660,My girlfriend said that she is ready to nest.
2842,3295,9,28,131,168,1.2738095238095237,0.04280443801656167,660,Waiting for mom to come back. It’s feeding time again.
1214,3295,8,30,130,168,1.2738095238095237,0.041963483107148744,660,It started with the empty nest syndrome and kind of grew from there.
1205,3297,9,31,139,179,1.2737430167597765,0.04101016842616222,660,Eggs for breakfast and squab for lunch.
5364,3297,10,29,140,179,1.2737430167597765,0.041768464335908605,660,"It's air conditioned, has a great view of Central Park, and it's only $6,000 a month!"
418,3299,10,38,164,212,1.2735849056603774,0.037269088604192514,660,'I wanted to go back to my roots.'
526,3300,6,29,115,150,1.2733333333333334,0.04324289305942818,660,"When the kids moved back home, I set up this place to get some peace and quiet."
3183,3301,8,28,125,161,1.2732919254658386,0.043155411807833464,660,"Yeah the chicks have been a little slow to warm up, but it's a pretty sweet deal."
4253,3301,5,34,122,161,1.2732919254658386,0.04036669807706975,660,They should hatch in two days. That's when I'll need the raw fish.
3757,3303,8,31,133,172,1.2732558139534884,0.041295563523383386,660,"''Getting used to the rustic plumbing may take some time, but Manhattan at $4,000 a month . . ."""
4895,3303,8,31,133,172,1.2732558139534884,0.041295563523383386,660,So your son finally moved out?
3251,3303,4,39,129,172,1.2732558139534884,0.037859288724121386,660,"Fly south, they said. Go to Florida, they said. I told em ta hell with ya, I’m a New York bird through and through."
5284,3303,11,25,136,172,1.2732558139534884,0.04369578852391668,660,".... And if I need worms, I can get them online!"
1406,3303,9,29,134,172,1.2732558139534884,0.04211084210412022,660,"So...this is your new apartment?""
""I know it's small, but hey its New York!"
170,3303,2,43,127,172,1.2732558139534884,0.0360184234897598,660,Can you believe I got this place with no broker's fee?
2871,3303,7,33,132,172,1.2732558139534884,0.040463861786901166,660,This time of year it is the lowest maintenance sitting job you can get.
4023,3310,5,40,138,183,1.273224043715847,0.03730019844941591,660,"Hey, Dad, where's my nest egg?"
4593,3310,11,28,144,183,1.273224043715847,0.04185212356175567,660,Your turn starts next week.
529,3312,7,39,148,194,1.2731958762886597,0.03745289531487577,660,"Once you get used to the bread crumbs, it's not so bad."
2025,3312,8,37,149,194,1.2731958762886597,0.03815934115612735,660,I'm in my nesting stage.  You ready to be a daddy!
5184,3314,9,27,129,165,1.2727272727272727,0.04329690580175037,660,It’s 8:30 already? Well I’m no early bird.
4896,3314,10,25,130,165,1.2727272727272727,0.04414217803884439,660,I think I’m pregnant silly boy. What else.
4565,3314,9,33,145,187,1.2727272727272727,0.0397981325499368,660,I am just following my nesting instinct.
4403,3314,9,27,129,165,1.2727272727272727,0.04329690580175037,660,Divorcing you makes me free as a bird.
4137,3314,10,28,138,176,1.2727272727272727,0.04222277456365938,660,My nest egg hatched during the great Recession.
3789,3314,8,29,128,165,1.2727272727272727,0.042434799657807436,660,I can't help it- it's my nesting instinct.
3303,3314,5,35,125,165,1.2727272727272727,0.0397364156911023,660,"‘When the news put up the “falcon cam”, I demanded equal time for bird hunters. I go on in 5 minutes.’"
2655,3314,10,28,138,176,1.2727272727272727,0.04222277456365938,660,The space is great! Breakfast was a little gamey...
2181,3314,4,34,116,154,1.2727272727272727,0.040446459355779806,660,"It's a tad rustic – but it's low rent, has views of the park, and will be a great place to raise kids."
2178,3314,7,28,119,154,1.2727272727272727,0.04348060933208722,660,"When we discussed your desire to start nesting, this wasn’t what I thought you had in mind."
1913,3314,8,35,144,187,1.2727272727272727,0.03906904590842639,660,It was this or paint the study pink.
1825,3314,8,32,136,176,1.2727272727272727,0.04065578140908709,660,"Ah, affordable housing!"
1472,3314,10,31,146,187,1.2727272727272727,0.04051410076417775,660,Kylie Jenner said this was the next big thing in childbirth.
3165,3314,8,29,128,165,1.2727272727272727,0.042434799657807436,660,"Trust me, I work at the diner, I know how to keep eggs warm."
3143,3328,6,40,145,191,1.2722513089005236,0.03706024674225279,660,"At least it's a job.......just keepin' the eggs  warm 'till they fly  back""."
4928,3329,7,35,138,180,1.2722222222222221,0.03925956181637003,660,"And when I'm done brooding, I'll make soup."
5435,3329,4,41,135,180,1.2722222222222221,0.03681159402580952,660,I have to spend Earth Day in style.
5046,3329,6,37,137,180,1.2722222222222221,0.03846088854385181,660,It's really comfy for hatching a plot!
4789,3329,7,35,138,180,1.2722222222222221,0.03925956181637003,660,"My only problem is, no bathroom."
3245,3329,8,33,139,180,1.2722222222222221,0.040042308130827924,660,I've also got a small nest egg.
1546,3329,7,35,138,180,1.2722222222222221,0.03925956181637003,660,"I know the kids are all grown up Frank, but I refuse to become an empty nester."
3130,3329,9,31,140,180,1.2722222222222221,0.04081004394600619,660,No more empty nest. I just became the mother of three.
3900,3329,4,41,135,180,1.2722222222222221,0.03681159402580952,660,"Sorry, the Airbnb listing specifically said no guests allowed."
1213,3329,8,33,139,180,1.2722222222222221,0.040042308130827924,660,I  majored in minimalism.
1194,3338,7,32,130,169,1.272189349112426,0.040893484172776336,660,I like being an empty nester.
3097,3338,8,30,131,169,1.272189349112426,0.041745891126238936,660,I refuse to be an empty-nester!
3633,3338,9,28,132,169,1.272189349112426,0.042581237699936346,660,I like nesting in public.
4946,3338,5,36,128,169,1.272189349112426,0.03913300769835788,660,I guess Mark and Jeannie really weren't kidding when they said Tim had 'flown the coop'.
1668,3342,8,27,123,158,1.2721518987341771,0.04366571521150535,660,"Don't you think this is rather extreme way of telling me ""I'm expecting?"""
229,3343,8,24,115,147,1.272108843537415,0.0458488551881332,660,And I've been getting all the free worms I can eat!
1635,3344,10,33,152,195,1.2717948717948717,0.03935606177029055,660,"I Air BnB'd it from the Grey Squirrels, they're on Spring Break right now."
54,3345,9,32,143,184,1.2717391304347827,0.04019916688788548,660,"I realize I may seem imprudent, 
but I am sitting on a nest egg."
667,3345,7,36,141,184,1.2717391304347827,0.03869340972303834,660,Rent is so cheap when everyone migrates south for the winter!
1645,3345,10,30,144,184,1.2717391304347827,0.04093127837879785,660,I know it's strange but I don't think I could ever see myself as an empty nester.
1721,3345,7,36,141,184,1.2717391304347827,0.03869340972303834,660,The whole weekend stay was super cheap and the host keeps bringing home these delicious noodles from nearby spot!
3295,3345,12,26,146,184,1.2717391304347827,0.0423575567308573,660,I could go for some slices of bread if you have any.
889,3350,11,25,137,173,1.2716763005780347,0.0434711825383148,660,Beats an epidural
3692,3350,6,35,132,173,1.2716763005780347,0.039416710106895535,660,I don't like empty nest syndrome!
5690,3350,8,31,134,173,1.2716763005780347,0.04108653923004977,660,I didn’t run away; I flew.
5241,3353,5,34,123,162,1.271604938271605,0.04015220195688405,660,"Can you imagine--great location, cozy, and cheap--I only have to babysit the squirrel babies."
4861,3353,7,30,125,162,1.271604938271605,0.04201858867441236,660,"It's just until Springtime - then, it's off to my pond . . ."
4077,3353,2,40,120,162,1.271604938271605,0.037177353505619855,660,I’m nesting. I read about it in Gwyneth’s newsletter.
2055,3353,5,34,123,162,1.271604938271605,0.04015220195688405,660,"Sure it’s a bit spartan, but it is rent controlled."
2651,3357,8,25,118,151,1.271523178807947,0.04500063755686408,660,The bench was too toxically anthropomorphic.
2931,3357,6,29,116,151,1.271523178807947,0.04299368487374794,660,"Very affordable, but, the best locations are going fast.  Don't wait!"
2199,3359,7,40,152,199,1.271356783919598,0.03679550632247332,660,I’ve decided to fly south.
1640,3360,6,39,143,188,1.2712765957446808,0.03739623015544535,660,Welcome to a Trump Parkview Tree Nest for the 99 percenters.
2045,3360,7,37,144,188,1.2712765957446808,0.03814927683815272,660,All good up here. How you doin?
4849,3360,7,37,144,188,1.2712765957446808,0.03814927683815272,660,Millennial Nest Egg.
4835,3363,6,36,135,177,1.271186440677966,0.038835387245388465,660,The rent is really cheep.
4319,3363,6,36,135,177,1.271186440677966,0.038835387245388465,660,Hmm..... living the American Dream.
3799,3363,12,24,141,177,1.271186440677966,0.04351316254681952,660,I NEITHER REAP NOR DO I SEW
2541,3363,8,32,137,177,1.271186440677966,0.040454789250159655,660,I'm holding down the fort while they're out shopping behind Ikea.
2213,3363,5,38,134,177,1.271186440677966,0.03799981535628173,660,I sublet from a couple of snowbirds.
23,3363,5,38,134,177,1.271186440677966,0.03799981535628173,660,My parents bet me I would never leave their basement and get a job. Do you know anyone who’s hiring?
462,3369,9,27,130,166,1.2710843373493976,0.043066639999029745,660,"I see the world as it is. You laugh because you are a prisoner, but I am truly free."
1144,3369,4,37,125,166,1.2710843373493976,0.0385958382493127,660,What? It's only $4K/mo with a view of the park ...
1447,3369,6,33,127,166,1.2710843373493976,0.0404435091259732,660,I kept getting towed.
3865,3369,5,35,126,166,1.2710843373493976,0.03953047027667257,660,Can you believe this house rental was vacant?! And check out this view!
4372,3369,3,39,124,166,1.2710843373493976,0.0376380044640962,660,"Studio apartment, 360 degree views, modular design,
huge skylight, what's not to like?...cheap!"
4770,3369,10,25,131,166,1.2710843373493976,0.043906204925201774,660,"Hi, my name is Robin. A buck to see my red breast."
1959,3375,5,32,118,155,1.270967741935484,0.04125155280809132,660,At least it’s rent controlled.
346,3376,5,29,110,144,1.2708333333333333,0.04320443218435998,660,I'm waiting for my sap to flow.
3096,3376,9,34,149,192,1.2708333333333333,0.03904840859853258,660,"Don't worry, I just order in."
1693,3378,8,33,140,181,1.270718232044199,0.03984885757029031,660,"Oh, my financial advisor recommended that I consider our future savings and building up a nest egg for retirement"
1899,3378,7,35,139,181,1.270718232044199,0.03907101349405016,660,I decided to see it from their point of view!
1956,3378,11,27,143,181,1.270718232044199,0.04209624107057998,660,First he brought me lovely worms.
3128,3378,7,35,139,181,1.270718232044199,0.03907101349405016,660,"I want to help, so I’m filling someone’s empty nest"
5545,3378,5,39,137,181,1.270718232044199,0.03746691056175011,660,"I got to where I am by feathering my own nest, that's how!"
5347,3383,6,34,130,170,1.2705882352941176,0.03981900452488688,660,Do you think this one comes in the birch veneer?
2527,3383,7,32,131,170,1.2705882352941176,0.04068374080179009,660,Well look who’s a bird brain now John
918,3383,5,36,129,170,1.2705882352941176,0.03893506744669494,660,"The rent is better than Trump Tower, and the view is better too!"
660,3383,5,36,129,170,1.2705882352941176,0.03893506744669494,660,"The birds migrated, so I'm keeping the nest warm."
176,3383,7,32,131,170,1.2705882352941176,0.04068374080179009,660,"Sooo, this is the little nest egg you keep talking about?"
860,3383,9,28,133,170,1.2705882352941176,0.04236028864603965,660,I just kicked the crow out and took over.
4239,3389,6,31,122,159,1.270440251572327,0.0415501846950937,660,"Yea,but it's rent stabilized!"
5153,3389,9,25,125,159,1.270440251572327,0.04433116664262766,660,"But Dear, I thought you didn't subscribe to traditional gender roles"
5261,3389,8,27,124,159,1.270440251572327,0.04342396619375543,660,Wanna learn how to build equity without owning a home?
2671,3392,10,33,153,196,1.2704081632653061,0.039179298879298975,660,"No, I'm not a ""tree"" hugger, I'm a ""tree"" potato."
1006,3393,8,34,143,185,1.2702702702702702,0.03926711325657011,660,You can go flock yourself.
1436,3393,7,36,142,185,1.2702702702702702,0.0385117096079077,660,Tell mom to stop freaking out -- it's not empty after all.
1611,3393,11,28,146,185,1.2702702702702702,0.04145080702767782,660,All my friends say I'm a bird brain.
3033,3396,6,35,133,174,1.2701149425287357,0.03922061343066335,660,You thought Barefoot in the Park was a stretch . . .
1992,3396,7,33,134,174,1.2701149425287357,0.040058673042586035,660,This was all that’s affordable!
1156,3396,4,39,131,174,1.2701149425287357,0.03748833127477099,660,This is my winter home.
1477,3396,7,33,134,174,1.2701149425287357,0.040058673042586035,660,These Millenials just won't leave the nest.
1896,3396,11,25,138,174,1.2701149425287357,0.043248819153289306,660,I’m method tweeting.
2387,3401,6,42,152,200,1.27,0.03594384229593402,660,Nice view and Uber-Eats delivers!
1680,3402,2,40,121,163,1.2699386503067485,0.03698612124403692,660,Waiting for spring and you?
3652,3402,6,32,125,163,1.2699386503067485,0.04087706707720505,660,Guess you heard I was up a tree ha ha
4064,3402,6,32,125,163,1.2699386503067485,0.04087706707720505,660,"You must be the dude who likes flying, hip-hop,  and watching the sun rise."
4183,3402,4,36,123,163,1.2699386503067485,0.03898017302112011,660,Well I'm finally feathering my own nest
1148,3406,8,35,146,189,1.2698412698412698,0.03870806197211717,660,I’m in town for the artisanal glamping convention
5395,3407,6,29,117,152,1.269736842105263,0.04274723541948937,660,Flying south for the winter is for the birds.
440,3408,9,30,139,178,1.2696629213483146,0.041036598361783805,660,"Rent is only $950 a month."""
2684,3408,7,34,137,178,1.2696629213483146,0.03945937735150838,660,"I staged a sit-in to save the birds, and they were so grateful they let me take their nest!"""
2929,3408,7,34,137,178,1.2696629213483146,0.03945937735150838,660,"No, ""hygge"" is so last year."
5388,3408,4,40,134,178,1.2696629213483146,0.03696758775958064,660,"So maybe it's a little on the smaller side, but for just 2700 a month you've got the best view in Manhattan!"
5596,3408,8,32,138,178,1.2696629213483146,0.0402557130484301,660,I just needed a little lift.
79,3413,8,29,130,167,1.2694610778443114,0.04198825055139145,660,We should never have left these things.
1827,3413,8,29,130,167,1.2694610778443114,0.04198825055139145,660,Welcome to the new Twitter office.
814,3415,8,36,149,193,1.2694300518134716,0.038170331888062306,660,...and the landlord says heat and cooling are included!
4324,3416,7,28,121,156,1.2692307692307692,0.04299205867207354,660,I got a great deal on a time share with a family of robins
4768,3416,7,28,121,156,1.2692307692307692,0.04299205867207354,660,It's the newest trend in urban housing.
3732,3416,10,29,143,182,1.2692307692307692,0.04115968579713304,660,What happens when nature calls?
3724,3416,8,33,141,182,1.2692307692307692,0.039657208665367996,660,I found that all my problems go away when you pretend to be a bird!
3946,3416,4,34,118,156,1.2692307692307692,0.04000222682609853,660,"Now that you mention it, I would like a can of worms."
2307,3416,7,35,140,182,1.2692307692307692,0.038884205421140475,660,It may not be much to look at but you can't beat the location for this price.
97,3416,7,35,140,182,1.2692307692307692,0.038884205421140475,660,I thought it was a two-bedroom.
3311,3416,6,30,120,156,1.2692307692307692,0.04201909236197543,660,I'm practicing my nesting instinct.
1081,3416,7,28,121,156,1.2692307692307692,0.04299205867207354,660,It’s my nest egg
1159,3425,7,32,132,171,1.2690058479532165,0.040476067493057086,660,And you said ‘it’s for the birds’!
1549,3425,4,38,129,171,1.2690058479532165,0.037840635445104555,660,We’re doing the gender reveal party by the fountain.
2454,3425,8,30,133,171,1.2690058479532165,0.041317205729658385,660,Let them call us 'empty nesters' now...
4019,3425,7,32,132,171,1.2690058479532165,0.040476067493057086,660,It has Central heating and air
4361,3429,6,38,142,186,1.2688172043010753,0.03756584446405763,660,I prefer the empty nest.
4215,3430,5,33,122,160,1.26875,0.040361841177905165,660,I couldn’t find anything rent controlled.
4875,3430,7,29,124,160,1.26875,0.042264771709698806,660,"I know what you’re thinking, the answer is yes"
634,3432,7,40,154,201,1.2686567164179106,0.03647821448721066,660,It turns out what you said is true … I am for the birds.
1673,3432,7,40,154,201,1.2686567164179106,0.03647821448721066,660,"It used to be a love nest, but she flew away."
4646,3434,5,37,133,175,1.2685714285714285,0.03817561307604783,660,I decided to really embrace that nesting instinct.
4364,3434,7,33,135,175,1.2685714285714285,0.03985900555352195,660,Gentrification truly knows no bounds huh?
1900,3434,6,35,134,175,1.2685714285714285,0.03902638695451968,660,Welcome to my new tiny house.
345,3434,8,31,136,175,1.2685714285714285,0.04067458381726214,660,I no longer trust banks with my nest egg.
4,3434,7,33,135,175,1.2685714285714285,0.03985900555352195,660,"Like they say, the early bird gets the best Shakespeare in the Park seat!"
611,3434,5,37,133,175,1.2685714285714285,0.03817561307604783,660,"It's not the cheapest Airbnb in the park, but it is the cleanest."
4450,3440,7,26,116,149,1.2684563758389262,0.04429227875286486,660,Does our  insurance cover an at-nest birth?
5494,3441,9,33,148,190,1.268421052631579,0.03924607170319419,660,This was no fly by by night decision!
5621,3441,7,37,146,190,1.268421052631579,0.037800324853874794,660,Leaving the nest is for the birds.
3207,3441,1,49,140,190,1.268421052631579,0.03308618750834066,660,And if I stay here another 23 months - BAM! - the rent control terms kick in.
4296,3444,5,34,125,164,1.2682926829268293,0.039729710180000224,660,You told mom to kick me out of the nest so I found a new one also rent free!
4016,3444,4,36,124,164,1.2682926829268293,0.03877670914221032,660,I'm giving Park 'N Fly a try.
3055,3444,5,34,125,164,1.2682926829268293,0.039729710180000224,660,This was the last tree bedroom in the city.
1646,3444,7,30,127,164,1.2682926829268293,0.04157022094193494,660,"And the food is free, too. It's pre-digested, but still . . ."
442,3444,6,32,126,164,1.2682926829268293,0.04066038084024853,660,Carl is going to give me a thousand dollars if I stay here for another hour.
2704,3444,7,30,127,164,1.2682926829268293,0.04157022094193494,660,"Empty nest syndrome, and I've never felt better!"
1218,3450,10,28,141,179,1.2681564245810055,0.04159599700600226,660,"It's a great view -- and the rent's as cheap as
anything in Washington Heights."
1366,3450,7,34,138,179,1.2681564245810055,0.03926722387704179,660,My parents send money for an apartment.
5035,3450,8,32,139,179,1.2681564245810055,0.04005852680326121,660,It's a great view and rent free!
2165,3453,11,30,153,194,1.268041237113402,0.040051598467114,660,Birds hell! it’s my mother’s fur coat and the best view in the park.
1928,3454,6,29,118,153,1.2679738562091503,0.04250350149249065,660,There was no nest egg.
858,3455,8,29,131,168,1.2678571428571428,0.04176837966230732,660,I get the freshest eggs this way.
973,3455,4,37,127,168,1.2678571428571428,0.038202794948744255,660,Hi Bob. I am loving this minimalist lifestyle.
1610,3455,9,27,132,168,1.2678571428571428,0.04261318503754864,660,...and it comes with three regurgitations a day.
3134,3455,10,25,133,168,1.2678571428571428,0.04344156464118289,660,I'm hoping this will help me ovulate.
3968,3459,9,31,143,183,1.2677595628415301,0.04022088975894009,660,The rent is 1300 a month but the bread is free!
5154,3460,3,36,118,157,1.267515923566879,0.03874371038406509,660,"It would be quite comfy, once we got used to it!"
395,3460,8,26,123,157,1.267515923566879,0.04369635775399191,660,"No, I'm just subletting it for half the year."
594,3460,7,28,122,157,1.267515923566879,0.04275175275514142,660,It's my nest egg for retirement.
2153,3463,10,26,136,172,1.2674418604651163,0.042728284830799865,660,You're taking this nesting thing a little too far!
2917,3463,8,30,134,172,1.2674418604651163,0.04110605080244584,660,"Yes, I'm a happy empty nester and 
I'm not coming down!"
738,3463,7,32,133,172,1.2674418604651163,0.04027043526669293,660,It's even rent controlled!
5732,3463,7,32,133,172,1.2674418604651163,0.04027043526669293,660,Are you the new renter? The owners are a nice empty-nester couple.
4382,3467,6,31,124,161,1.2670807453416149,0.041100698161654264,660,"No, Mark, I won’t be home for dinner until May, after my eggs hatch."
2395,3468,10,27,139,176,1.2670454545454546,0.04204545454545454,660,Homelessness has gone to new heights!
5142,3469,7,37,147,191,1.2670157068062826,0.03762814934848055,660,"I'm in the city, I'm back to nature, and no more robocalls."
4973,3470,8,32,140,180,1.2666666666666666,0.03986320494676991,660,Cocooning is so last year.
4523,3470,6,28,116,150,1.2666666666666666,0.043004257285391624,660,I made it myself
4110,3470,7,30,128,165,1.2666666666666666,0.04134949496875358,660,"When are you going to come down"" 
""From the tree or my acid trip?"
3975,3470,5,30,115,150,1.2666666666666666,0.041950931885420414,660,"Thanks anyway, I had worms for breakfast."
3147,3470,4,36,125,165,1.2666666666666666,0.03857526725959011,660,"It's not what you spend on vacation, it's where you go."
2726,3470,5,34,126,165,1.2666666666666666,0.03952165323156656,660,I'm just keeping these eggs warm while the Easter Bunny runs to the store.
2629,3470,11,26,143,180,1.2666666666666666,0.04213424792162008,660,"Hmm, must be spring the millennials are out."
2858,3470,7,30,128,165,1.2666666666666666,0.04134949496875358,660,"I'm never gonna leave the nest, in spite of what my parents said."
1169,3470,6,40,149,195,1.2666666666666666,0.03640366591755838,660,'Eagle's nest rentals' - quite reasonable for the Central Park district
1005,3470,6,32,127,165,1.2666666666666666,0.04044590095625991,660,Treebones Realty Group...you need a referral.
691,3470,9,30,141,180,1.2666666666666666,0.040634324838232136,660,You could say I've uprooted
304,3470,8,24,118,150,1.2666666666666666,0.04503706320236822,660,A she grows in Brooklyn
285,3470,4,36,125,165,1.2666666666666666,0.03857526725959011,660,I adopted.
218,3470,8,32,140,180,1.2666666666666666,0.03986320494676991,660,"Yes, but its only $400 a month!"
2557,3470,5,42,148,195,1.2666666666666666,0.035670138745622984,660,"Yes, it may be a rather small apartment but it has great views of the park."
812,3485,7,35,142,184,1.266304347826087,0.03851571949875561,660,At least I got a view of the park.
4485,3485,12,25,147,184,1.266304347826087,0.04219529955717462,660,"Hi Hon, Guess what! We're going to have babies."
4807,3485,6,37,141,184,1.266304347826087,0.03773677407071579,660,"Don’t judge me, there’s no rent control and I pay no taxes!!"
5372,3485,4,41,139,184,1.266304347826087,0.036128535187287855,660,You really do get a Birdseye view from here
3334,3489,5,35,129,169,1.2662721893491125,0.038924752511789215,660,"Sorry,but there's plenty of available space behind me."
3801,3489,5,35,129,169,1.2662721893491125,0.038924752511789215,660,When did you stop being a tree hugger ?
2780,3489,7,31,131,169,1.2662721893491125,0.04069423932663458,660,"Overheard my son-in-law saying he hoped I croak, so I'm just waiting for him to jog by."
222,3489,7,31,131,169,1.2662721893491125,0.04069423932663458,660,"Sure, I’m cold. But, I don’t have to pay property taxes."
1790,3489,7,31,131,169,1.2662721893491125,0.04069423932663458,660,My doctor says I need a better perspective.
1129,3489,8,29,132,169,1.2662721893491125,0.041550733958717244,660,"Yeah, while you're down there entrapped in the daily grind of “Buy/Sell” and endless investment strategy meetings,

I’m up here having eliminated all that by working directly on my nest egg!"
2571,3489,7,31,131,169,1.2662721893491125,0.04069423932663458,660,I've got this strong nesting instinct.
1455,3496,7,27,120,154,1.2662337662337662,0.043255015112900655,660,I'm what the late bird got.
2737,3496,10,21,123,154,1.2662337662337662,0.046104703077756694,660,This was way easier than building the beaver dam.
2810,3496,5,31,118,154,1.2662337662337662,0.04124598715960179,660,I flew North for the Winter.
5003,3496,5,31,118,154,1.2662337662337662,0.04124598715960179,660,You look like an empty nester.
3763,3500,7,36,145,188,1.2659574468085106,0.037976362504873476,660,Would you throw me a piece of that sandwich?
36,3500,9,32,147,188,1.2659574468085106,0.03944594650875437,660,"Indeed, the housing market is volatile."
964,3502,4,38,131,173,1.2658959537572254,0.03746611415505046,660,Call it basking in the joy of an empty-nester.
3410,3502,7,32,134,173,1.2658959537572254,0.04006681563658808,660,"What differentiates our investment firm you ask? For starters, we are fully committed to securing your retirement nest egg."
3577,3502,10,26,137,173,1.2658959537572254,0.04250870170486751,660,"If Horton could do it, why can't I."
4304,3502,5,36,132,173,1.2658959537572254,0.038352614578473804,660,I'm excited! Tomorrow I am going to be a fledgling!
5050,3502,7,32,134,173,1.2658959537572254,0.04006681563658808,660,"Hi Dad! See, I have finally made it!"
5348,3502,6,34,133,173,1.2658959537572254,0.03921908183691518,660,This place was a steal with great views of the park!
4219,3508,9,24,125,158,1.2658227848101267,0.04436997625775281,660,"No, I didn't lose her. She's just catching lunch."
3528,3508,7,28,123,158,1.2658227848101267,0.0425140386572089,660,"It's a new branch of Air BnB called Tree BnB, you've got to try it!"
4792,3510,5,41,146,192,1.265625,0.03597204358858304,660,Beats the high rents and it's air conditioned!
751,3510,7,37,148,192,1.265625,0.037457482077269094,660,This nest had great reviews.
4633,3510,11,29,152,192,1.265625,0.04026429002017756,660,I would come down and welcome you in but then the egg would get cold.
306,3513,5,37,135,177,1.265536723163842,0.037803630398993635,660,I’ll be redecorating in early May.
1443,3513,5,37,135,177,1.265536723163842,0.037803630398993635,660,Finally got rid of that empty nester feeling.
3373,3513,8,31,138,177,1.265536723163842,0.04027056589504354,660,So I guess now I'm just another of the girls you've squirrelled away.
5021,3513,11,25,141,177,1.265536723163842,0.04259486452226808,660,"My biological imperative to reproduce is getting difficult to resist, dear."
5295,3513,5,37,135,177,1.265536723163842,0.037803630398993635,660,"I can't explain it, but since Jake left for college, I've just been more comfortable up here."
3536,3518,5,33,124,162,1.2654320987654322,0.03993055266148707,660,"It's cozy, has a view of the park, but best all no monthly maintenance fee! You just gather a few twigs."
3140,3518,8,27,127,162,1.2654320987654322,0.0427140813334007,660,[Bird Noises]
2850,3518,1,41,120,162,1.2654320987654322,0.035884872738323706,660,Can I get it in memory foam?
3396,3518,7,29,126,162,1.2654320987654322,0.04180683566182501,660,"Even after DNA testing, I'm still stuck on my family tree."
1413,3518,6,31,125,162,1.2654320987654322,0.040879460269838665,660,Have you seen the prices at the Ritz lately?
298,3518,7,29,126,162,1.2654320987654322,0.04180683566182501,660,"Then I thought, maybe I could be the nest egg."
2818,3518,10,23,129,162,1.2654320987654322,0.044473084178629003,660,They just raised the rent to three small rodents a day.
4690,3525,10,32,154,196,1.2653061224489797,0.03902396372031022,660,Empty nester . They all moved to Prospect.
3716,3526,5,38,138,181,1.2651933701657458,0.03727633039360753,660,"She's a single, homeless mother, so I thought I'd help out."
4826,3526,5,38,138,181,1.2651933701657458,0.03727633039360753,660,I always wanted a birdseye  view of the city.
4881,3526,11,26,144,181,1.2651933701657458,0.04192670906288247,660,"I got here first, but no sign of the worm yet."
2985,3529,6,32,128,166,1.2650602409638554,0.040233595659601044,660,"To think like the pigeon, you must live like the pigeon."
787,3529,8,28,130,166,1.2650602409638554,0.042009295637463806,660,"My wife called me a birdbrain, so I moved out."
2863,3529,4,36,126,166,1.2650602409638554,0.03837581946284275,660,"This isn't bad, I have a great view of the park."
2898,3529,6,32,128,166,1.2650602409638554,0.040233595659601044,660,and that’s not even the best part! It has rent control!!
2982,3529,6,32,128,166,1.2650602409638554,0.040233595659601044,660,"Come on, display a little."
3833,3534,9,35,156,200,1.265,0.03782895915504111,660,Getting the hint?
868,3534,9,35,156,200,1.265,0.03782895915504111,660,"I am not sure why you are so concerned, my OB says “nesting behavior” is quite common."
2555,3536,6,28,117,151,1.2649006622516556,0.04275499971276549,660,It's a life choice.
4604,3537,9,31,145,185,1.2648648648648648,0.0398372207922085,660,"If an elephant can hatch an egg, so can I!"
659,3538,7,31,132,170,1.2647058823529411,0.040484464065047195,660,I knew you were an odd bird.
752,3538,9,27,134,170,1.2647058823529411,0.0421689354760427,660,"Once you get used to the taste of regurgitated worms, it's great."
1679,3538,7,31,132,170,1.2647058823529411,0.040484464065047195,660,"Now that the Trump Tax Cut is in place, we can feather our nest."
1725,3538,5,35,130,170,1.2647058823529411,0.038726793594171235,660,It's a two-story climb up.
1779,3538,4,37,129,170,1.2647058823529411,0.03781733594280888,660,Impossible N'EST pas francais!
3077,3538,7,31,132,170,1.2647058823529411,0.040484464065047195,660,The view is good plus it's only three grand a month
5255,3538,6,33,131,170,1.2647058823529411,0.03961537815495164,660,I’ve joined the one percent of the clutter free.
5412,3545,8,25,122,155,1.264516129032258,0.043972626739534455,660,You're not going to believe how my mom feeds me.
3844,3545,9,23,123,155,1.264516129032258,0.044915243324909135,660,The beauty of it is;  A typo made me endangered.
683,3547,4,47,157,208,1.2644230769230769,0.03354750412072682,660,"I guess it's just that ol' nesting instinct, coming home to roost."
1781,3548,9,28,137,174,1.264367816091954,0.04149836334740514,660,I am NOT resting! ....... I am nesting.
3284,3548,7,32,135,174,1.264367816091954,0.03986518060165665,660,You’ve taken twitter to a new level
3318,3548,9,28,137,174,1.264367816091954,0.04149836334740514,660,‘Birding’ is a hot new approach to homelessness. And FYI - you might not want to sit on that particular bench.
4660,3548,6,34,134,174,1.264367816091954,0.039022965755403864,660,"We’re both nesters by nature, so my wife keeping her place directly across the park at the Dakota just made sense to us."
5012,3548,10,26,138,174,1.264367816091954,0.04229131031983447,660,Thirty-five hundred dollars a month with a view!  I think we should take it.
5143,3548,5,36,133,174,1.264367816091954,0.038162168286041395,660,The empty nest was killing me.
4092,3554,9,33,151,193,1.2642487046632125,0.03870868600384439,660,"Honey, you know I just can't stand an empty nest."
3583,3554,6,39,148,193,1.2642487046632125,0.03655742433075151,660,"Thanks for meeting me here, my mom says my wings still aren't strong enough to leave the nest."
4308,3556,9,24,126,159,1.2641509433962264,0.04412172243135606,660,"After hearing about Boeing 737, I decided not to fly south for the winter."
1240,3556,6,30,123,159,1.2641509433962264,0.04132664881900787,660,WATCH where you walk.
2742,3556,7,28,124,159,1.2641509433962264,0.04227887650481754,660,"I wanted to try out the ""Nesting"" impulse before I actually made any commitments in that direction!!"
923,3559,5,37,136,178,1.2640449438202248,0.03762023937966908,660,Paying New York rent prices is for the birds.
2551,3559,10,27,141,178,1.2640449438202248,0.04162550025318213,660,I've switched to offline dating for spring
4453,3559,6,35,137,178,1.2640449438202248,0.03845467959887868,660,"It's in my budget and, other than the obvious, it's just like home."
5240,3562,7,38,152,197,1.263959390862944,0.03679443868012289,660,I prefer this to online dating.
313,3563,8,22,114,144,1.2638888888888888,0.046210422818557334,660,"It's cheap, it has a great view, and my food is already chewed for me!"
553,3563,8,22,114,144,1.2638888888888888,0.046210422818557334,660,The Uber Eats guy will be here any minute to throw up in my mouth.
661,3565,8,27,128,163,1.2638036809815951,0.04248244431051912,660,The landlady dotes over me
3399,3565,7,29,127,163,1.2638036809815951,0.04158145875937288,660,"The food is atrocious, but man, look at this view!"
5507,3567,5,38,139,182,1.2637362637362637,0.037099574975730645,660,My deed says it’s a condo.
4435,3567,10,28,144,182,1.2637362637362637,0.04098709922469875,660,Sing for me
3626,3567,9,30,143,182,1.2637362637362637,0.040239651277815675,660,'Free Bread' and 'Three Bed' sound very similar over the phone.
2225,3567,8,32,142,182,1.2637362637362637,0.03947805424619005,660,"I’m in the mood for eggs, you?"
2015,3567,7,34,141,182,1.2637362637362637,0.03870147282946782,660,I'm contemplating the fall.
5406,3567,6,36,140,182,1.2637362637362637,0.03790898615466982,660,"It’s great! They bring me breakfast and everything...

(Or)

It’s great! I just sit here and they bring me breakfast and everything..."
1335,3567,5,38,139,182,1.2637362637362637,0.037099574975730645,660,Wanna make a baby bird?
1215,3567,9,30,143,182,1.2637362637362637,0.040239651277815675,660,I turned over a new leaf.
785,3567,8,32,142,182,1.2637362637362637,0.03947805424619005,660,I have this thing about processed wood.
1727,3567,9,30,143,182,1.2637362637362637,0.040239651277815675,660,It's hard to find free range eggs in the city
60,3567,6,36,140,182,1.2637362637362637,0.03790898615466982,660,"Wonderful view, reasonable rent; these tree houses are the next BIG thing, really.”  Jacqueline Moran, Ottawa"
5744,3578,7,25,116,148,1.2635135135135136,0.044314025996588666,660,Hey.  You got the time?
4328,3579,7,30,130,167,1.2634730538922156,0.040914790907759784,660,"Sweetie, please come home, that’s not what they meant by nesting."
2396,3580,7,35,144,186,1.2634408602150538,0.03815392655139479,660,"Empty Nest Syndrome be damned!"""
3682,3580,8,33,145,186,1.2634408602150538,0.038908157885680326,660,And it is only five hundred dollars a month!
1596,3580,4,41,141,186,1.2634408602150538,0.03579600808729694,660,The eggs are so warm.
1950,3580,7,35,144,186,1.2634408602150538,0.03815392655139479,660,I thought you were an empty nester ?
4870,3584,6,33,132,171,1.263157894736842,0.03941343871821076,660,"I don't know, honey, I just got this sudden crazy urge!"
1357,3584,7,31,133,171,1.263157894736842,0.040276774960249215,660,This timeshare is worth every penny!
1617,3584,7,26,119,152,1.263157894736842,0.04352140984370994,660,Property taxes are for the birds!
1623,3584,8,29,134,171,1.263157894736842,0.041121989869204546,660,"Sure it's a little drafty, but it's affordable... and it really keeps my Tinder dates from sneaking out in the morning."
2117,3584,8,24,120,152,1.263157894736842,0.04451125128015218,660,Rent controlled!
2294,3584,8,34,148,190,1.263157894736842,0.03836033165813674,660,Helping and hoping for one good egg
2422,3584,7,36,147,190,1.263157894736842,0.037627386999170565,660,Anthropologically speaking we just aren't meant to be on the ground - that's why we live in skyscrapers
3167,3584,6,33,132,171,1.263157894736842,0.03941343871821076,660,Today's my bird day.
4108,3584,11,28,151,190,1.263157894736842,0.040479617371375204,660,"No worries,eh?  I'm on my way to Canada."
4136,3584,8,29,134,171,1.263157894736842,0.041121989869204546,660,"Left the nest, but mom still stops by twice a day to throw up in my mouth"
4998,3594,13,25,156,194,1.2628865979381443,0.041212067069257806,660,"“ The way I see it,  it’s an easy way to have a nest egg."""
3960,3595,3,40,132,175,1.262857142857143,0.03620257338219638,660,"Yeah, but I'll have it made in the shade as soon as fall rolls around."
3222,3595,9,28,138,175,1.262857142857143,0.041288194310771846,660,Just sittin on my nest egg.
4672,3595,8,30,137,175,1.262857142857143,0.040484979244804646,660,"Best rent I could find, and the view is great."
624,3595,3,40,132,175,1.262857142857143,0.03620257338219638,660,"I won't be falling for you this time, Fred."
2925,3595,5,36,134,175,1.262857142857143,0.03797353301283531,660,Who can afford rent these days?
3264,3600,7,27,122,156,1.2628205128205128,0.04276639324281545,660,I guess you could say I've got the nesting urge.
5371,3600,7,27,122,156,1.2628205128205128,0.04276639324281545,660,I finally have an empty nest.
1738,3600,7,27,122,156,1.2628205128205128,0.04276639324281545,660,I see you're taking 'stay off the grass' literally.
2657,3600,6,29,121,156,1.2628205128205128,0.041788173028505786,660,AirBirdnBird Nest-sharing!
2908,3604,10,27,142,179,1.2625698324022345,0.04141857851945866,660,Why?  Because it is a rent controlled nest  and the view is unobstructed.
5437,3605,5,32,123,160,1.2625,0.040132935548290886,660,"Well, it is Williamsburg."
3450,3605,7,28,125,160,1.2625,0.04204622718063757,660,"It's a bird... It's a plane... Oh, its just my step son Gary..."
2841,3607,8,32,143,183,1.2622950819672132,0.03928817636165757,660,...and all the dead fish I can eat. Then we migrate north.
3563,3607,9,30,144,183,1.2622950819672132,0.040045100102282405,660,"Now I know the meaning of ""empty nest""."
5070,3607,9,30,144,183,1.2622950819672132,0.040045100102282405,660,"I understand your need to fill an empty nest, but isn't this a little bit ridiculous?"
5651,3607,8,32,143,183,1.2622950819672132,0.03928817636165757,660,"Neither her parents nor mine approve, but we're making it work."
397,3611,5,33,126,164,1.2621951219512195,0.03950805227642463,660,I was so lucky! This loft was a steal!
1947,3611,11,21,132,164,1.2621951219512195,0.044830641186582636,660,"You won't ever complain about an empty nest again, Dad."
2711,3611,7,29,128,164,1.2621951219512195,0.041358428316984844,660,Going green
4569,3611,8,27,129,164,1.2621951219512195,0.0422532400170497,660,"""Yeah, it's a little lonely since you left."""
5558,3611,4,35,125,164,1.2621951219512195,0.03854957192485366,660,"I'd like to, but I've got to feed my kids now."
2125,3616,9,36,161,206,1.2621359223300972,0.03701017139895763,660,I'm really feeling that nesting instinct and you're going to be a father.
2823,3617,8,22,115,145,1.2620689655172415,0.04592669660691276,660,"It's only $2,000 a month and it comes with all the squirrels you can eat."
246,3618,6,37,144,187,1.2620320855614973,0.037210704516369035,660,What?! I am nesting.
1484,3618,8,33,146,187,1.2620320855614973,0.03872516679292352,660,"If I wait here long enough, she’ll come back with a cheeseburger."
1490,3618,6,37,144,187,1.2620320855614973,0.037210704516369035,660,I'm a 'surrogate-egg warmer'... and will rejoin you for daily walks once the chirping begins!
1614,3618,11,27,149,187,1.2620320855614973,0.04089182756911918,660,Welcome to college
2983,3618,6,37,144,187,1.2620320855614973,0.037210704516369035,660,"It's kinda pricey and no stairs, but meals are included."
4754,3618,3,43,141,187,1.2620320855614973,0.03481570783140417,660,You were right about the benefits of an empty nest.
5443,3624,7,30,131,168,1.2619047619047619,0.04070074746107804,660,Yoga in the park 'tree pose'--how 'bout you?
5433,3624,6,32,130,168,1.2619047619047619,0.039815384519815186,660,"I'm delighted to have found this cozy, winter sublet with unobstructed views of the park."
5356,3624,7,30,131,168,1.2619047619047619,0.04070074746107804,660,Why not?
3266,3624,6,32,130,168,1.2619047619047619,0.039815384519815186,660,Got a killer deal on rent
1608,3624,8,28,132,168,1.2619047619047619,0.0415672568654724,660,I'm sitting on my nest egg.  Would you like to add yours to the clutch?
883,3624,4,36,128,168,1.2619047619047619,0.03798279670589456,660,What?..I had the overwhelming urge to start nesting.
73,3624,7,30,131,168,1.2619047619047619,0.04070074746107804,660,Let’s just say my life has migrated south.
42,3624,8,28,132,168,1.2619047619047619,0.0415672568654724,660,Used to have a family but all the kids have left the nest.
1699,3624,4,36,128,168,1.2619047619047619,0.03798279670589456,660,It even has a self-deploying green roof!
75,3633,8,34,149,191,1.2617801047120418,0.03818382924449672,660,"Hey, handsome. Lookin' for an on-nest woman?"""
3377,3633,8,34,149,191,1.2617801047120418,0.03818382924449672,660,"""It keeps me grounded."""
4202,3633,11,28,152,191,1.2617801047120418,0.040290688983298725,660,Now can we get that weekend place?
2507,3636,4,37,131,172,1.2616279069767442,0.03743925865640066,660,And there aren't any condo fee's
2814,3636,7,31,134,172,1.2616279069767442,0.04007114244383266,660,I know. Nesting instinct.
1626,3636,9,27,136,172,1.2616279069767442,0.04173362395913673,660,"Well, where did you think free-range eggs come from?"
1258,3636,7,31,134,172,1.2616279069767442,0.04007114244383266,660,"I take the ""no loitering on the park grounds"""" restriction literally."
550,3636,6,33,133,172,1.2616279069767442,0.03921347983474019,660,We have finches on our balcony
2607,3641,8,35,152,195,1.2615384615384615,0.03766286808791138,660,"Yes, its just a No-water Shinny-up, but in summer the privacy is great."
1514,3642,6,28,119,153,1.261437908496732,0.04226479039206945,660,It's a rent control.
3321,3642,8,24,121,153,1.261437908496732,0.044252809299484865,660,I just entered my 30’s. Mom told me these should be my nesting years.
2633,3644,11,24,141,176,1.2613636363636365,0.04263148976656396,660,That’s not how you make your eggs organic.
3076,3644,8,30,138,176,1.2613636363636365,0.040281990081318636,660,You got sushi and the internet; I got a feathered nest and all the worms I can eat.
4268,3644,7,32,137,176,1.2613636363636365,0.03946775468628014,660,"It's rent controlled, and no HOA fees!"
5398,3644,11,24,141,176,1.2613636363636365,0.04263148976656396,660,"How did you hear about me - was it Twitter, Instagram, or LinkedIn? I quit Facebook."
5532,3648,7,33,140,180,1.261111111111111,0.03888888888888888,660,Where else am I going to find a rent-controlled place in this market?
5361,3648,7,33,140,180,1.261111111111111,0.03888888888888888,660,What’s your maintenance like?
5198,3648,5,37,138,180,1.261111111111111,0.037258545142702076,660,Wanna Lay Some Eggs?
3156,3648,10,27,143,180,1.261111111111111,0.041213655726041944,660,"My parents moved out, so I guess I’m an empty nester now."
3304,3652,11,26,147,184,1.2608695652173914,0.04131591289992289,660,I was advised to protect my retirement nestegg.
3217,3652,5,32,124,161,1.2608695652173914,0.03991619630573821,660,I actually enjoy being an empty nester.
2758,3652,8,26,127,161,1.2608695652173914,0.0427343185528518,660,No way! You know how many birds poo on those benches?
2593,3652,7,34,143,184,1.2608695652173914,0.038332995366703516,660,My therapist says  that I need to get out more in the fresh air and to nest.
4001,3652,9,30,145,184,1.2608695652173914,0.039852372529987024,660,"Just a moment.
I'll fly down."
1757,3652,8,32,144,184,1.2608695652173914,0.0391000647701035,660,"I'd love to get you down from there, but we could use the eggs."
1599,3652,8,32,144,184,1.2608695652173914,0.0391000647701035,660,My work gives me 3 weeks of paternal nesting.
877,3652,7,28,126,161,1.2608695652173914,0.04181605230798118,660,The story of my life - I never learned to fly.
2008,3652,5,32,124,161,1.2608695652173914,0.03991619630573821,660,They're letting me stay here until they get back from Galveston.
1078,3661,3,43,142,188,1.2606382978723405,0.034658059936536416,660,"I know, but I get this way when my hormones kick in."
1408,3661,10,29,149,188,1.2606382978723405,0.039992576468757035,660,Who needs rent control?
4575,3661,11,27,150,188,1.2606382978723405,0.040697610077796396,660,I told you I was literally going out on a limb.
202,3664,5,33,127,165,1.2606060606060605,0.03930001880371855,660,I hear the studios are getting expensive now
249,3664,9,25,131,165,1.2606060606060605,0.042896745774035065,660,I'm saving it for my friends.
569,3664,5,33,127,165,1.2606060606060605,0.03930001880371855,660,I’m trying out this open concept living thing.”
1780,3664,7,29,129,165,1.2606060606060605,0.04113770944021329,660,I was advised to do a better job of managing my nest egg!
4921,3664,8,27,130,165,1.2606060606060605,0.042026431778046595,660,"It's got a great view of Central Park, it's 100% green energy, and the most affordable rent in Manhattan."
4769,3669,5,27,110,142,1.2605633802816902,0.04319612541308653,660,I love it! It's rent controlled.
4899,3670,5,34,130,169,1.2603550295857988,0.03870999361770568,660,It's squawkers rights.
4423,3670,7,30,132,169,1.2603550295857988,0.04048886713841456,660,"All in all, I have to say that my take on a nesting phase just feels right for me."
1405,3670,7,30,132,169,1.2603550295857988,0.04048886713841456,660,Just preparing for when we’ll be empty nesters
2262,3670,4,36,129,169,1.2603550295857988,0.03778916812723097,660,I am waiting for the Fire Department to arrive.
912,3674,8,29,136,173,1.260115606936416,0.04070176751043654,660,"I knew I couldn't have it all in the NYC nest search, so I prioritized park views. What do you think?"
1387,3674,4,37,132,173,1.260115606936416,0.03725292656920892,660,I couldn’t afford the Park Avenue view... but I do have a great view of Park Avenue.
2068,3674,11,23,139,173,1.260115606936416,0.043107700980807295,660,"Well, I didn't want to be an empty-nester."
2843,3674,7,31,135,173,1.260115606936416,0.03986753746280222,660,They're not really free-range unless you brood them yourself.
3389,3674,3,39,131,173,1.260115606936416,0.03633960928305618,660,"...and, trust me, I don't miss those mortgage repayments at all."
3503,3674,6,33,134,173,1.260115606936416,0.03901547395870323,660,I'm tending to our nest egg.
4076,3674,9,27,137,173,1.260115606936416,0.041519239077797615,660,I'll be famous... the biggest story since the Mandarin Duck!
4538,3681,7,25,118,150,1.26,0.0437912477337203,660,"I won the bet fair and square.  No Obstruction.  Now, get a worm, climb up, and regurgitate it into my mouth."
5749,3682,5,36,136,177,1.2598870056497176,0.03760159911715133,660,We don’t have a live-in super but the common charges are low!
3316,3682,3,40,134,177,1.2598870056497176,0.03585355749979914,660,I'm giving Horton a break
1929,3682,10,26,141,177,1.2598870056497176,0.04165197394008879,660,It's the latest in birthing theories.
2691,3682,7,32,138,177,1.2598870056497176,0.03927191015143658,660,"According to Trump, I'm an endangered species."
3739,3686,7,26,121,154,1.2597402597402598,0.04302183273971188,660,The best thing is an albatross brings me sushi every hour.
3824,3686,6,28,120,154,1.2597402597402598,0.04202375107555406,660,"The rent could be better, but the amenities cover the whole park."
4395,3686,7,26,121,154,1.2597402597402598,0.04302183273971188,660,#1 flew over the cuckoos nest. #2  wasn't able  to make it.
726,3689,8,31,142,181,1.2596685082872927,0.03948548004199304,660,"Unfortunately, I bet on Hillary."
144,3689,7,33,141,181,1.2596685082872927,0.038700333072747534,660,"You'll be happy to know, I've been working on my nest egg."
3838,3689,9,29,143,181,1.2596685082872927,0.04025531627439616,660,"Nah, I'm not out of my tree---yet!"
2688,3692,7,40,161,208,1.2596153846153846,0.0354081058021063,660,"Once the word gets around, it will be a colony."
2204,3693,9,23,126,158,1.259493670886076,0.044153810223525845,660,Can’t beat the rent!
406,3693,8,25,125,158,1.259493670886076,0.04323116124014815,660,The 'early bird' really does get the worm!
324,3693,6,29,123,158,1.259493670886076,0.04132410908906316,660,"Don't worry sir, I'm Robin. Batman and I are doing a stakeout."
1500,3696,7,35,147,189,1.2592592592592593,0.037623411807978444,660,It's got a view and it's rent-controlled ...
4773,3696,3,36,123,162,1.2592592592592593,0.03772085545889085,660,"With rent prices this high, why leave the nest?"
5048,3696,7,35,147,189,1.2592592592592593,0.037623411807978444,660,WHAT!!! Are you still expecting a partridge to be sitting in a pear tree?
5448,3696,8,26,128,162,1.2592592592592593,0.04250022490597157,660,I could use an umbrella
1651,3700,6,38,149,193,1.2590673575129534,0.03638105817158082,660,"Well, yes, I'm usually downstairs but the view from the penthouse is really quite spectacular."
3127,3701,6,31,129,166,1.2590361445783131,0.04001708551824684,660,Don't mind me. I'm just preparing for climate change.
1601,3701,8,27,131,166,1.2590361445783131,0.04180198360879839,660,I don't think the What to Expect book meant THAT.
3224,3701,5,33,128,166,1.2590361445783131,0.03909408885300817,660,You'd be surprised that a bird's eye view is really spectacular.
1381,3701,6,31,129,166,1.2590361445783131,0.04001708551824684,660,Getting ahead of the housing crisis
1347,3701,5,33,128,166,1.2590361445783131,0.03909408885300817,660,It's only $750 a month with a great view.
1553,3701,8,27,131,166,1.2590361445783131,0.04180198360879839,660,I am taking your advise Dad and sitting on a Nest Egg.
1752,3707,11,29,157,197,1.2588832487309645,0.03935304873448916,660,I havent figured that out yet.
571,3708,7,30,133,170,1.2588235294117647,0.04027911870455727,660,"It's Marie Kondo-approved."""
4112,3708,3,38,129,170,1.2588235294117647,0.03665996217290334,660,My ex wanted to spread his wings
4559,3708,6,32,132,170,1.2588235294117647,0.039405504175705416,660,"It took my whole nest egg, but it's home."
320,3711,9,27,138,174,1.2586206896551724,0.04130699281584876,660,"And, it's rent controlled!"
4146,3711,6,33,135,174,1.2586206896551724,0.03881939401024628,660,The only part I haven't figured out is how to get free health insurance.
5159,3711,7,31,136,174,1.2586206896551724,0.039665931469940595,660,"After paying my taxes this year, I'm protecting the only nest egg I have left."
5340,3711,8,29,137,174,1.2586206896551724,0.040494776051156305,660,"Listen John, when you get to my age fighting a family of magpies for a tree just isn’t big deal anymore"
5533,3711,5,35,134,174,1.2586206896551724,0.03795397980801837,660,"Of course, I trusted the real estate agent, because any good bargain hunter knows 'location, location, location' is everything."
600,3716,8,37,160,205,1.2585365853658537,0.03636310616012965,660,This is my punishment for eating their parents for lunch.
4618,3717,6,34,138,178,1.2584269662921348,0.038257099316967906,660,It was a free upgrade.
2026,3717,6,34,138,178,1.2584269662921348,0.038257099316967906,660,I'm ovulating!
1059,3717,3,40,135,178,1.2584269662921348,0.035681448007920155,660,"Gerald, I refuse to accept the notion of an empty nest."
1434,3717,8,30,140,178,1.2584269662921348,0.03988189554529687,660,My parents are getting a divorce
1481,3717,8,30,140,178,1.2584269662921348,0.03988189554529687,660,Last spring my wife told me she'll be right back and to stay here and keep the eggs warm.
4392,3722,4,31,116,151,1.2582781456953642,0.040377442349399294,660,"I figure, BE the change you want to see in your life!"
3023,3723,7,33,142,182,1.2582417582417582,0.0385135428189856,660,"Forget the egg thing, I just went for the nest."
1857,3723,8,31,143,182,1.2582417582417582,0.039293838554726686,660,This sure beats nine months of wearing maternity
1631,3723,9,29,144,182,1.2582417582417582,0.040058938032104814,660,"It is big for a bird, but hey, I'm not a bird."
4293,3723,5,37,140,182,1.2582417582417582,0.0369034882454174,660,"Yeah, and a bargain at 10000 for the Upper East."
531,3723,6,35,141,182,1.2582417582417582,0.037717107691003414,660,"No rent, no chores, and three meals a day litrrally dropped into my mouth."
282,3723,8,31,143,182,1.2582417582417582,0.039293838554726686,660,I found it on TreeEasy.com.
662,3723,10,27,145,182,1.2582417582417582,0.04080969595764102,660,I can't believe I had to put my whole nest egg into this spot.
492,3730,4,32,119,155,1.2580645161290323,0.039729615770672154,660,Yeah.  I used to be an empty nester.
4520,3730,4,32,119,155,1.2580645161290323,0.039729615770672154,660,It's affordable and has a view!
5608,3730,4,32,119,155,1.2580645161290323,0.039729615770672154,660,"Dad, can we talk about upgrading to a man cave?"
2287,3733,6,29,124,159,1.2578616352201257,0.041095805817513,660,How do you like my new place? It's a cozy studio in an established neighborhood.
4014,3733,11,19,129,159,1.2578616352201257,0.045682849465535476,660,It was a steal at $3000 a month.
5232,3733,5,31,123,159,1.2578616352201257,0.040115505230405954,660,"Cheap rate, great view, and breakfast was included!"
1133,3736,9,24,130,163,1.2576687116564418,0.04315526050809657,660,At least my rent is cheep.
276,3737,7,37,154,198,1.2575757575757576,0.03646412306673373,660,Wanna see my egg??
240,3737,8,35,155,198,1.2575757575757576,0.03716054943048061,660,"I’m done watching, Dave."
3537,3739,7,29,131,167,1.2574850299401197,0.04070306999953109,660,"But, Dear, this is my version of nesting."
1993,3739,2,39,126,167,1.2574850299401197,0.03600021628994921,660,This really gives you a bird's-eye view.
2815,3739,7,29,131,167,1.2574850299401197,0.04070306999953109,660,I didn't know you were expecting?
353,3742,6,32,133,171,1.2573099415204678,0.03920361433755316,660,It's not much. But it's the only place I could afford on my own. And it comes with an omelet bar!
374,3742,5,34,132,171,1.2573099415204678,0.038316105328219364,660,My therapist suggested nesting.
599,3742,6,32,133,171,1.2573099415204678,0.03920361433755316,660,"Then I say, ‘Why don’t we call it Bitcoin?’"
1541,3742,2,40,129,171,1.2573099415204678,0.035520776718844294,660,This is my new side hustle. I found this gig on Air Tree & Tree. I get $10 per hour plus a $5 bonus for every egg that hatches.
3220,3742,8,28,135,171,1.2573099415204678,0.04092092711970746,660,"I thought you were heading south for the winter, to your place on palm"
4066,3742,8,28,135,171,1.2573099415204678,0.04092092711970746,660,We’re having a bird!
5655,3742,6,32,133,171,1.2573099415204678,0.03920361433755316,660,Didn’t we agree that it was time to settle into our own nest and have a family?
5661,3742,6,32,133,171,1.2573099415204678,0.03920361433755316,660,"Hey, downsizing is in... google it."
1665,3750,9,27,139,175,1.2571428571428571,0.04109685441303293,660,"I told you I was in a nesting mood, so I found this one on Amazon; and they shipped it with our Prime account."
914,3750,6,33,136,175,1.2571428571428571,0.03862521336731559,660,I'm sitting on my nest egg in the current economic climate.
33,3752,10,26,143,179,1.2569832402234637,0.04123614496928282,660,"I spend all day shitting on people. This rules, dude."
2296,3752,11,24,144,179,1.2569832402234637,0.0419903602100004,660,At heart I'm a nestor.
3686,3752,5,36,138,179,1.2569832402234637,0.037236623890174715,660,My nesting instinct is kicking in.
4507,3752,8,30,141,179,1.2569832402234637,0.03968473578911617,660,I used to hate eggs.
1536,3756,7,33,143,183,1.2568306010928962,0.0383284945272189,660,The hygge is incredible
1713,3756,10,27,146,183,1.2568306010928962,0.04061060469698003,660,"At the risk of appearing too obvious, Winston,  this bird’s eggs are ready."
4363,3756,6,35,142,183,1.2568306010928962,0.037536971805753584,660,"Don't forget, I fly south in the winter."
813,3759,7,34,146,187,1.2566844919786095,0.03779286171126043,660,Mama bird's looking for worms while I'm keeping her eggs warm.  How could I not help?
4680,3759,9,30,148,187,1.2566844919786095,0.039284887792402745,660,I'm going 'green'in a couple of months.
4311,3761,8,23,121,152,1.256578947368421,0.04427557808511744,660,It's a new concept...it's called a tiny loft.
4365,3762,7,35,149,191,1.256544502617801,0.0372776107570834,660,Care for an omelet?
3202,3762,7,35,149,191,1.256544502617801,0.0372776107570834,660,"This is a gig economy, pal, so I'm going to feather my nest every chance I get."
3506,3762,6,37,148,191,1.256544502617801,0.03653092748295081,660,Why are you surprised ? I told you I was nesting
2143,3765,10,20,126,156,1.2564102564102564,0.045356591797701226,660,Howdy! Looking for a 'cheep' date?
4404,3765,7,26,123,156,1.2564102564102564,0.04253329826955489,660,Three more weeks and our chicks will be hatched!
1016,3767,8,25,127,160,1.25625,0.04275025745628459,660,"Well, at least he's out of my basement..."
1662,3767,7,27,126,160,1.25625,0.041820666665864606,660,I got it at a yard sale.
2138,3769,6,30,128,164,1.2560975609756098,0.040220430356588004,660,"Well, they say it's for the birds. I say it's for me."
2375,3769,7,28,129,164,1.2560975609756098,0.04114000142387433,660,It wouldn't have made sense to skimp on the nest.
5026,3771,8,27,133,168,1.255952380952381,0.04136002690521971,660,"No dear, I'm not coming hoe.
I waited thirty years to become
an empty nester ''"
3877,3771,8,27,133,168,1.255952380952381,0.04136002690521971,660,New York City solves it homeless population problem.
3411,3771,5,33,130,168,1.255952380952381,0.03868841980892167,660,Because it's softer.  Duh!
3239,3771,8,27,133,168,1.255952380952381,0.04136002690521971,660,It's more stable than my rent was.
2200,3771,3,37,128,168,1.255952380952381,0.03679975310313832,660,"As a homeless hipster, I'd rather call this ""nesting"""
1026,3771,4,35,129,168,1.255952380952381,0.03775589792180357,660,I told you I had a strong nesting urge.
1180,3771,10,23,135,168,1.255952380952381,0.043049086220963186,660,Come up and see me sometime
1092,3771,5,33,130,168,1.255952380952381,0.03868841980892167,660,"Our nest isn’t actually empty, John!  See my point?"
366,3771,7,29,132,168,1.255952380952381,0.040489082802291125,660,"Whoever said, ""Bird's eye view"", got it right!"
1976,3771,9,25,134,168,1.255952380952381,0.042213005401537225,660,A little bird told me this is how babies are made
5686,3771,3,37,128,168,1.255952380952381,0.03679975310313832,660,It has a birds-eye view and the rent is affordable.
5751,3782,4,36,132,172,1.255813953488372,0.037219500846350013,660,Don't worry-this sublet ends on March 21st
4962,3782,6,32,134,172,1.255813953488372,0.03900371976184006,660,It's only $1700 a month and it's Southern exposure!
5643,3782,6,32,134,172,1.255813953488372,0.03900371976184006,660,"Besides the good reception, the faux tree cell tower is surprisingly comfortable."
4083,3782,7,30,135,172,1.255813953488372,0.03986589534005859,660,An empty nest all to yourself is so great!
3982,3782,9,26,137,172,1.255813953488372,0.041536592581399946,660,"So what, Gerald? Unlike you, I don't have parents with half a million to bribe the birding society admissions chair."
2698,3787,6,33,137,176,1.2556818181818181,0.038432905857564745,660,Best people watching spot in the park.
3188,3787,7,31,138,176,1.2556818181818181,0.03926860473191656,660,"My realtor said this tiny house was for the birds, but I’ve been feeling like nesting lately."
2935,3789,8,31,145,184,1.2554347826086956,0.038915936877687615,660,It's only $600 per month and my landlady feeds me worms.
5622,3789,6,35,143,184,1.2554347826086956,0.03735849408880149,660,"Your butt hurts all the time, but you get used to it."
2649,3791,11,26,151,188,1.2553191489361701,0.04052810193708301,660,Millennials.
887,3792,2,45,145,192,1.2552083333333333,0.033230148840436055,660,It's the city's new solution to removing The Homeless off the sidewalks!
3750,3793,6,39,155,200,1.255,0.03544228800309698,660,I call this next-gen nesting!
4556,3793,5,41,154,200,1.255,0.03472613601616318,660,...and I get eggs every morning!
4549,3795,3,33,117,153,1.2549019607843137,0.03882676076658846,660,"Thanks to climate change, I can crash here a little longer!"
2158,3795,6,40,158,204,1.2549019607843137,0.03500531139040003,660,The owner is in Florida now and offered me cheep rent.
2782,3795,5,29,119,153,1.2549019607843137,0.04098189814585094,660,I’m trying out minimalism. My other home’s in Central Park South.
3287,3798,5,30,122,157,1.2547770700636942,0.040316057606833856,660,"Haven't you heard? Hammocks are out, nesting is in."
4675,3798,7,26,124,157,1.2547770700636942,0.04229306249982094,660,This is the bench i was telling you about!
5420,3798,6,28,123,157,1.2547770700636942,0.04131638680094925,660,"I can see clearly now, now that the kids have fledged."
3547,3801,8,25,128,161,1.2546583850931676,0.04251370176061516,660,Can you believe it? I snagged this for just under market value. What a steal!
4786,3801,6,29,126,161,1.2546583850931676,0.040646467672910316,660,It's my nesting period.
5171,3801,8,25,128,161,1.2546583850931676,0.04251370176061516,660,She promised to be back in spring.
1569,3804,4,34,127,165,1.2545454545454546,0.038113830998969304,660,"Yeah man, house sitting is a pretty good gig!"
5168,3804,9,24,132,165,1.2545454545454546,0.04268738998176099,660,"Ya that's right, I haven't come down since '92. How'd that whole Internet thing turn out?"
4440,3806,5,33,131,169,1.2544378698224852,0.03848862214805896,660,"Well, Mike, it started with giving up Twitter; and suddenly I felt lighter and freer.”

Cathi Burgess
Somerville, M"
620,3806,7,29,133,169,1.2544378698224852,0.040277273879018013,660,My folks are right: empty-nester life is pretty sweet.
4208,3808,5,34,134,173,1.254335260115607,0.03792988511451294,660,"My parents said moving to New York City would be stressful, but luckily I haven't developed any unhealthy coping mechanisms."
1912,3809,11,23,143,177,1.2542372881355932,0.042231402225214834,660,Just another day in Washington D.C.
2524,3809,9,27,141,177,1.2542372881355932,0.0406827809168981,660,"My mortgage company just made me an ""empty nester""-- literally!"
2830,3809,6,33,138,177,1.2542372881355932,0.038242445750357026,660,Buy you a new hat? You know what can happen when you walk under a tree.
5015,3809,11,23,143,177,1.2542372881355932,0.042231402225214834,660,"Oh, I’m just house-sitting for a Russian oligarch."
1550,3813,9,28,144,181,1.2541436464088398,0.04006953450711325,660,"You know ever since moving out of my parents house, things have really been looking up. Did you bring the wine?"
1901,3813,9,28,144,181,1.2541436464088398,0.04006953450711325,660,Cocooning is so twentieth century
4439,3813,7,32,142,181,1.2541436464088398,0.03850704983774623,660,"There’s more to a woman’s life than just nesting, you know."
5451,3813,9,28,144,181,1.2541436464088398,0.04006953450711325,660,"Getting a reservation was hard, but the regurgitated earthworm is to die for!"
4179,3817,6,35,144,185,1.2540540540540541,0.03718165283133156,660,My real estate agent is also getting me a great deal on a bridge nearby!
1716,3817,5,37,143,185,1.2540540540540541,0.03638297542380465,660,She will be right back.
604,3819,8,33,152,193,1.2538860103626943,0.03766142053084029,660,"The landlord said I can stay as long as I watch her kids. It comes with free breakfast too, apparently..."
4740,3819,4,41,148,193,1.2538860103626943,0.03467698273792965,660,"Ok, ok. I confess. I have always fantasized about being the early bird."
2490,3821,9,32,156,197,1.2538071065989849,0.037847681945467414,660,You wanna see the eggs?
2612,3821,5,40,152,197,1.2538071065989849,0.03500367914763501,660,Once you get used to the worms it's really not so bad
1476,3823,9,33,159,201,1.2537313432835822,0.03734327165133375,660,"Las year I was adoted by a loon.   Very tasty meals , but I cvouldn't stand the hooting"
4193,3824,7,24,119,150,1.2533333333333334,0.043541917540996115,660,I know they call it “empty nester” but I’m supposed to be in there with you.
3910,3825,8,23,123,154,1.2532467532467533,0.043761753910379876,660,I find it very uplifting.
5221,3825,7,25,122,154,1.2532467532467533,0.042780938132409324,660,I don't trust the banks with my nest egg.
4154,3827,6,29,127,162,1.2530864197530864,0.040425359327943194,660,Traders are predicting the flattening of the yield curve. Where's your nest egg?
5633,3827,6,29,127,162,1.2530864197530864,0.040425359327943194,660,Do you feel like beetle grubs tonight?
1224,3827,5,31,126,162,1.2530864197530864,0.03946553484613882,660,"I’m nesting and you know who’s 
fault it is!!"
4981,3830,6,30,130,166,1.2530120481927711,0.039793871028663635,660,"Honey, you said we were EMPTY NESTER’S."
2888,3830,6,30,130,166,1.2530120481927711,0.039793871028663635,660,I am the bird lady
3942,3832,6,31,133,170,1.2529411764705882,0.03918928221208077,660,"It might not look like much, but it's the only tree in the neighborhood that has Rent Control!"
733,3833,5,34,135,174,1.2528735632183907,0.037739584453835955,660,Can't beat the cost per square foot.
1428,3833,6,32,136,174,1.2528735632183907,0.038609804490614755,660,Somebody has to hatch these eggs
1832,3833,7,30,137,174,1.2528735632183907,0.039460838445967844,660,In the winter it's just free housing!
2411,3833,5,34,135,174,1.2528735632183907,0.037739584453835955,660,"Dad, don’t fight my nesting instinct."
3000,3833,7,30,137,174,1.2528735632183907,0.039460838445967844,660,Yes I am a looney bird!
4072,3833,5,34,135,174,1.2528735632183907,0.037739584453835955,660,You promised they’d leave home...they didn’t
5742,3839,3,39,136,178,1.252808988764045,0.035463394761095175,660,Joe decided to voice his concerns via Twitter
4654,3839,3,39,136,178,1.252808988764045,0.035463394761095175,660,Me? I'm nest sitting during the winter migration.
3879,3839,10,25,143,178,1.252808988764045,0.041255450215249845,660,I think I'm over empty nest syndrome.
2121,3839,4,37,137,178,1.252808988764045,0.03634738422569202,660,"So, how's that rent-controlled apartment treating you?"
695,3839,6,33,139,178,1.252808988764045,0.03805380774886673,660,"Rents cheap, view's great!"
456,3839,7,31,140,178,1.252808988764045,0.038878943610346745,660,"Good morning John, I'm just waiting for breakfast"
2260,3839,10,25,143,178,1.252808988764045,0.041255450215249845,660,... and I just installed a Nest doorbell too!
4274,3846,3,40,139,182,1.2527472527472527,0.035008531867996094,660,I'm still waiting for Horton.
1833,3846,6,34,142,182,1.2527472527472527,0.037519802867789206,660,After the housing market exceeded my nest egg I realized I'd been taking the term too literally.
2069,3846,8,30,144,182,1.2527472527472527,0.03910449006224144,660,"Hey buddy, can you spare a twig?"
2469,3846,5,36,141,182,1.2527472527472527,0.03670180975568745,660,Just dealing with my nesting instincts
3765,3850,9,29,148,186,1.2526881720430108,0.03929177434726687,660,"I needed a break.  I was going completely squirrelly sitting in that office!"""
2577,3850,5,37,144,186,1.2526881720430108,0.036212607974092925,660,I just couldn’t cope with being an empty nester.
2110,3850,7,33,146,186,1.2526881720430108,0.03778357121581996,660,They’re snow birds.
5642,3853,8,33,153,194,1.2525773195876289,0.0374896354603738,660,Someone has to look out for our nest egg!
5573,3854,6,41,163,210,1.2523809523809524,0.03429590238745473,660,"Robin, I know its april 20th, but can you please get down?"
1583,3855,1,36,114,151,1.2516556291390728,0.036657887425425285,660,Mom said she was throwing me out of the nest and a little millenium  birdy told me this one was available.
832,3856,3,33,119,155,1.2516129032258065,0.038394189865459456,660,I call it my summer home.
5561,3856,4,31,120,155,1.2516129032258065,0.039470254572099274,660,Usually I branch out when Spring arrives.
1946,3858,7,26,126,159,1.251572327044025,0.04182044241324806,660,"See Dad, no empty nest yet!"
4100,3858,5,30,124,159,1.251572327044025,0.03987137333776931,660,My nesting instinct kicked in this very minute!
808,3858,5,30,124,159,1.251572327044025,0.03987137333776931,660,No one complains that it isn't made!
1655,3858,5,30,124,159,1.251572327044025,0.03987137333776931,660,"I'm saving up a little nest egg, dad."
1517,3862,6,29,128,163,1.2515337423312884,0.04020657696812169,660,It's got a great view. I don't need a doorman. I mean what more could you ask for?
1067,3863,8,26,133,167,1.251497005988024,0.041366321584708224,660,Just taking a quick bird's eye view of my life.
1521,3863,7,28,132,167,1.251497005988024,0.040484906997012814,660,"Not a single leaf was sparking joy, so I just thanked each one - and sent it away."
2466,3863,5,32,130,167,1.251497005988024,0.0386618411456482,660,"After 12 years of being a gutter-punk, I decided to branch out."
5380,3863,4,34,129,167,1.251497005988024,0.03771727845270143,660,Heat rises!
692,3867,7,29,135,171,1.2514619883040936,0.03986006417835845,660,"I said we are empty nesters, not go sit on a nest."
765,3867,6,31,134,171,1.2514619883040936,0.038987501416459756,660,Got this gig as a house sitter till the Spring.
2913,3869,7,30,138,175,1.2514285714285713,0.039261300071719546,660,Psst... I have three early-stage startups under here looking for the right investor.
2282,3870,7,31,141,179,1.2513966480446927,0.038686921395675346,660,I am the youngest.  My parents couldn't bare to see me go.
4548,3870,6,33,140,179,1.2513966480446927,0.03786696698228268,660,"A bird in a tree is worth two in a bush, Leonard."
460,3870,4,37,138,179,1.2513966480446927,0.03617133936090196,660,Happy Arbor Day.
1239,3870,4,37,138,179,1.2513966480446927,0.03617133936090196,660,Then increase my rent subsidy...
5503,3874,8,30,145,183,1.2513661202185793,0.03891473405344112,660,"Sure, the food's terrible, but you can't beat the service."
4943,3874,4,38,141,183,1.2513661202185793,0.035695371757997044,660,I recently discovered how much cheaper the rent is here!
4641,3874,3,40,140,183,1.2513661202185793,0.03484408593383537,660,The rent's pretty cheep.
3587,3874,5,36,142,183,1.2513661202185793,0.03652682309370365,660,"I'm okay, thanks--just waiting for spring."
3527,3874,7,32,144,183,1.2513661202185793,0.03813538102697993,660,But the eggs are really fresh.
3627,3874,9,28,146,183,1.2513661202185793,0.03967878232540861,660,I think I'm nesting!
2242,3880,8,31,148,187,1.2513368983957218,0.03836217890105118,660,"I built it to attract you, Mate!"
4480,3880,9,29,149,187,1.2513368983957218,0.03910444701442364,660,my nest thermostat arrives next week.
709,3882,9,30,152,191,1.2513089005235603,0.03855232771575296,660,"I was tired of being an ""Empty-Nester""."
2603,3883,9,31,155,195,1.2512820512820513,0.038021092511108745,660,"They fill our streets. Fine, we'll fill their nests."
3657,3883,10,29,156,195,1.2512820512820513,0.03871009648455422,660,I just wanted to check out the view from the top.  Overrated.
3828,3883,7,35,153,195,1.2512820512820513,0.036604197676330434,660,The view is spectacular and there are no HOA fees.
3160,3886,10,23,139,172,1.25,0.04214837823823943,660,"Yea, man. So I took your advice about building a nest egg in an environmentally-conscious way.'"
3864,3886,4,38,142,184,1.25,0.035527120470208784,660,Best spot for watching tree leafing!
4037,3886,6,34,144,184,1.25,0.037161395982792125,660,Save for the future?  Why would I need a nest egg?
4230,3886,5,36,143,184,1.25,0.036353443030162955,660,"Comfy, n'est-ce pas?"
4463,3886,7,28,133,168,1.25,0.04027103781908219,660,"Empty nest syndrome? An ounce of prevention, I say."""
4479,3886,7,35,154,196,1.25,0.03643952288160244,660,Surprise! I saw what you did just now.
4887,3886,3,37,132,172,1.25,0.036062301591596055,660,Great location and the price is right
4609,3886,5,34,137,176,1.25,0.03736447371640468,660,I prefer  to go highrise since I am  homeless
3132,3886,6,31,135,172,1.25,0.03878772955583102,660,"It's the cheapest option, plus it includes three meals a day!"
4945,3886,8,24,128,160,1.25,0.04252265396972455,660,"My mother said she loved being an empty nester, so once again I had to prove her wrong."
5099,3886,8,36,164,208,1.25,0.03574081936260718,660,Where were you all when I was up a creek?
5133,3886,5,35,140,180,1.25,0.03684904701174095,660,I'm just back from Boca. Going straight from migrating to hibernating.
5637,3886,10,20,130,160,1.25,0.04433293138324429,660,It's like Tinder but the really old school way.
4550,3886,6,30,132,168,1.25,0.039376014115146754,660,"Well, it’s better than a bird’s nest on the ground."
3125,3886,6,26,120,152,1.25,0.04200657220898526,660,"A 1bdr. loft for only $1000.00 a month, I was lucky to get it """
2465,3886,6,30,132,168,1.25,0.039376014115146754,660,"I’ll learn to fly soon, Dave"
2710,3886,8,23,125,156,1.25,0.04325946493965428,660,I killed the bird and I ate it. Big deal.
2583,3886,6,30,132,168,1.25,0.039376014115146754,660,"It's not luxury, but it still makes a great nesting spot."
2226,3886,7,28,133,168,1.25,0.04027103781908219,660,Love the free rent; it's the dead rodents she feeds me that are an acquired taste.
1999,3886,6,33,141,180,1.25,0.03768189899811689,660,It’s the latest hygge craze.
1850,3886,8,31,149,188,1.25,0.038180991923616237,660,It beats Uber and I get to sell half the chicks.
1689,3886,9,26,141,176,1.25,0.04069206502309947,660,I'm working on my Eagle Nest Badge!
1464,3886,6,25,117,148,1.25,0.04274438190247978,660,I'm happy being an empty nester.
1316,3886,2,36,122,160,1.25,0.036557871757275255,660,It’s home! I’ll have more privacy when It leafs out!
1036,3886,6,32,138,176,1.25,0.03822353935782192,660,I'm communing with nature!
892,3886,8,25,131,164,1.25,0.04181913845554626,660,I borrowed it from a friend for the weekend.
708,3886,3,36,129,168,1.25,0.036559711285882715,660,"But for me, finally an empty nest!"
532,3886,9,27,144,180,1.25,0.04007674202572669,660,"Yeah, yeah, I know -- 'but you need the eggs.'"
110,3886,7,28,133,168,1.25,0.04027103781908219,660,"""

""It's my hygge place."
3048,3886,4,32,124,160,1.25,0.038648553554096944,660,"I'm sitting on my retirement nest egg, hoping for an early spring."
5611,3916,9,28,148,185,1.2486486486486486,0.03929541096887466,660,Comfort is for the birds.
2906,3916,7,32,146,185,1.2486486486486486,0.03777063025753962,660,This is the year I'm finally going to find out where the ducks go when the lake freezes!
5052,3916,6,34,145,185,1.2486486486486486,0.036984673899755745,660,"Hi, can I interest you in a chocolate egg?"
2304,3916,8,30,147,185,1.2486486486486486,0.038540561965703886,660,Are you happy?
2508,3916,8,30,147,185,1.2486486486486486,0.038540561965703886,660,My wife said that I should try to understand the nesting instinct in preparation for our baby.
1358,3921,5,35,141,181,1.2486187845303867,0.036670916669870865,660,"Hey, don’t knock it. Being an empty nester is pretty cool!"
1430,3921,9,27,145,181,1.2486187845303867,0.039878635210206834,660,"Nah,don't worry,I didn't eat yet."
2826,3921,3,39,139,181,1.2486187845303867,0.03495685084498524,660,It's been good so far. Beats living with rabbits.
2413,3924,5,34,138,177,1.2485875706214689,0.03717961360189914,660,It’s a little rustic but at only $6500 a month I’m not complaining.
3306,3924,2,40,135,177,1.2485875706214689,0.03449231307731036,660,I can't wait for this thing to hatch.
308,3924,9,26,142,177,1.2485875706214689,0.04048615824127585,660,"Honey, get out of the tree....
and for God's sake, please shave, this isn't the 70's"
493,3924,4,36,137,177,1.2485875706214689,0.036305954500587746,660,I'll leave when I'm good and ready.
57,3928,4,35,134,173,1.2485549132947977,0.03680701896364391,660,It’s time that we had a nest egg.
545,3928,6,31,136,173,1.2485549132947977,0.03858993800515129,660,I have Stork home syndrome
831,3928,5,33,135,173,1.2485549132947977,0.03770901722553548,660,Just keeping my eggs warm and safe.
1957,3928,7,29,137,173,1.2485549132947977,0.039451193269242305,660,Only $1000 a month.
2091,3928,8,27,138,173,1.2485549132947977,0.04029404404490567,660,Stick around. The wife's coming back with some fresh squab.
2467,3928,5,33,135,173,1.2485549132947977,0.03770901722553548,660,Tell mom I’m working on a new science project...
4809,3928,9,25,139,173,1.2485549132947977,0.04111962208749598,660,Please let me know when you are going to the bathroom.
3418,3935,4,34,131,169,1.2485207100591715,0.03732861190680791,660,I want to live in Manhattan but I don't want it to take all my money.
3383,3935,8,26,135,169,1.2485207100591715,0.040929143399634264,660,I'm Australian
4094,3935,8,26,135,169,1.2485207100591715,0.040929143399634264,660,Just practicing.
1069,3935,5,32,132,169,1.2485207100591715,0.038260523323966275,660,"My father always said I was a slow learner. I guess he was right. However the owners won't be back until spring, and I can't afford the rent, anyway."
251,3935,5,32,132,169,1.2485207100591715,0.038260523323966275,660,Actually it was wintering in Cabo that clinched the deal.
1733,3935,7,28,134,169,1.2485207100591715,0.04005936096960533,660,"Go away! You’ll scare the birds from sitting on the bench, and it’s time for some hardcore revenge."
3419,3941,7,27,131,165,1.2484848484848485,0.04069432553230535,660,It's part of Ocasio-Cortez's plan to equalize the distribution of wealth. Everyone gets an identical nest!
4459,3941,6,29,130,165,1.2484848484848485,0.0397758507202781,660,Sitting on benches is for the birds
5616,3941,6,29,130,165,1.2484848484848485,0.0397758507202781,660,"The ad called it a ""one bedroom with den""."
4562,3944,6,28,127,161,1.2484472049689441,0.0404084886504948,660,"You go ahead and 
""empty nest"" your own way."
2960,3944,6,28,127,161,1.2484472049689441,0.0404084886504948,660,"I came for the view, stayed for the 4G."
4589,3944,7,26,128,161,1.2484472049689441,0.04135801864898707,660,"I’m thirty. Come on up, it’s time for us to make a baby."
1131,3944,6,28,127,161,1.2484472049689441,0.0404084886504948,660,The moment I realized where she was getting her eggs for breakfast every morning.
524,3944,6,28,127,161,1.2484472049689441,0.0404084886504948,660,i'm going to have a baby
2450,3944,5,30,126,161,1.2484472049689441,0.039436102792547494,660,"I was seeking a new perspective on life... besides, my mom won’t look for me up here."
2694,3950,8,23,126,157,1.2484076433121019,0.04301252903945452,660,My parents wanted to be empty nesters.
2922,3950,5,29,123,157,1.2484076433121019,0.040063695565756244,660,"It's got a great view plus it's close to the park, but it's a real climb and the landlord is a hawk about guests."
4133,3950,6,27,124,157,1.2484076433121019,0.04107017189778616,660,Sanctuary!
937,3953,8,22,123,153,1.2483660130718954,0.043773903246154315,660,Hugging doesn't do it for me. I have to sleep with them.
4115,3953,1,36,116,153,1.2483660130718954,0.03625133682176633,660,Winter house-sitting. It's sure cheaper than the 7 floor walk up.
4197,3953,9,20,124,153,1.2483660130718954,0.044745434598506065,660,My therapist calls it 'nesting.'
4844,3956,5,27,117,149,1.2483221476510067,0.0414086712909991,660,Turns out - I'm a stork!
4584,3957,5,39,154,198,1.2474747474747474,0.03466562885729341,660,How do you think Airb&b got started?
3566,3958,4,40,150,194,1.2474226804123711,0.03432863206479928,660,I think devolving is the way to save the planet.
166,3959,4,39,147,190,1.2473684210526317,0.034754052595821,660,"Well yeah, I'm getting a little tired of begging for popcorn"""
4968,3960,9,28,149,186,1.2473118279569892,0.0391064300552299,660,How do you like my new She Shed?
2952,3961,7,31,144,182,1.2472527472527473,0.038121780954712484,660,Sandra don't you think just because you're a Vegan you've gone to far this time?
3057,3961,8,29,145,182,1.2472527472527473,0.03890993383512966,660,Not every migrant goes to Central America.  I drove south from Hudson
2088,3961,6,33,143,182,1.2472527472527473,0.03731698561331007,660,Cheaper than an apartment in the city.
2749,3961,9,27,146,182,1.2472527472527473,0.03968243589989476,660,I'm moving back home so you don't have to be an emptynester!
3945,3965,7,30,141,178,1.247191011235955,0.038674310119759324,660,Birding was supposed to be our thing.
1636,3965,7,30,141,178,1.247191011235955,0.038674310119759324,660,.....and I have some falcon feeding me squirrels.
625,3965,7,30,141,178,1.247191011235955,0.038674310119759324,660,I had to pay the asking price but it's so worth it.
514,3968,3,37,134,174,1.2471264367816093,0.03570412450437399,660,I'm subletting for the winter.
2118,3968,5,33,136,174,1.2471264367816093,0.0375188758191713,660,"It is minimalist, but I should have 5G by summer."
5676,3968,5,33,136,174,1.2471264367816093,0.0375188758191713,660,I just love an Up-in-the-Air B & B.
2276,3971,4,34,132,170,1.2470588235294118,0.03713716656775238,660,It helps that my spirit animal is a bird.
3230,3971,8,26,136,170,1.2470588235294118,0.04071392535457735,660,So which is it Dad. Leave the nest or leave the nest?
3492,3971,8,26,136,170,1.2470588235294118,0.04071392535457735,660,..and at first I thought nesting was just for the birds!
4749,3971,9,24,137,170,1.2470588235294118,0.04156004526047071,660,"Figuratively speaking, this is the incubator stage of my off-Wall Street hedge fund."
3512,3975,4,33,129,166,1.2469879518072289,0.03767304916858206,660,Did you go through a broker for that nest?
5722,3975,3,35,128,166,1.2469879518072289,0.03669113358197887,660,You wanted to change things up a bit....
2301,3977,5,30,127,162,1.2469135802469136,0.03922190882232042,660,He's a great hugger.
2179,3977,5,30,127,162,1.2469135802469136,0.03922190882232042,660,"You do the 401K, I do the nest egg."
1425,3977,7,26,129,162,1.2469135802469136,0.041130531286010255,660,"This is the deluxe, bachelor, loft unit. It doesn't come with an ensuite bathroom; however, you do have unlimited access to a nearby bird bath and the park fountain!"
875,3977,4,32,126,162,1.2469135802469136,0.03823188323330268,660,I’m keeping her nest warm
1515,3977,5,30,127,162,1.2469135802469136,0.03922190882232042,660,No rent and the Robins feed me for free
250,3982,4,31,123,158,1.2468354430379747,0.03881530810456615,660,Just waiting for supper. Any minute now...
3388,3983,8,22,124,154,1.2467532467532467,0.043518622403021276,660,"Remember when you said my calcium boycott would hollow out my bones? Doesn't seem so stupid now, does it Lyle?"
4455,3983,5,28,121,154,1.2467532467532467,0.040487321254757055,660,Tapas arrive every two hours!
1163,3985,5,27,118,150,1.2466666666666666,0.04116498878012371,660,"Good news Dad,I've been adopted by a loving couple,The Humming Birds."
1763,3986,3,29,110,142,1.2464788732394365,0.040210488682567457,660,"The Nesting Material?
Pottery Barn on Broadway."
4322,3987,3,42,150,195,1.2461538461538462,0.03339326441025068,660,Would you like someone who is ready for nesting?
3521,3988,6,34,147,187,1.2459893048128343,0.036636083755378426,660,Winter was comin' and this was the only thing I could afford south of this wall.
547,3988,4,38,145,187,1.2459893048128343,0.0350314233281476,660,"Hey, don't look at me like that.  You know how crazy rent prices have been getting lately.  Might as well take advantage of these folks' space while they're gone south for the winter!"
172,3988,8,30,149,187,1.2459893048128343,0.038173349937702904,660,Do you think we can repaint the branches in lavender?
5,3988,7,32,148,187,1.2459893048128343,0.03741261337034227,660,"I'll still do the pregnancy test if you want, but..."
288,3992,7,31,145,183,1.2459016393442623,0.03793696009826397,660,You can't beat the rent!
5226,3992,7,31,145,183,1.2459016393442623,0.03793696009826397,660,"Until the birds return in the spring, I've got the cheapest condo in Manhattan."
3,3994,8,28,143,179,1.2458100558659218,0.039289543678694624,660,I found this great place on the nesting site.
995,3995,6,31,138,175,1.2457142857142858,0.03820018385356495,660,I'm nest sitting while birds are vacationing in the south.
2717,3995,9,25,141,175,1.2457142857142858,0.040697645895328316,660,Is it really as comfy as it looks?
4692,3995,5,33,137,175,1.2457142857142858,0.037330585335008805,660,I’m investing; sitting on my nest egg.
3666,3998,6,30,135,171,1.2456140350877194,0.0387649947801712,660,"Honey,when they say on the nest,it's just a euphemism."
3823,3998,6,30,135,171,1.2456140350877194,0.0387649947801712,660,"Yeah, it's a pretty good deal, but when they hatch, they get all the worms."
2921,3998,7,28,136,171,1.2456140350877194,0.03964245539710051,660,It’s vegan and gluten free.
3059,3998,9,24,138,171,1.2456140350877194,0.04134154289718648,660,I always dreamed of a treehouse to get away from it all.
382,4002,2,37,128,167,1.2455089820359282,0.035498720287811085,660,Remember all those birds I fed all winter? This is them paying it forward!
1051,4002,5,31,131,167,1.2455089820359282,0.038426471900896805,660,It's fine until dinner time.
1462,4002,7,27,133,167,1.2455089820359282,0.04026019717457744,660,"I'm supposed to be a bird, but my disguise got lost--I'm in the witness protection program."
2999,4002,5,31,131,167,1.2455089820359282,0.038426471900896805,660,"Airy, great view of the park and the price was a steal!"
3507,4002,4,33,130,167,1.2455089820359282,0.03747597731691185,660,"It's not gentrification, it's ""revitalization."""
3908,4002,8,25,134,167,1.2455089820359282,0.0411464256458392,660,"It's great! No rent. Great views. Spring is rough, but mom says I've never been great at chewing my food anyway."
4248,4002,5,31,131,167,1.2455089820359282,0.038426471900896805,660,I told you I wanted to start nesting.
5717,4002,6,29,132,167,1.2455089820359282,0.03935401643597681,660,I’ll give you three guesses.
4510,4010,6,28,129,163,1.2453987730061349,0.039968957639452074,660,These NYC prices finally made me fly the co-op.
3743,4010,7,26,130,163,1.2453987730061349,0.04090547563374914,660,"I have made my own nest and I'm lying in it."""
2206,4010,8,24,131,163,1.2453987730061349,0.04182102699435029,660,"As I recall John Mulaney saying, ""If one is wet, one feels like a bird."""
1505,4010,5,30,128,163,1.2453987730061349,0.03900996299338649,660,When's spring coming?
2869,4010,6,28,129,163,1.2453987730061349,0.039968957639452074,660,"I'm a flippin' bird, who the hell are you."
3558,4015,9,33,166,208,1.2451923076923077,0.0362233744616356,660,"You give new meaning to ""failure to launch."""
3579,4016,5,28,122,155,1.2451612903225806,0.04025675397735821,660,I've got some timeshares in your price range I can show you right now.
5648,4017,6,38,160,204,1.2450980392156863,0.03465868196380755,660,It’s too big for them anyway.
2630,4018,4,29,118,151,1.2450331125827814,0.03983064304201867,660,...and it's easy to build. Just trust your instincts.
4840,4019,6,37,157,200,1.245,0.03508603925714285,660,You said you wanted to be an empty nester.
4125,4020,10,28,158,196,1.2448979591836735,0.03836155695203179,660,This flying South for the Winter is for the birds.
1368,4020,4,28,115,147,1.2448979591836735,0.040488855009644,660,"I figure it'll cost an arm and a leg for park views like this in a building uptown. Plus,utilities are included."
5176,4022,12,23,157,192,1.2447916666666667,0.040278396805236885,660,How many eggs did you lay ?
5282,4022,8,31,153,192,1.2447916666666667,0.037472645515630225,660,It's my empty nest empathy project for extra credit.
2855,4022,6,35,151,192,1.2447916666666667,0.03598783292044777,660,Now we dont need to save for our nest egg!
3343,4025,5,25,113,143,1.2447552447552448,0.04235831268917647,660,And I have suet for breakfast.
5656,4026,5,36,147,188,1.2446808510638299,0.035675574827818135,660,Being an empty nester definitely has its perks.
1201,4026,8,30,150,188,1.2446808510638299,0.03799229552949094,660,"Hey Sammy, I'm wearing Patagonia and you're not!
Take a seat on that frozen metal bench and wait until I take my nap."
2120,4026,7,32,149,188,1.2446808510638299,0.03723607425824051,660,"I'm determined to meet a real fireman, Stanley."
2597,4026,4,38,146,188,1.2446808510638299,0.034869146044322265,660,...and these big brown birds with white heads bring me food!
1867,4030,5,35,144,184,1.2445652173913044,0.03614640070213289,660,Free rent and daily meals! What's to complain about?
2012,4030,5,35,144,184,1.2445652173913044,0.03614640070213289,660,"No nesting instinct, eh?"
613,4030,5,35,144,184,1.2445652173913044,0.03614640070213289,660,"I know it doesn’t look like much, but I got a great deal through airbnb!"
1674,4030,4,37,143,184,1.2445652173913044,0.035315234000025786,660,I can't help it. It's spring. It's my nesting instinct.
3952,4034,4,36,140,180,1.2444444444444445,0.035778321396489246,660,"It's bigger thank our last place honey, and the rent is cheaper."
2391,4034,7,30,143,180,1.2444444444444445,0.0382924016123675,660,"The bench was full so I improvised."""
361,4034,7,30,143,180,1.2444444444444445,0.0382924016123675,660,I've gone back to my roots.
756,4034,4,36,140,180,1.2444444444444445,0.035778321396489246,660,"Who, me homeless?"
458,4038,6,31,139,176,1.2443181818181819,0.03800816649338537,660,"It's AirBnB! Emphasis on the ""air,"" get it? Also the ""B""s could stand for ""Birds"" instead of bed or board, get it? Comedy is just math you guys."
1666,4038,5,33,138,176,1.2443181818181819,0.03714412006299028,660,This gives me the advantage of a bird's eye view.
2398,4038,6,31,139,176,1.2443181818181819,0.03800816649338537,660,"Oh, she'll come back"
1570,4041,8,26,138,172,1.244186046511628,0.040290065019390094,660,I fight normality
3484,4041,8,26,138,172,1.244186046511628,0.040290065019390094,660,"Thanks to the southern migration, I was able to find this reasonable treetop view in the city."
3851,4041,5,32,135,172,1.244186046511628,0.03767347835352644,660,You wouldn't believe what I save on heating costs.
4590,4044,6,29,133,168,1.244047619047619,0.03914635138842723,660,When Spring comes I won’t even have to buy curtains!
838,4044,3,35,130,168,1.244047619047619,0.03631224075621171,660,"Yes Graham, I'm feeling clucky. Get over it and get up here."
4961,4044,9,23,136,168,1.244047619047619,0.041788692553313446,660,Koo Koo Kachoo
2963,4047,8,35,166,209,1.244019138755981,0.03542522071210051,660,And my wife said I didn’t understand nesting.
5211,4048,4,32,128,164,1.2439024390243902,0.037823818822946144,660,Rent is a bargain but I have to share the place with a cuckoo!
4999,4048,5,30,129,164,1.2439024390243902,0.03880023156423543,660,It's just a phase!
5592,4048,5,30,129,164,1.2439024390243902,0.03880023156423543,660,It's the cheapest view property I could find.
3693,4048,6,28,130,164,1.2439024390243902,0.03975266869690043,660,Just building my retirement nest!
4277,4048,7,26,131,164,1.2439024390243902,0.04068281415552227,660,"The poop thing is a little gross, but I get all the worms I want and they say they are going to teach me how to fly!"
5754,4048,8,24,132,164,1.2439024390243902,0.04159216352511612,660,I don't know what everyone is talking about-being a mother of 5 is easy!
2141,4054,7,35,159,201,1.243781094527363,0.03563731287372383,660,And the monthly maintenance fee is only $2500!
5566,4055,9,21,130,160,1.24375,0.043207553606739245,660,"What do you think they'll do when you call the fire department and tell them that your 'pretty little bird' is up a tree?"""
5111,4055,4,31,125,160,1.24375,0.03839024521506676,660,One fly over the cuckoo's nest...the other one...
5399,4055,5,29,126,160,1.24375,0.03940085379625947,660,Not a problem!  I stayed at a Holiday Inn Express last night .
3421,4058,7,34,156,197,1.2436548223350254,0.03609462759896973,660,"I love Nest, but I haven’t figured out the thermostat function."
588,4059,7,24,125,156,1.2435897435897436,0.042044321480046803,660,"Newlywed Millennials out house-hunting: 
""Hunny, it's spacious, cozy and solar powered! I think we should make an offer."""
5262,4059,7,24,125,156,1.2435897435897436,0.042044321480046803,660,"Ya, I just got it! The ad said: 'Cozy  park side lair, 1 bedroom climb up. '"
3533,4061,5,27,120,152,1.243421052631579,0.040685900502249725,660,"I am that ""empty-nester"" you've often heard about."
673,4062,8,29,148,185,1.2432432432432432,0.038346422537792836,660,They said they would be back in a jiffy!
1740,4062,8,29,148,185,1.2432432432432432,0.038346422537792836,660,I'm waiting for the snow to melt so that my mate can join me.
3171,4062,7,22,119,148,1.2432432432432432,0.04353984510691705,660,It came with a free worm buffet voucher.
3430,4062,8,29,148,185,1.2432432432432432,0.038346422537792836,660,"The diet is high in carbs, but people are so much nicer to me."
2202,4066,5,34,142,181,1.2430939226519337,0.036457577036434485,660,"Come and get me, big boy."
1200,4066,5,34,142,181,1.2430939226519337,0.036457577036434485,660,"I've opted to take 'feather one's nest' to a new height."""
432,4066,6,32,143,181,1.2430939226519337,0.037289975564118956,660,Call me Kookaburra.
633,4066,6,32,143,181,1.2430939226519337,0.037289975564118956,660,"No, of course they’re not my eggs: they’re on loan from my girlfriend."
1147,4070,9,17,118,144,1.2430555555555556,0.04648328915979201,660,Yeah. It's my Airbnb.
2805,4071,5,33,139,177,1.2429378531073447,0.036959454733299986,660,Satisfying my nesting instinct.
2977,4071,3,37,137,177,1.2429378531073447,0.035179519942820404,660,A nut for your thoughts
3186,4071,5,33,139,177,1.2429378531073447,0.036959454733299986,660,Three meals a day. What can I say?
4049,4071,4,35,138,177,1.2429378531073447,0.03608046505791014,660,It’s better than you think.
4275,4071,4,35,138,177,1.2429378531073447,0.03608046505791014,660,"I promise! You're first in line when they hatch."""
4760,4071,6,31,140,177,1.2429378531073447,0.037818019905471345,660,“There’s more than one way to get up in the world.”
5272,4071,7,29,141,177,1.2429378531073447,0.03865752145389566,660,"I have a birdseye view of Central Park, and my home is outfitted with the newest technology in Nest products."
5040,4078,6,30,137,173,1.2427745664739884,0.038367806741707186,660,"The rent's only $2,000 a month, pretty good for this city!"
4884,4078,8,26,139,173,1.2427745664739884,0.04008135806606818,660,I didn’t like being an empty Nester
1936,4078,5,32,136,173,1.2427745664739884,0.03748166563859326,660,I can't help it. I like worms.
3253,4078,6,30,137,173,1.2427745664739884,0.038367806741707186,660,"Yesiree, I am sitting in the catbird seat!"
3721,4078,8,26,139,173,1.2427745664739884,0.04008135806606818,660,I know Im early for our meeting but Im waiting to catch a worm.
2791,4083,8,25,136,169,1.242603550295858,0.04070960047445818,660,Mom said I needed to find my niche. This is the best I could do.
4481,4083,5,31,133,169,1.242603550295858,0.03802557608223639,660,"Empty nester, you know?"
4934,4083,7,27,135,169,1.242603550295858,0.03983502469756131,660,The HOA fees really are bird feed.
104,4086,9,31,162,202,1.2425742574257426,0.036843145939810786,660,"... and then I told her, I've got my own nest egg."
4674,4086,9,31,162,202,1.2425742574257426,0.036843145939810786,660,I love it! And it's the cheapest rent in the Heights!
2477,4088,7,26,132,165,1.2424242424242424,0.04046251004639518,660,"They were both so exhausted, I suggested a night at Birdland might do ‘em some good."
2640,4088,8,24,133,165,1.2424242424242424,0.04136574125120958,660,"I don't know why, but I love sitting on a porcupine in a tree this time of year."
640,4088,2,36,127,165,1.2424242424242424,0.03560429144383688,660,My parents are empty nesters.
269,4091,4,31,126,161,1.2422360248447204,0.038181079583507166,660,I warned her not to park under my tree.
2418,4091,5,29,127,161,1.2422360248447204,0.03918462185239131,660,How much for a dozen?
2774,4091,5,29,127,161,1.2422360248447204,0.03918462185239131,660,Do you want to be my wingman?
4957,4091,5,29,127,161,1.2422360248447204,0.03918462185239131,660,"Sure, it’s mostly regurgitated worms, but a free meal’s a free meal."
2096,4095,6,26,125,157,1.2420382165605095,0.04081610096642558,660,Couvez-moi. Un trésor est caché dedans.
2623,4095,9,20,128,157,1.2420382165605095,0.043714208789428735,660,Avoiding that dreaded 'millenial failure to launch' moniker.
2037,4097,6,33,147,186,1.2419354838709677,0.036607401005316335,660,Birdman! The Musical” is having open auditions.
2817,4098,6,25,122,153,1.2418300653594772,0.041499814314480576,660,It’s a Real  ‘Air BnB!
1634,4099,5,34,143,182,1.2417582417582418,0.03628130191652918,660,Only place affordable working a 40 hour week......
1109,4099,6,32,144,182,1.2417582417582418,0.03710856554292327,660,"Yeah, it gets chilly at night, but the view is spectacular!"
3458,4101,8,20,121,149,1.2416107382550337,0.04431288780186817,660,"Say, I don't suppose you could spare a few eggs?!"
243,4102,10,23,145,178,1.2415730337078652,0.04086460029624646,660,"Sorry if I hit you, but they say it's good luck"
2256,4102,8,27,143,178,1.2415730337078652,0.03928047368902724,660,"Junior studio"" doesn't even begin to do it justice"
2397,4102,8,27,143,178,1.2415730337078652,0.03928047368902724,660,I think the mother is fully capable of keeping her own eggs warm.
4791,4102,4,35,139,178,1.2415730337078652,0.03590314366401795,660,"The view is amazing, but the rent is too damn high!"
3534,4106,7,28,139,174,1.2413793103448276,0.0390327496256229,660,Want to hear my warbler impression next?
1770,4106,7,28,139,174,1.2413793103448276,0.0390327496256229,660,You said AirBnB is fine.
3729,4106,3,36,135,174,1.2413793103448276,0.03546537002648428,660,Can you pick up some half-digested carrion that I can regurgitate to the little ones?
925,4106,4,34,136,174,1.2413793103448276,0.03639001565224627,660,An you toss me the remote?
1457,4106,4,34,136,174,1.2413793103448276,0.03639001565224627,660,Jennifer Eagle. What s yours?
3616,4111,8,32,159,199,1.2412060301507537,0.036475236598945915,660,"I even changed my Facebook status to 'In a symbiotic relationship.'"""
582,4112,7,27,136,170,1.2411764705882353,0.039625713500328376,660,"Tweet, tweet!"
2315,4112,6,29,135,170,1.2411764705882353,0.038737366019591844,660,"It's never too early to get started on a nest egg!
Peter Giessner, Peapack, NJ"
2341,4112,5,31,134,170,1.2411764705882353,0.037828162549369895,660,Now this is what I call a great “staycation”.
3984,4112,4,33,133,170,1.2411764705882353,0.03689656132469899,660,Look all you want; I'm never leaving the nest.
1303,4116,8,31,156,195,1.241025641025641,0.036958012080380014,660,Beats paying rent.
1095,4117,6,27,129,162,1.2407407407407407,0.03994240500744754,660,I knew I could only get coop approval if the Board were a bunch of  birdbrains.
5623,4118,7,31,149,187,1.2406417112299466,0.037214836055216645,660,Apartment prices are out of sight and this has a wonderful view.
5733,4119,3,32,123,158,1.240506329113924,0.03748780849078623,660,"Rent's a bit high, but the view's decent."
4386,4119,5,28,125,158,1.240506329113924,0.03958013511357382,660,Empty Nestor still?
3637,4119,6,26,126,158,1.240506329113924,0.04058586885471601,660,Millions are following on the internet. Eggs haven’t hatched.
3839,4119,4,30,124,158,1.240506329113924,0.03854817039141173,660,Keep walking or I might poop on you.
686,4123,4,36,143,183,1.2404371584699454,0.035265319194142025,660,I'm just waiting for the climate to change.
4997,4124,4,29,121,154,1.2402597402597402,0.03914803890931436,660,"This is great, Hal.  It's the time of year the empty nesters fly south."
727,4125,6,31,142,179,1.2402234636871508,0.03744323473843104,660,I'm waiting for my Timber Date.
1605,4125,7,29,143,179,1.2402234636871508,0.03827226837169604,660,Airbnb has really been great for the migrating bird community.
3139,4125,7,29,143,179,1.2402234636871508,0.03827226837169604,660,Never leaving the nest has become a literal statement.
5151,4128,5,32,138,175,1.24,0.037103680235630467,660,"ok, no more Marie Kondo, but can you at least nest at home?"
5607,4128,3,36,136,175,1.24,0.035289094590883675,660,Incubator and seed investment all in one place...who needs San Francisco?
2220,4128,3,36,136,175,1.24,0.035289094590883675,660,They call it ergonomic.
113,4128,6,30,139,175,1.24,0.037978474587846534,660,The agent said it's a Junior One.
5064,4128,6,30,139,175,1.24,0.037978474587846534,660,Range Free In vitro
1816,4133,4,33,134,171,1.239766081871345,0.036707262751988795,660,"Can you believe it? Only $800 a month and forget about the view."""
3027,4133,5,31,135,171,1.239766081871345,0.03763273293753654,660,I'm here every month to fight my empty nest syndrome.
5609,4133,3,35,133,171,1.239766081871345,0.03575784793774845,660,I'm sitting on my nest egg for awhile longer.
3856,4136,3,29,114,146,1.2397260273972603,0.03924752130074012,660,Home is where the nest is.
4580,4137,6,34,152,192,1.2395833333333333,0.035791949701952985,660,"Yeah, some call me bird-brained, but I don't let it get to me"
292,4138,6,28,133,167,1.2395209580838322,0.03911729012126524,660,Life in Boulder was hard. Aspen is much better.
573,4138,3,34,130,167,1.2395209580838322,0.03624538295773785,660,"There's a month to month option, but Id recommend leasing through spring to lock down your nest through high season."
231,4138,7,26,134,167,1.2395209580838322,0.04002883027673873,660,It's my answer to the empty nest syndrome
5107,4138,7,26,134,167,1.2395209580838322,0.04002883027673873,660,Squatter's Rights
4636,4142,7,31,150,188,1.2393617021276595,0.03703847997514851,660,My clock's ticking.  Sorry I couldn't find a more secluded tree.
4583,4143,6,27,130,163,1.2392638036809815,0.039724068941604546,660,she sufferers from empty-nest syndrome
763,4143,6,27,130,163,1.2392638036809815,0.039724068941604546,660,I can’t leave right now. I am keeping the children warm until my wife gets back.
567,4145,6,32,146,184,1.2391304347826086,0.036750856742374896,660,280 characters just wasn’t enough.
619,4145,8,28,148,184,1.2391304347826086,0.038332995366703516,660,Who says this place is for the birds?
4541,4145,3,38,143,184,1.2391304347826086,0.03424085100535377,660,I'm tree-steading.
744,4148,6,26,127,159,1.2389937106918238,0.040358160363694384,660,Feed me.
5369,4148,4,30,125,159,1.2389937106918238,0.03833481597897213,660,"So, how do you like being an Empty Nester?"
3313,4150,7,23,125,155,1.238709677419355,0.04203044258281022,660,Living my nest life.
1718,4151,8,26,142,176,1.2386363636363635,0.03946775468628014,660,It's the only affordable rent I could find in this neighborhood!
4006,4151,6,30,140,176,1.2386363636363635,0.037786684560917196,660,I prefer bagels over breadcrumbs.
2531,4153,5,26,120,151,1.2384105960264902,0.0406444870629624,660,"I used to be sad too, until I changed my perspective."
1263,4153,5,26,120,151,1.2384105960264902,0.0406444870629624,660,I like the bird’’s eye view
163,4155,7,27,138,172,1.2383720930232558,0.03921347983474019,660,Nest sitting - it's a thing.
904,4155,7,27,138,172,1.2383720930232558,0.03921347983474019,660,Call 911.  The pains are getting closer !!!
1759,4155,9,23,140,172,1.2383720930232558,0.040910828795788036,660,Dad told me to start growing my nest egg.
1909,4155,8,25,139,172,1.2383720930232558,0.04007114244383266,660,"I'm subletting from snowbirds, and they cut my rent in half because I'm egg sitting."
1695,4159,7,32,154,193,1.238341968911917,0.036377214628368806,660,"What's up, dog?"
3498,4160,7,26,135,168,1.2380952380952381,0.039815384519815186,660,"Sure, I have to build a new one every season; but it’s cheap!!!"
4585,4160,2,36,130,168,1.2380952380952381,0.035054740725216874,660,"I appreciate your kind offer, but the birds keep me very well fed."
4526,4160,8,29,152,189,1.2380952380952381,0.03761945374034264,660,I'm nesting.  Want to join me?
4141,4160,8,24,136,168,1.2380952380952381,0.04070074746107804,660,What’a a hammock?
3372,4160,5,30,133,168,1.2380952380952381,0.03798279670589456,660,I call it my paleo parlor.
4140,4160,7,26,135,168,1.2380952380952381,0.039815384519815186,660,Don't you know there's a flash flood warning in effect?
2207,4160,7,31,151,189,1.2380952380952381,0.03686374925847798,660,"At least rent up here is free!"""
2504,4160,6,28,134,168,1.2380952380952381,0.03890988107192088,660,...and its got a great view of the park!
2108,4160,5,25,117,147,1.2380952380952381,0.04133335136970877,660,"You can’t call me homeless, I’m in my treehouse"
1782,4160,7,31,151,189,1.2380952380952381,0.03686374925847798,660,"I used to live in the city, but I couldn't pass up this extra space."
1616,4160,4,37,148,189,1.2380952380952381,0.03449745118704287,660,"I think of it as a first stop, next month I was thinking of flying out to Poughkeepsie"
3485,4171,6,32,147,185,1.2378378378378379,0.036574511913540594,660,They said I couldn't sleep on the bench and that I could only go up from here.
4490,4171,8,28,149,185,1.2378378378378379,0.03814713272153898,660,I always get the nesting urge this time of year.
4701,4171,7,30,148,185,1.2378378378378379,0.03736909589880676,660,"Its like 1,250 dollars a month. New York City, I am right? Haha its ok though my parents are paying for it."
200,4174,5,29,130,164,1.2378048780487805,0.03854957192485364,660,You just have to be careful not to break the eggs.
2034,4174,5,29,130,164,1.2378048780487805,0.03854957192485364,660,"She said she'd be back soon, and that she could spare it if I want to scramble one"
5301,4174,7,25,132,164,1.2378048780487805,0.04044382392608217,660,"Do you have any seeds, literal or figurative, you'd like to throw out for me?"
3590,4177,4,35,142,181,1.2375690607734806,0.035381170224688674,660,"I usually sleep on the bench, but with global warming I'm safe up here if it floods."
1606,4177,2,39,140,181,1.2375690607734806,0.03360137643100843,660,It's not only for the birds!
1676,4179,4,30,126,160,1.2375,0.03812374340644888,660,"I envy the birds... they never have to pay rent. Fortunately for me, the Nestin Hotel is always vacant this time of year. Who're you calling bird-brained now, John?"
4457,4179,5,28,127,160,1.2375,0.03914123354624906,660,That's the beauty of this place - eagles fly south for the winter.
21,4181,6,30,141,177,1.2372881355932204,0.03759677561650712,660,It's an awesome sublet. They're chilling with my grandparents in Daytona Beach.
2236,4181,7,28,142,177,1.2372881355932204,0.0384411091430224,660,You know it’s really hard to find vacant spaces these days.
2900,4181,3,36,138,177,1.2372881355932204,0.03494157309845474,660,"The rent is only $2,000 a month!"
2927,4181,7,28,142,177,1.2372881355932204,0.0384411091430224,660,It's a timeshare and the viewscape during the off-season rates is fantastic.
4738,4181,5,32,140,177,1.2372881355932204,0.036733039642401065,660,"I mostly agree with your austerity theories dad, but that cheesy hat is going  way too far!"""
2089,4186,7,23,126,156,1.2371794871794872,0.041788173028505786,660,You are calling the FBI?  Who? Eliot Nest
2393,4186,7,23,126,156,1.2371794871794872,0.041788173028505786,660,Next year I’ll be an empty nester.
1966,4188,7,32,155,194,1.2371134020618557,0.03621006537693132,660,"The view is great, but fighting the squirrels for nuts is tedious"
5114,4189,3,35,135,173,1.2369942196531791,0.03539725061825401,660,And the best part is it’s rent stabilized.
4910,4189,4,33,136,173,1.2369942196531791,0.036334263257387964,660,I wanted a bird’s eye view
177,4189,5,31,137,173,1.2369942196531791,0.03724771162880831,660,It's helping with my fear of being an empty nester.
3675,4189,3,35,135,173,1.2369942196531791,0.03539725061825401,660,"Ok, I’ll take the bench but you’re overdoing it a bit with your aversion to being called an empty-nester."
1010,4193,3,30,119,152,1.236842105263158,0.038189281691081746,660,"So, you’re single, right? No eggs?"
919,4194,6,28,135,169,1.2366863905325445,0.03870460937766047,660,"I'm fine, thanks.  You can sit on that cold bench!"
1012,4194,6,28,135,169,1.2366863905325445,0.03870460937766047,660,"I lost my rent controlled apartment, now I have a better view of central park!"
1118,4194,8,24,137,169,1.2366863905325445,0.04048371948508011,660,"I just flew into town and, boy, are my arm tired."
2040,4194,6,28,135,169,1.2366863905325445,0.03870460937766047,660,"Welcome to the ""full-nest syndrome"".  Hi to Mom!"
3774,4194,6,28,135,169,1.2366863905325445,0.03870460937766047,660,"Tweet, tweet, tweet..."
2968,4199,7,30,149,186,1.2365591397849462,0.03718963313652715,660,I CALL IT 'OFF THE GRID IN GOTHAM'
5215,4200,11,17,137,165,1.2363636363636363,0.043744630409296006,660,Life's good! They give me all the worms I can eat.
2681,4200,1,37,127,165,1.2363636363636363,0.03427089712236893,660,I think I finally found my nest egg Jim
1096,4202,8,27,147,182,1.2362637362637363,0.038504880303622084,660,"I feel like a bird, hence I am a bird."
4068,4202,4,35,143,182,1.2362637362637363,0.03521043503871985,660,I missed interaction with people when I was working from home.
1000,4204,5,28,128,161,1.236024844720497,0.0389253226253006,660,"Empty nest syndrome, and it's all mine. Go."
1325,4204,8,22,131,161,1.236024844720497,0.041810285769677824,660,It's my first pregnancy.
3606,4204,5,28,128,161,1.236024844720497,0.0389253226253006,660,You missed your chance to cuddle--so there
5294,4204,9,20,132,161,1.236024844720497,0.042728675941279985,660,This solves my parent's empty nest syndrome .
3899,4208,8,26,144,178,1.2359550561797752,0.039068815724360335,660,"I'm nestling, not nesting. Take a chill pill."
700,4208,6,30,142,178,1.2359550561797752,0.03740872114850227,660,"Once I was pregnant, I started nesting"
3004,4208,6,30,142,178,1.2359550561797752,0.03740872114850227,660,I’m sitting in for my wife.
4033,4208,8,26,144,178,1.2359550561797752,0.039068815724360335,660,My doula said it was time for me to do some nesting!
933,4212,2,29,109,140,1.2357142857142858,0.03875067785862603,660,Haven’t you ever seen a pregnant woman nest?
1561,4213,5,27,125,157,1.2356687898089171,0.03953441204976719,660,"My broker told me when the market is down, protect my nest egg."
1692,4213,5,27,125,157,1.2356687898089171,0.03953441204976719,660,"Holden, that's not where the birds go in the winter."
2526,4213,1,35,121,157,1.2356687898089171,0.035161519688550844,660,Isn't it great? You and mom won't have to worry about an empty nest anymore!
2677,4213,3,31,123,157,1.2356687898089171,0.03741191122442908,660,I think Marie Kondo would be proud!
61,4217,7,27,140,174,1.235632183908046,0.03880955635321799,660,"The rent was only $500 a month, and more hygge than anything in Staten Island."
1330,4217,4,33,137,174,1.235632183908046,0.03615050981891911,660,"The zoning permit cost more than my townhouse, but I was looking for something more humble."
1468,4217,8,25,141,174,1.235632183908046,0.03965630381652937,660,I missed the low cost flights to the south.
1687,4217,7,27,140,174,1.235632183908046,0.03880955635321799,660,I wanted a real living room.
5149,4217,2,37,135,174,1.235632183908046,0.03426335978939032,660,Just keeping an eye on my nest egg.
4873,4222,6,32,149,187,1.2352941176470589,0.03622672918929965,660,I’m the 3 Eyed Raven....deal with it!
3576,4222,6,28,136,170,1.2352941176470589,0.03850144323290976,660,Did you see me on 'Planet Earth'?
3252,4222,9,26,152,187,1.2352941176470589,0.03853412677819085,660,I haven’t shaved in a month
2824,4222,0,36,117,153,1.2352941176470589,0.034405744227388346,660,Have you seen the apartment rents in this city?
465,4222,4,32,134,170,1.2352941176470589,0.036648790463921416,660,I'm feathering my own bed.
1537,4222,7,22,124,153,1.2352941176470589,0.04225814027946561,660,I found that the change in perspective had a positive effect on my thinking.
1217,4222,5,30,135,170,1.2352941176470589,0.037586533316371365,660,My financial advisor said I need to work on my nest egg.
5247,4222,7,30,150,187,1.2352941176470589,0.03701184829243827,660,City living is for the birds.
2057,4222,7,30,150,187,1.2352941176470589,0.03701184829243827,660,I’ll be the decider of when the kids leave the nest.
3747,4231,6,31,146,183,1.2349726775956285,0.036714991463871485,660,"'I think nesting instinct is finally kicking in."""
3917,4232,8,23,135,166,1.2349397590361446,0.04090851662302249,660,Dad!  I’ll be flying off soon.  You’re on your own!!!!
2461,4232,6,27,133,166,1.2349397590361446,0.03908283551689334,660,Cuckoo!
454,4232,4,31,131,166,1.2349397590361446,0.03716758442224853,660,"Only three thousand a month, water included."
1061,4232,6,27,133,166,1.2349397590361446,0.03908283551689334,660,"I'm going to name the baby Robin, it should be hatched in 9 months."
5500,4236,9,32,172,213,1.2347417840375587,0.035298265572732204,660,I've always wanted to be in the catbird seat.
2431,4237,5,32,142,179,1.23463687150838,0.0363695399643473,660,Nesting instinct meets resting instinct.
2724,4237,4,34,141,179,1.23463687150838,0.03549609469477424,660,It’s the best spot for a Birdseye view!
3938,4237,6,30,143,179,1.23463687150838,0.03722249502459677,660,You SAID you couldn’t handle the empty nest.
4513,4237,5,32,142,179,1.23463687150838,0.0363695399643473,660,It was just so empty!
4933,4237,9,24,146,179,1.23463687150838,0.03967147882005105,660,It's comfortable.  Birds of a feather.  Go away.
5695,4237,7,28,144,179,1.23463687150838,0.03805633763900577,660,I don't see why the sharing economy needs to stay within one species
5179,4243,6,26,130,162,1.2345679012345678,0.039689781138555175,660,Must have moved here from Berkeley
408,4243,6,26,130,162,1.2345679012345678,0.039689781138555175,660,I'm leaning into the nesting phase.
5254,4245,4,33,138,175,1.2342857142857142,0.03596855300212749,660,It's the trendiest bnb in the city!
1199,4245,5,31,139,175,1.2342857142857142,0.03687028953044232,660,"Squirrels.  Yeah, definitely squirrels."
1664,4245,8,25,142,175,1.2342857142857142,0.03945202890896758,660,I'm waiting for the spring blossoms to engulf me.
1882,4245,5,31,139,175,1.2342857142857142,0.03687028953044232,660,"Buddy, you seem confused. I think you need some nest."
3779,4245,6,29,140,175,1.2342857142857142,0.037750492646460056,660,Nesting is really ’in’ this season.
4045,4245,6,29,140,175,1.2342857142857142,0.037750492646460056,660,Why?  It's free-range and park-raised.
4143,4245,7,27,141,175,1.2342857142857142,0.03861063506395905,660,"$1700 per month, utilities extra."
4422,4245,6,29,140,175,1.2342857142857142,0.037750492646460056,660,With junior leaving I thought “we” were going to be empty nester’s?
4542,4245,4,33,138,175,1.2342857142857142,0.03596855300212749,660,It's a little tight but includes board & the rent is month to month.
5725,4245,4,33,138,175,1.2342857142857142,0.03596855300212749,660,"I'm eating well and planning to live to 100, so I figured I'd better start taking my nest egg seriously."
4327,4255,6,25,127,158,1.2341772151898733,0.040324133704382245,660,I've tidied up!
2240,4256,4,36,148,188,1.2340425531914894,0.034441287557874053,660,We've had some empty nest syndrome since the kids went to college.
2567,4256,5,34,149,188,1.2340425531914894,0.03525750391163767,660,"Once the Doctor told me I couldn't have coffee any more, I replaced it with a morning worm or two."
3599,4256,7,30,151,188,1.2340425531914894,0.03683571865661232,660,It really was more drag and drop.
535,4259,8,24,139,171,1.2339181286549707,0.04005640796232496,660,"This apartment with a skyline view is ""cheep-cheep"". I'll take it!"
3431,4259,6,28,137,171,1.2339181286549707,0.038300351429659284,660,"Hey, I'll have a great view of the Easter parade.  And by then my chicks will have hatched!"
799,4261,5,26,123,154,1.2337662337662338,0.039939058695599196,660,"Yep, she flies in and feeds me raw fish. Plus, she’s good company.”

Don Dechman
Austin, T"
1974,4262,4,35,145,184,1.233695652173913,0.03487371872793657,660,"Trust me, it's good luck."
5237,4262,4,35,145,184,1.233695652173913,0.03487371872793657,660,"We don't get health insurance because we're not ""employees"", but I really like the flexible working hours."
4246,4264,4,31,132,167,1.2335329341317365,0.03697112960463775,660,Just trying to put together a nest egg for us!
3221,4264,4,31,132,167,1.2335329341317365,0.03697112960463775,660,It’s my nest egg to insure I don’t get caught in another 2008 housing crisis.
3219,4264,6,27,134,167,1.2335329341317365,0.03887356631476411,660,"As part of my fledgling career, I get to poop on people's shoulders..."
2192,4264,7,25,135,167,1.2335329341317365,0.039790690178998944,660,Don’t look so surprised they are hottest new accommodation at Air B and B
939,4264,9,21,137,167,1.2335329341317365,0.041564272623330296,660,"How did my eggs get here, you may ask."
3034,4264,5,29,133,167,1.2335329341317365,0.037934275940574406,660,I'm thinking about listing it on Airbnb.
690,4270,6,34,157,197,1.233502538071066,0.03498489530987366,660,"Yup, see you at the reunion!"
1591,4270,8,30,159,197,1.233502538071066,0.03643538990089389,660,I am getting in touch with my inner bird.
2584,4272,7,28,145,180,1.2333333333333334,0.03786676633343822,660,"Nesting Doll, well thank you.
Your pretty cute yourself."
1188,4272,4,41,165,210,1.2333333333333334,0.03222113536977482,660,"Perching, you?"
2050,4272,6,30,144,180,1.2333333333333334,0.03703807157669554,660,I like the view and it's cheap!
3269,4272,9,24,147,180,1.2333333333333334,0.03947199621773374,660,My favorite sparrow died. I'm trying to notify her nest of kin.
5586,4276,9,27,157,193,1.233160621761658,0.03764285255627044,660,"Would you please call the Cornell Laboratory of Ornithology -- 
I need to talk to them."
2949,4276,6,33,154,193,1.233160621761658,0.03542692831911229,660,This is what I call a high rent district
2565,4278,5,28,130,163,1.2331288343558282,0.03850039876330727,660,"There's very little overhead, which is nice, but it does get uncomfortable when it rains."
3572,4278,5,28,130,163,1.2331288343558282,0.03850039876330727,660,It's complicated  but I do feel better for now.
4600,4278,7,24,132,163,1.2331288343558282,0.040419814806744635,660,Wanna come up for a drink?
4651,4278,7,24,132,163,1.2331288343558282,0.040419814806744635,660,And this one's under rent control!
4877,4278,5,28,130,163,1.2331288343558282,0.03850039876330727,660,"The rent is so good, I don't even care that I'm a side chick"
5460,4278,5,28,130,163,1.2331288343558282,0.03850039876330727,660,Real estate has been easy to come by every since everybody moved South for the winter.
4753,4284,3,35,138,176,1.2329545454545454,0.034869358984441226,660,"It displaced a family of squirrels but, hey, it beats a subway grate."
2415,4284,5,31,140,176,1.2329545454545454,0.03668436078025569,660,You can't beat the winter views and the summer privacy.
5170,4284,6,29,141,176,1.2329545454545454,0.03755898548671179,660,Just think how much we’d save on central heating!
1397,4287,6,32,151,189,1.2328042328042328,0.03588534382605963,660,And then the IPO finally came! I just joined a bit too late.
773,4288,5,27,127,159,1.2327044025157232,0.03909143333640367,660,"I'm feeling the nest, not the egg."
1117,4288,5,27,127,159,1.2327044025157232,0.03909143333640367,660,What brings you to my neck of the woods?
2874,4288,7,23,129,159,1.2327044025157232,0.041077526119455005,660,"Is that a squirrel in your pocket?  Or are you just happy to see me?"""
5075,4288,7,23,129,159,1.2327044025157232,0.041077526119455005,660,My apartment is too small for my nesting phase.
5414,4292,7,26,139,172,1.2325581395348837,0.03898344228723751,660,I've heard it's a good idea to have a nest egg!
2905,4293,3,37,145,185,1.2324324324324325,0.03385069754101212,660,I’m keeping her eggs warm
1866,4293,8,27,150,185,1.2324324324324325,0.03794261136131186,660,My broker said I needed a larger nest egg.  I literally took her literally.
1003,4293,6,31,148,185,1.2324324324324325,0.03636114607317218,660,Do I ruffle your feathers?
934,4293,8,27,150,185,1.2324324324324325,0.03794261136131186,660,"Damn bro, you’ll really do ANYTHING to get laid, won’t you?"
1230,4297,8,30,160,198,1.2323232323232323,0.03627008310155769,660,My parents' empty nest is being retrofitted for a Peloton studio.
4647,4297,7,32,159,198,1.2323232323232323,0.03555621978282577,660,I've been feeling kind of broody lately.
4891,4299,3,30,122,155,1.232258064516129,0.03753992968556,660,"Richard, pregnancy is not a prerequisite."
5098,4299,4,28,123,155,1.232258064516129,0.038639791683679696,660,The view is great but utilities aren't included.
5329,4301,4,31,133,168,1.2321428571428572,0.03677668477107789,660,"I figure if I can act like one of them, at least I'll get a free meal out of it."
1701,4301,4,31,133,168,1.2321428571428572,0.03677668477107789,660,All the trees behind me are available for micro housing development
3013,4301,8,23,137,168,1.2321428571428572,0.040468117580017,660,Why did you leaf me?
644,4301,7,25,136,168,1.2321428571428572,0.03957755097325211,660,I love it here. The house has such great phloem.
1380,4301,9,21,138,168,1.2321428571428572,0.04133950338235563,660,The early bird gets the nest!
1149,4306,6,30,145,181,1.2320441988950277,0.03685542559150922,660,It’s cheaper than what my landlord was charging.
2854,4306,5,32,144,181,1.2320441988950277,0.036012984343514756,660,Wonder if he has any spare nests for rent.
3116,4306,3,36,142,181,1.2320441988950277,0.03426602300991715,660,"Can’t complain, the rent is free all winter"
4218,4306,4,34,143,181,1.2320441988950277,0.035150358278703296,660,"What's the matter, you never saw the first Robyn of spring before?"
5756,4306,5,32,144,181,1.2320441988950277,0.036012984343514756,660,This is my nest egg
3769,4311,5,35,154,194,1.231958762886598,0.03449865109319827,660,"We couldn't afford a man-cave, so we settled for a man-nest."
4098,4312,4,30,130,164,1.2317073170731707,0.037301583388225264,660,It really is better than a grate.I got the idea at Home Depot in the thermostat department.
4671,4312,4,30,130,164,1.2317073170731707,0.037301583388225264,660,Being homeless is much cozier than I had imagined
326,4312,8,22,134,164,1.2317073170731707,0.04111781754443769,660,I knew that wasn't pigeon poop
2266,4312,5,28,131,164,1.2317073170731707,0.03829131523408356,660,I just hope somebody parks a Skylark or a Falcon by the curb.
1020,4316,5,31,141,177,1.231638418079096,0.03650025190527588,660,"Everyone was right, I can't deal with being an empty nester after Junior went off to college."
2622,4316,6,29,142,177,1.231638418079096,0.037369368800347316,660,I'm waiting for the stork to bring me a baby.
133,4316,4,33,140,177,1.231638418079096,0.035609929145686586,660,It's pre-warbler.
2989,4316,6,29,142,177,1.231638418079096,0.037369368800347316,660,Yes I’m pregnant. My bird brained husband  insisted  on natural birth.
5390,4320,5,34,151,190,1.231578947368421,0.034928628473575904,660,I've ordered a small pizza and a large birdseed.
130,4320,5,34,151,190,1.231578947368421,0.034928628473575904,660,It was the cheapest rent I could find in the city.
3173,4322,6,25,129,160,1.23125,0.039871920535256525,660,I'm thinking about renovating and renting it out next Spring
3915,4322,7,23,130,160,1.23125,0.04084588595404767,660,Look who's sitting in the catbird seat now.
2512,4322,3,31,126,160,1.23125,0.03679566537740604,660,"Thanks to the housing crisis, I can now afford a beautiful home."
2988,4322,3,31,126,160,1.23125,0.03679566537740604,660,No kitchen or bathroom but it's rent free.
5188,4326,3,34,136,173,1.23121387283237,0.035143898438890285,660,I told you the mother wouldn't attack me if I started chirping. Don't know I am going to do when its feeding time.
3523,4326,5,30,138,173,1.23121387283237,0.037007029977213966,660,"Mortgage, insurance, and utility bills are for the birds."
548,4326,6,28,139,173,1.23121387283237,0.037904268926601155,660,"The bench was bolted down, otherwise I would be more comfortable."
3695,4329,5,33,148,186,1.2311827956989247,0.035374502310086556,660,"I said meet me by the park bench, not ON it!"
4879,4329,5,33,148,186,1.2311827956989247,0.035374502310086556,660,As good as memory foam and a down pillow!
5086,4329,4,35,147,186,1.2311827956989247,0.034543201573081196,660,Those birds really have it figured out!
2914,4332,5,29,135,169,1.2307692307692308,0.037534618190328196,660,"Well, it worked for Horton!”
Ivor Hanson 
Scarsdale, New York"
2836,4332,8,23,138,169,1.2307692307692308,0.0402513937286372,660,Can I join you?
2280,4332,7,25,137,169,1.2307692307692308,0.039366639670704535,660,You know this is supposed to be the Male's job!
2800,4332,7,28,147,182,1.2307692307692308,0.03749312053453334,660,Mother told you I was a nester!
655,4332,1,37,131,169,1.2307692307692308,0.0335719831132296,660,Bet my current landlord that he had to renovate my kitchen if I survived this nest for a week.
551,4332,6,30,146,182,1.2307692307692308,0.036674532301339,660,"Hey Mister, you interested in renting my AirBnB
Fresh Air, birch and birds!"
230,4332,4,28,124,156,1.2307692307692308,0.038420159709954986,660,You still believed that a STORK brought babies?
2147,4332,4,37,154,195,1.2307692307692308,0.03356332942495252,660,"You call it small. I call it cozy. TomAYto, tomAHto."
1681,4340,4,33,141,178,1.2303370786516854,0.035433213143065,660,Penthouse is way better than ground floor.
1039,4341,5,28,132,165,1.2303030303030302,0.03808443805020087,660,I just had the nesting instinct!!!
3237,4341,6,26,133,165,1.2303030303030302,0.03904272341431856,660,"You just missed her, mister."
3703,4341,9,20,136,165,1.2303030303030302,0.04178592755496941,660,I hear there's a nesting mother cam.
5274,4341,8,22,135,165,1.2303030303030302,0.04089197857308644,660,"You have stocks and bonds, I'm happy with my nest egg.""

Cal Bellamy, Munster, I"
5652,4341,6,26,133,165,1.2303030303030302,0.03904272341431856,660,Welcome to my humble abode!
3956,4346,5,25,122,152,1.230263157894737,0.04011832744092849,660,"When you said you were a tad squirrely, I  thought it was just your affinity for wines in a box."
5518,4347,6,34,160,200,1.23,0.034517492470226764,660,Subleasing -- $4000 a month till April.
5521,4348,2,39,146,187,1.2299465240641712,0.03266492433908435,660,I was able to lower my rent
1104,4349,6,28,140,174,1.2298850574712643,0.03770921868430573,660,"No, it isn't really comfortable but it's rent-controlled and the robins bring me all the worms I can eat!"
1809,4349,6,28,140,174,1.2298850574712643,0.03770921868430573,660,"Wanted to get out of the city but couldn't afford the Hamptons, so came up with this. Waddaya think?"
2615,4349,4,32,138,174,1.2298850574712643,0.03590408942822858,660,"Well, you do know that my last name is Bird"
3190,4349,4,32,138,174,1.2298850574712643,0.03590408942822858,660,"I'm with ""Free the Giving Tree""  movement."
716,4353,2,33,126,161,1.2298136645962734,0.03551795889564173,660,The nest was finally empty.
2495,4353,5,27,129,161,1.2298136645962734,0.03865804778789121,660,If you’re an empty nester ...
2865,4353,3,31,127,161,1.2298136645962734,0.03659460555417001,660,New York rent is for the birds
3762,4353,7,23,131,161,1.2298136645962734,0.040616796548675164,660,He accused me  of 'feathering my own nest'. So I bought a hat.
3342,4357,1,32,115,148,1.2297297297297298,0.03599579477721235,660,I've started a pro-squirrel Super PAC.
3620,4358,6,30,147,183,1.2295081967213115,0.036495367375049347,660,"What are you staring at, handsome? Never seen a woman’s nest eggs?"
2311,4358,5,32,146,183,1.2295081967213115,0.03566318268835112,660,You wouldn't understand.
909,4358,5,32,146,183,1.2295081967213115,0.03566318268835112,660,It works for the squirrels!
2157,4361,7,25,138,170,1.2294117647058824,0.03915792241867862,660,I found that this is better than being chained to the tree. Want to join me?
1451,4362,4,28,125,157,1.2292993630573248,0.038202948199056584,660,I was carried off by a large eagle. It's not a bad gig.
3210,4362,5,26,126,157,1.2292993630573248,0.039257159454396444,660,It’s super good luck to get pooped by a human.
5724,4362,7,22,128,157,1.2292993630573248,0.04128490284697449,660,Nestflix and chill?
5288,4365,8,31,166,205,1.2292682926829268,0.03533822037565795,660,I'm assisting in the Birth of Spring
5158,4366,6,32,154,192,1.2291666666666667,0.035384892327134605,660,"The rent  is only 5,000 dollars a month."
5090,4367,2,37,140,179,1.229050279329609,0.033430509645972245,660,It is said my ideas are for the birds.
3645,4367,4,33,142,179,1.229050279329609,0.03525819581976927,660,Not much storage space - but it's rent controlled!
3241,4367,4,33,142,179,1.229050279329609,0.03525819581976927,660,"""Why?... I have an open mortgage,
and a roof in the summer!"""
4689,4367,2,37,140,179,1.229050279329609,0.033430509645972245,660,"I didn’t fly south for the winter, and this tiny house was available cheap."
1022,4367,5,31,143,179,1.229050279329609,0.036137391592408426,660,It's called nesting.
521,4367,6,29,144,179,1.229050279329609,0.03699569934115244,660,"When you return with the worms, make sure they're well chewed."
2414,4367,5,31,143,179,1.229050279329609,0.036137391592408426,660,This is not what I've imagined when you said you have high standards.
935,4374,5,28,133,166,1.2289156626506024,0.03787973359952879,660,And my mother regurgitates food right into my mouth.
963,4374,6,26,134,166,1.2289156626506024,0.03883160526811961,660,It’s a low- tech way of freezing my eggs.
2399,4374,3,32,131,166,1.2289156626506024,0.035900355392610016,660,"Oh, I'm well aware. But imprinting is a force of nature."
5249,4374,6,26,134,166,1.2289156626506024,0.03883160526811961,660,It’s so cheap! My landlord only charges 100 worms a month.
5759,4374,3,32,131,166,1.2289156626506024,0.035900355392610016,660,"The landlord is rarely here and rent is dirt cheap"""
329,4379,4,27,122,153,1.2287581699346406,0.03879055189853624,660,"We’re expecting our first child, so I’m nesting."
1359,4379,4,27,122,153,1.2287581699346406,0.03879055189853624,660,"I’ll be down in a few months, see you later."
4697,4381,8,27,153,188,1.2287234042553192,0.03739623015544535,660,I told Linda I was visiting my parents.
2070,4381,5,33,150,188,1.2287234042553192,0.03504012199656435,660,At least the rent is cheap
3642,4381,6,31,151,188,1.2287234042553192,0.03584270418047568,660,I figured why not live in a nest while I’m building my nest egg.
402,4384,9,22,144,175,1.2285714285714286,0.040056258818238655,660,It's game addiction therapy - and it's working.
2011,4384,6,28,141,175,1.2285714285714286,0.03751612367420643,660,What do you think of our new tiny home?
4710,4384,7,26,142,175,1.2285714285714286,0.038381518736628206,660,It occurred to me while researching my ancestry online.
4320,4387,7,31,159,197,1.2284263959390862,0.035521893753602915,660,Çould you fetch me a worm?
1597,4388,7,23,132,162,1.228395061728395,0.04039021702110284,660,The Department of Homeland Security found it for me and sent me here.
2945,4388,5,27,130,162,1.228395061728395,0.038444858678485655,660,Got this idea from my folks when they said they were empty-nesters.
4012,4388,7,23,132,162,1.228395061728395,0.04039021702110284,660,I need my own space till the baby comes.
4863,4391,9,24,151,184,1.2282608695652173,0.03869340972303834,660,It’s only $900 a month! Plus the insulation cuts $50 off my PG&E bill.
4919,4392,3,33,135,171,1.2280701754385965,0.035242178090218075,660,They froze my rent.
5418,4392,9,21,141,171,1.2280701754385965,0.040679329077174635,660,"Plus, I can finally afford Coachella tickets."
1527,4392,5,29,137,171,1.2280701754385965,0.03714310185958428,660,"I see-another ""empty nester."""
1291,4392,6,27,138,171,1.2280701754385965,0.038057975055904594,660,"Honey, I just love Spring in New York!"
2457,4392,5,29,137,171,1.2280701754385965,0.03714310185958428,660,My wife said to find another outlet for my nesting instinct.
4210,4397,3,30,125,158,1.2278481012658229,0.036911671773559904,660,It's a side door for all the schools which have bird mascots.
2235,4398,6,29,145,180,1.2277777777777779,0.03681159402580952,660,I call it the Treehouse of the December Moon.
2673,4398,6,29,145,180,1.2277777777777779,0.03681159402580952,660,Nesting is a perfectly normal reaction to the rise of protofascism.
3772,4398,7,27,146,180,1.2277777777777779,0.03764527461915776,660,Sooo this is what’s like to have a bird’s eye view!
4237,4398,5,31,144,180,1.2277777777777779,0.03595859018774549,660,You have a better way to get a bird's-eye view?
5436,4398,7,27,146,180,1.2277777777777779,0.03764527461915776,660,28 more days and they can't kick me out. Squatters rights.
2326,4403,3,27,115,145,1.2275862068965517,0.03883458829086472,660,I got a great deal on a time share
5453,4404,6,26,135,167,1.2275449101796407,0.03862271254630513,660,I just tired of beating around the bush.
5353,4404,3,32,132,167,1.2275449101796407,0.035711053243447664,660,"Not only that, it's also rent-controlled."
4488,4404,2,34,131,167,1.2275449101796407,0.03468622863419477,660,Migrating from winter in Florida.
1398,4404,6,26,135,167,1.2275449101796407,0.03862271254630513,660,"Hey there, you with the sexy plumage.  Do you want to come up here to my love nest?"
4732,4404,5,28,134,167,1.2275449101796407,0.037677168916225585,660,"It's not a palace, but it's what I can afford."
1942,4409,6,31,152,189,1.2275132275132274,0.03567308884321607,660,"Yeah, but you're not a bird and you don't eat worms."
2205,4409,5,33,151,189,1.2275132275132274,0.03487523444059041,660,They said it's time to leave the nest and I said no thank you I like it just fine.
3455,4409,8,27,154,189,1.2275132275132274,0.037217520716400145,660,I'm looking forward to waking up a few birds.
4639,4409,8,27,154,189,1.2275132275132274,0.037217520716400145,660,"Honey, we are close to retirement, I’m feathering my nest."
4446,4413,6,23,125,154,1.2272727272727273,0.04070794374412261,660,C'mon up!
5011,4413,4,27,123,154,1.2272727272727273,0.03856645962786087,660,Oh Really!? This isn’t what ‘Sit on my crotch’ meant?
4700,4413,4,27,123,154,1.2272727272727273,0.03856645962786087,660,"All is well, just nesting."
3744,4413,6,23,125,154,1.2272727272727273,0.04070794374412261,660,"I should admit privacy is seasonal here, but certainly better than what you get through Airbnb."
2986,4413,7,26,143,176,1.2272727272727273,0.03818491020256925,660,"Even though our youngest left for college, I’m not quite ready to be an empty nester just yet."
2733,4413,6,23,125,154,1.2272727272727273,0.04070794374412261,660,"Wait, where does your family get their Easter eggs?"
1795,4413,4,27,123,154,1.2272727272727273,0.03856645962786087,660,"Rent control, rat control, and and nutty vegan neighbors!"
891,4413,5,30,141,176,1.2272727272727273,0.0364447148062397,660,"If she's more the adventurous type, I call it my aerie."
95,4413,3,34,139,176,1.2272727272727273,0.03461715048119959,660,"I’ll get you a weighted blanket, but I’m not climbing up there with it"
4890,4422,5,32,148,185,1.227027027027027,0.03531995141316013,660,"Alternative living, hmmm"
3374,4422,6,30,149,185,1.227027027027027,0.03614212741951539,660,And that's how I lost so much weight
5120,4422,7,28,150,185,1.227027027027027,0.03694601170612302,660,I'm Airbnb-ing from Woodstock.
1848,4422,5,32,148,185,1.227027027027027,0.03531995141316013,660,"... And it’s a bargain at only $2,750 a month!"
452,4422,5,32,148,185,1.227027027027027,0.03531995141316013,660,"I feel so motherly up here, I 'm getting this urge to fly down upon some unsuspecting rat and feed the kids with it."
2515,4422,3,36,146,185,1.227027027027027,0.03361532618712788,660,I'm sorry my nesting instincts are too literal for your refined tastes.
3922,4428,3,31,129,163,1.2269938650306749,0.03619882221500137,660,I'm colluding with the pigeons.
4966,4428,2,33,128,163,1.2269938650306749,0.0351370796696929,660,Normally this is my summer home
5147,4430,6,32,156,194,1.2268041237113403,0.03505877251071925,660,I’m in the catbird seat!
2100,4431,2,35,135,172,1.2267441860465116,0.034078261673374376,660,Latest fertility cure
4029,4431,5,29,138,172,1.2267441860465116,0.03695032187535087,660,Only $2000 per month. Heat and air conditioning included.
1312,4433,4,26,120,150,1.2266666666666666,0.039171128785758576,660,"I overheard you telling mom something about an empty nest, so......."
2435,4433,3,28,119,150,1.2266666666666666,0.03801173334297594,660,"It's a bit snug, but I couldn't do roommates anymore."
4497,4435,7,27,147,181,1.2265193370165746,0.03745785730305524,660,"I’m running for the Democratic nomination. My platform is twigs, not tweets."
2016,4435,5,31,145,181,1.2265193370165746,0.03578150870667671,660,"When I jump out, I'll know what it's like to be an empty-nester."
5736,4437,5,26,128,159,1.2264150943396226,0.03881507448550428,660,"It's only $3800 a month, honey, I think we better grab it."
5060,4437,1,34,124,159,1.2264150943396226,0.034469755202426566,660,It's not a bad life as long as I don't get up early.
1839,4437,7,22,130,159,1.2264150943396226,0.040814617468687135,660,Is there room up there?
3208,4437,5,26,128,159,1.2264150943396226,0.03881507448550428,660,You'll never believe what I found in here.
5094,4441,7,29,154,190,1.2263157894736842,0.0362808827350786,660,I like it up here...and I have WiFi too
3795,4442,6,26,136,168,1.2261904761904763,0.03841601120320939,660,Million dollar view!
5000,4443,10,25,164,199,1.2261306532663316,0.03730153498902985,660,"Take a picture, it'll last longer."
924,4444,7,26,144,177,1.2259887005649717,0.037990268863138686,660,I’m just waiting for the right raptor to come ravish me...!
1321,4444,6,28,143,177,1.2259887005649717,0.03713568624525187,660,"Hey babe, I'm no longer an empty nester."
3771,4444,4,32,141,177,1.2259887005649717,0.035364622465540854,660,"...and, there are no dishes to do, ever!"
2975,4447,4,34,148,186,1.2258064516129032,0.03431402287703608,660,Now that I’m an empty nester.
4832,4447,6,23,126,155,1.2258064516129032,0.040471029630601875,660,"Empty, shmempty!"
4558,4447,8,26,152,186,1.2258064516129032,0.03754920400057711,660,My tree hygge.
4449,4447,6,30,150,186,1.2258064516129032,0.03596800583214693,660,"You're wondering how I got up here, eh?"
4318,4447,5,32,149,186,1.2258064516129032,0.03515074401450922,660,"Not how, but when and...why?"
987,4447,3,29,123,155,1.2258064516129032,0.03723630886214331,660,No....I'm not sitting on 'your' nest egg!
2520,4447,6,30,150,186,1.2258064516129032,0.03596800583214693,660,I got tired of walking.
5410,4447,10,22,154,186,1.2258064516129032,0.03906645618190311,660,I'm living out my nesting instinct before it outlives me.
363,4447,4,27,124,155,1.2258064516129032,0.038344880730526554,660,If I just squat here a few more weeks the idiots who abandoned this place will have to take me to court when they get back and then I get get at least a few more month of rent free living while it goes through the court system.
4241,4447,7,28,151,186,1.2258064516129032,0.036767105982238465,660,I'm protesting empty nesters.
734,4457,5,27,132,164,1.225609756097561,0.038025306701429465,660,It's pretty small I agree but the view is great!
1587,4457,6,25,133,164,1.225609756097561,0.038996674843183914,660,Martha kicked me out. She said I just don't have that nesting instinct she's looking for.
405,4457,7,23,134,164,1.225609756097561,0.039944428246155295,660,"Ugh, Millennials."
610,4457,6,25,133,164,1.225609756097561,0.038996674843183914,660,"I had a dream that thousands of aardvarks will soon invade our city. Famously, aardvarks can't climb trees. Have you ever seen an aardvark? Maybe not, as aardvarks are nocturnal. I wonder what aardvark tastes like in soup. Burp! My name is Gary."
5649,4457,4,29,131,164,1.225609756097561,0.037028465410418245,660,"Hello Mary. Do you know that we, as mammals, do not lay eggs?"
2790,4462,4,38,162,204,1.2254901960784315,0.03245763087620262,660,My parents joined an empty-nesters group while I was in college... they're trying to get their dues back.
278,4463,5,29,139,173,1.2254335260115607,0.036759488536947216,660,My wife's OBGYN said that this is normal.
485,4463,5,29,139,173,1.2254335260115607,0.036759488536947216,660,"Yeah, but the bathroom's a lot more fun"
2951,4463,6,27,140,173,1.2254335260115607,0.03766262514248898,660,"That lawsuit against my parents didn't go so well--but, what the hell, it's Spring!"
3487,4463,5,29,139,173,1.2254335260115607,0.036759488536947216,660,Checked out rents and this is all I can afford
536,4467,4,33,145,182,1.2252747252747254,0.034743103563309716,660,"Found this gig on my side hustle app"""
2652,4467,8,25,149,182,1.2252747252747254,0.0380780030567678,660,I really hope you went to the bathroom before you climbed up there.
5447,4467,5,31,146,182,1.2252747252747254,0.03560612325297367,660,"If I get here early, sometimes I can hold this perch for days!"
360,4470,5,35,160,200,1.225,0.03357845384787796,660,They told me I need to have a birds eye view in life so I took it to a literal level!
3468,4470,6,24,130,160,1.225,0.03960298254443843,660,"Thanks for getting me into SC, Daddy. Now could you bring me a mouthful of worms?"
3517,4472,5,28,136,169,1.2248520710059172,0.037278330134802244,660,"This boutique bnb is so comfy, and only $75 a day!"
3082,4472,7,24,138,169,1.2248520710059172,0.03912235491261584,660,This is way better than your apartment which has no heat!
291,4472,3,32,134,169,1.2248520710059172,0.03533821078337065,660,I was raised by birds...OKAY?...though I haven't gotten the flying part down yet.
259,4472,4,30,135,169,1.2248520710059172,0.03632122684470638,660,"Free rent, pre-chewed food, a great view...SUCKERS!"
1204,4472,2,34,133,169,1.2248520710059172,0.034327055848634144,660,I;m actually a Toronto blue jay
4462,4477,6,28,144,178,1.2247191011235956,0.036948288573843725,660,I’m working on the premise that the early bird gets the worm.
5117,4477,4,32,142,178,1.2247191011235956,0.035188294707166556,660,My immigration lawyer arranged it:  amnesty.
5763,4479,8,26,153,187,1.2245989304812834,0.037367381859923283,660,Someone just left free eggs up here!
2760,4479,5,32,150,187,1.2245989304812834,0.03498311318711493,660,I'm testing the theory that there's someone for everyone.
3778,4479,5,32,150,187,1.2245989304812834,0.03498311318711493,660,"True, but my ex-wife didn't come with free eggs."
5277,4479,6,30,151,187,1.2245989304812834,0.03579551947562857,660,"The surveys say I'm squirrelly, so I'm going with it. And you know what? It sure beats politics!"
5037,4483,10,24,162,196,1.2244897959183674,0.037630793703236264,660,"Don’t worry honey, it’s getting near nesting season and I want to be ready"
257,4484,3,29,124,156,1.2243589743589745,0.0370251495560223,660,"Yes, my therapist suggested it to prepare me for our empty nest this Fall."
1786,4485,6,25,134,165,1.2242424242424241,0.03878372113711275,660,You're late!
2392,4485,5,27,133,165,1.2242424242424241,0.03781887353205983,660,""" I couldn't afford a park view"""
4704,4485,7,23,135,165,1.2242424242424241,0.039725141349637984,660,There are no pigeons now cause they're out gathering food for me.
5383,4485,5,27,133,165,1.2242424242424241,0.03781887353205983,660,They’ve been pelting my car for years so I finally decided to lay an egg of my own.
503,4489,6,27,141,174,1.2241379310344827,0.037467954411586055,660,Don't worry.  I swept  for hidden cams.
2702,4489,5,29,140,174,1.2241379310344827,0.03657057341269634,660,"When the neighbors moved south, I combined units."
3552,4489,6,27,141,174,1.2241379310344827,0.037467954411586055,660,It's Audobon's new hazing ritual.
4095,4489,4,31,139,174,1.2241379310344827,0.03565061109824253,660,I'm inspired!  Let's make some babies!
5069,4489,3,33,138,174,1.2241379310344827,0.03470627181969931,660,Rent has really skyrocketed in town.
5141,4489,8,23,143,174,1.2241379310344827,0.03920113702304116,660,These days I just fly by night
2872,4495,9,23,151,183,1.2240437158469946,0.038673668880689925,660,So my wife is pregnant but I got the nesting instinct!
1930,4496,4,26,122,152,1.2236842105263157,0.03871111921947651,660,I 'm not an empty nester.
2437,4496,3,28,121,152,1.2236842105263157,0.03756876861814674,660,'It's the cheep-est way to get a central park view...'
1513,4498,5,26,130,161,1.2236024844720497,0.03838263072766544,660,I got tired of the empty nest thing.
2201,4499,5,28,137,170,1.223529411764706,0.03708199321004141,660,All the worms I can eat.  Life is good!
2441,4499,7,24,139,170,1.223529411764706,0.03891402714932127,660,"You do know that’s a snake’s nest, right?"
2189,4501,4,32,143,179,1.223463687150838,0.03501367350130436,660,"Hi, my name is Robin. What a great nest I made! Don't you want to help me make some blue eggs?"
3185,4501,6,28,145,179,1.223463687150838,0.03676273560729254,660,"You know winter is coming, right?"
4864,4501,8,24,147,179,1.223463687150838,0.038432279747725694,660,All i need now are some eggs.
5222,4501,10,20,149,179,1.223463687150838,0.0400322560428862,660,"Wish I could join you, but the darlings wouldn't hatch."
5283,4501,7,26,146,179,1.223463687150838,0.03760677369795993,660,My wife is going through the nesting stage.
5640,4506,6,30,152,188,1.2234042553191489,0.03562464607261945,660,And then she told me it was the last straw. Not today Karen.
5357,4506,3,36,149,188,1.2234042553191489,0.03314283523620865,660,It's hard for me to fly south with them for the winter.
162,4506,7,28,153,188,1.2234042553191489,0.03641434746407487,660,"Okay, I'll come down,,, but you'll have to feed me a squirrel"
1308,4509,3,38,156,197,1.2233502538071066,0.03225549871832374,660,"It's $1500 a month, but I get free food."
1250,4510,1,31,116,148,1.222972972972973,0.035644650189662466,660,Birds lay their eggs here; why not me?
3299,4511,7,21,129,157,1.2229299363057324,0.04101314316595286,660,These new Port-A-Johns blend in so seamlessly.
3862,4511,8,19,130,157,1.2229299363057324,0.0419968716653878,660,"Let's have a baby, John!"
4478,4511,6,23,128,157,1.2229299363057324,0.040005232095600175,660,They said I’d experience “nesting behavior”; I wanted to see if I’d like it.
128,4514,9,19,138,166,1.2228915662650603,0.041315097460102194,660,I usually take a break at tree.
2708,4514,8,21,137,166,1.2228915662650603,0.040421750679676884,660,Nothing like a homeless's penthouse with a view.
4158,4516,3,33,139,175,1.2228571428571429,0.03453114128591891,660,It's cheaper than a crib.
2589,4516,2,35,138,175,1.2228571428571429,0.03356662439859426,660,"I would not sit on a tree that has met its demise and been slaughtered. But you do you, bro."
3488,4516,8,23,144,175,1.2228571428571429,0.03899752483770018,660,Horton the Elephant left to run H.U.D.
1068,4516,5,29,141,175,1.2228571428571429,0.03638354859674456,660,"You can't call it your ""Nest Egg."""
983,4516,3,33,139,175,1.2228571428571429,0.03453114128591891,660,"Yes, let's do lunch; as soon as the full Mueller report is released."
2237,4516,4,31,140,175,1.2228571428571429,0.035469439853201556,660,Got all my nest eggs safe from the markets.
804,4522,5,31,148,184,1.2228260869565217,0.03526034693046014,660,I'll never have that empty nest syndrome!
3327,4522,10,21,153,184,1.2228260869565217,0.03924633386533431,660,They underestimated my ability to be an empty nester
2867,4524,4,35,154,193,1.2227979274611398,0.033432907642757165,660,"By the time I got the Amazon return authorization to exchange it for the Nest(r) system, I decided I really liked it."
4744,4524,6,31,156,193,1.2227979274611398,0.035010056351656944,660,You’ve taking nesting to a whole new level
3042,4526,6,33,163,202,1.2227722772277227,0.034014244186295825,660,These millennials really don’t move out of their parents homes.
3867,4527,8,20,134,162,1.2222222222222223,0.04107294966560803,660,"The bench hurt my butt, so I had a bird build this for me."""
5765,4527,4,26,123,153,1.2222222222222223,0.03848505245308902,660,The doctor said nesting is good for pregnancy.
5647,4527,5,26,131,162,1.2222222222222223,0.03816992907943363,660,"Well sure it was time to leave the nest, but why not take the egg too?"
5205,4527,4,28,130,162,1.2222222222222223,0.037151880838356854,660,It is called birdrification.
4986,4527,2,28,114,144,1.2222222222222223,0.03745554791462456,660,"The incubation period varies among the species, so, yeah,it's a sublet."
4652,4527,2,34,135,171,1.2222222222222223,0.033975018420835286,660,Cuckoo? I'm saving a fortune on rent!
2912,4527,2,32,128,162,1.2222222222222223,0.03502712916618225,660,Just nesting
740,4527,6,26,139,171,1.2222222222222223,0.03780872485437336,660,"My roommate winters in Belize, so I'm catching up on ""me"" time."
2338,4527,6,28,146,180,1.2222222222222223,0.03657900096985356,660,I moved in and ate all the eggs. Now they feed me!
1706,4527,6,28,146,180,1.2222222222222223,0.03657900096985356,660,"'Help yourself, I didn't think it looked very comfortable.'"
1504,4527,4,30,137,171,1.2222222222222223,0.035943021240637286,660,"...and don't forget, Charles, over easy on the eggs this time, please."
2355,4527,2,30,121,153,1.2222222222222223,0.03618149579973173,660,"She meant ""nest"" figuratively."
279,4527,5,28,138,171,1.2222222222222223,0.0368876703724877,660,Hey! It's a public park. Leaf me alone.
99,4527,3,32,136,171,1.2222222222222223,0.03497286557176149,660,This cured my broodiness without the bother of children!
4073,4541,4,33,148,185,1.2216216216216216,0.034242479473812905,660,"Urban glamping?”
“DIY affordable housing."
4940,4541,7,27,151,185,1.2216216216216216,0.0367261571670108,660,This mattress came in a box and includes freshly caught meals delivered through the end of spring.
3179,4541,2,37,146,185,1.2216216216216216,0.03248135753556971,660,Birds do it...How about us doing it?
1257,4544,5,29,142,176,1.2215909090909092,0.03619838669785914,660,Having an Empty Nest must not suit you
3951,4544,10,19,147,176,1.2215909090909092,0.040435114989363766,660,Nice to meet you.  Horton's the name.
4611,4544,3,33,140,176,1.2215909090909092,0.03435772212556612,660,"You always said you want more nature.
Take the bench and I’l take the tree. Just think of the money we’ll save! ."
2547,4547,4,29,134,167,1.221556886227545,0.03643558633896611,660,My flight to Ft Myers leaves tomorrow
3560,4547,7,23,137,167,1.221556886227545,0.039293594294012045,660,"Just like R. Kelly, I believe I can fly.  Tomorrow, we find out!"
4344,4549,5,25,128,158,1.2215189873417722,0.03874951939947326,660,"If I leave here tomorrow
Would you still remember me"
1722,4549,4,27,127,158,1.2215189873417722,0.03769482190708304,660,"Not bad for undergrad, huh Dad? You should see the dining hall."
1243,4551,6,21,122,149,1.221476510067114,0.04134247033532939,660,You twig it right Romeo! —Yes! I'm pregnant!
1625,4552,3,36,151,190,1.2210526315789474,0.03283494984493697,660,It is worth the climb .
93,4553,2,36,143,181,1.2209944751381216,0.03285112585677323,660,I sublet the place from the Hawk.
4155,4553,6,28,147,181,1.2209944751381216,0.03639705876685216,660,It's more comfy than that bench.
2211,4555,4,30,138,172,1.2209302325581395,0.03575678832266111,660,Who can afford an apartment nowadays?
2807,4555,6,26,140,172,1.2209302325581395,0.037610461618548335,660,It's a nest.  What's your problem?
3360,4555,7,24,141,172,1.2209302325581395,0.0385038475891001,660,"On a scale of one to tree, how sick is my crib?"
4901,4558,3,30,130,163,1.2208588957055215,0.03590884033010477,660,Are you ready for my summer plumage?
5281,4559,8,18,128,154,1.2207792207792207,0.042467354655325626,660,Wanna join me? I’m nesting.
1532,4560,5,33,157,195,1.2205128205128206,0.033916891131751066,660,I am feeling a little squirrelly about our relationship.
3790,4560,2,39,154,195,1.2205128205128206,0.031492081889380255,660,You can really L I V E in Brooklyn
3556,4562,4,31,142,177,1.2203389830508475,0.03511243755552559,660,"Robin finally moved out!
 Do you like my new love nest?"
1407,4562,8,23,146,177,1.2203389830508475,0.038596484459621286,660,This bed's only 500 a month!
946,4562,5,29,143,177,1.2203389830508475,0.036015060828470905,660,"Harry, nest egg means something else for us humans......."
649,4565,5,27,136,168,1.2202380952380953,0.03721253782080273,660,This is the most stable home life I’ve ever had
1869,4565,3,31,134,168,1.2202380952380953,0.0352448715731133,660,And it comes with a sub-lease option...
2505,4565,4,29,135,168,1.2202380952380953,0.036242060808333754,660,And why do you say I can’t be a surrogate mother if I promise to give them back after they hatch?
3827,4565,5,27,136,168,1.2202380952380953,0.03721253782080273,660,Happy bird-day Mr.!!!
5657,4565,5,27,136,168,1.2202380952380953,0.03721253782080273,660,"Sweetheart, you’ve taken this empty nest thing too far."
705,4570,6,23,130,159,1.220125786163522,0.03954985017675705,660,You never listen at my OB appointments. She DID said I'd start nesting in my ninth month.
4708,4570,3,29,127,159,1.220125786163522,0.03640544136944237,660,Retirement!
5314,4570,5,25,129,159,1.220125786163522,0.038530236867996566,660,It’s a tree house. You said we need to budget.
1796,4573,5,23,122,150,1.22,0.03998881275324226,660,That's a nice looking coat...know any songs?
2687,4573,3,27,120,150,1.22,0.03768466834387587,660,Not before they've hatched.
1991,4575,4,34,153,191,1.219895287958115,0.03351560257597705,660,Yeah well they are still my eggs to protect.
3911,4576,5,30,147,182,1.2197802197802199,0.0353687699524347,660,You're boring.
2560,4577,5,28,140,173,1.2196531791907514,0.036504947758810545,660,"Get up here, Gary. Mama's nesting!"
3152,4577,6,26,141,173,1.2196531791907514,0.037414229191567956,660,I could get used to this empty nest thing
1260,4579,6,24,134,164,1.2195121951219512,0.03872962143917949,660,"John, with spring coming very soon it's time to start a family."
2013,4579,3,30,131,164,1.2195121951219512,0.035714611569502515,660,well my 'tweet' worked...and how are your nesting instincts?
2879,4579,6,24,134,164,1.2195121951219512,0.03872962143917949,660,Hatching a nest egg.  What about you?
3200,4579,5,26,133,164,1.2195121951219512,0.037751382461241274,660,"Mary, did you watch Lady Bird again?"
3384,4579,4,28,132,164,1.2195121951219512,0.036747111160575316,660,I just finished The Overstory.
4273,4579,4,28,132,164,1.2195121951219512,0.036747111160575316,660,I went through one 'empty nest' saga too many.
5125,4579,4,28,132,164,1.2195121951219512,0.036747111160575316,660,This is my way of coping with our empty nest.
2582,4586,6,22,127,155,1.2193548387096773,0.04018283282430401,660,It's great except when I order pizza delivery...
857,4587,6,29,152,187,1.2192513368983957,0.035571472135681126,660,Just wait until you hear about the bees.
225,4588,8,23,147,178,1.2191011235955056,0.0383989952260944,660,"The tree is my landlord, the branches give me a penthouse view, and YOU are my toilet!"
1248,4588,7,25,146,178,1.2191011235955056,0.037563318041738646,660,Prime real estate.
3041,4588,6,27,145,178,1.2191011235955056,0.03670862147011238,660,"Sure beats the heck out of New York rental prices, and gives me lots more free time not having to keep house!"
403,4591,7,23,139,169,1.2189349112426036,0.03887117402457423,660,I am waiting for my Mommy to bring me some food.
416,4591,6,25,138,169,1.2189349112426036,0.03795425920649814,660,I promise I won't bring up nesting during our gender pay-gap arguments.
2139,4591,8,21,140,169,1.2189349112426036,0.03976695296579084,660,It's my retirement next egg.
4605,4591,4,29,136,169,1.2189349112426036,0.03605053447099887,660,"If you really want to hear about it, the first thing you'll probably want to know is where I was born, and what my lousy childhood was like, and how my parents were birds and all that David Copperfield kind of crap..."
4409,4595,3,29,128,160,1.21875,0.03620334234370282,660,Trying to be a better birder.
5155,4595,3,36,153,192,1.21875,0.03253258032684332,660,"Please swipe right, this is me at my most creative"
5441,4597,7,26,150,183,1.2185792349726776,0.03686216420308999,660,Don't forget the gummy worms!
1915,4597,7,26,150,183,1.2185792349726776,0.03686216420308999,660,What's to explain?  It's hormones!
3056,4599,4,25,122,151,1.218543046357616,0.03862314640183871,660,"It was a steal, only $2,500/month!"
3513,4599,3,27,121,151,1.218543046357616,0.0374626109237906,660,"Your mom ever sang you that song about the cradle in the treetop? Yeah, that's me."
1823,4601,2,34,138,174,1.2183908045977012,0.03345990325869016,660,Things are good up here.  I have the option of migration when politics ruffles my feathers.
2496,4601,6,26,142,174,1.2183908045977012,0.03721999729046228,660,I thought I should try the literal version of empty nesting.
2882,4601,3,32,139,174,1.2183908045977012,0.03443843629051968,660,It beats the vacation rental ordinance.
4081,4601,4,30,140,174,1.2183908045977012,0.03538992317300875,660,Tell the office I've joined the sharing economy.
5471,4601,7,24,143,174,1.2183908045977012,0.03810208611555669,660,Finally mastered the Treehouse!
2052,4606,5,33,159,197,1.218274111675127,0.033608789633811365,660,"Now Frank, don't you dare call it empty nest syndrome! What's more, I expect you to help keep our eggs warm when I go forge for worms."
213,4607,4,33,151,188,1.2180851063829787,0.03375574296523643,660,"I'm promoting my real estate office called, 'Do You Need A New Nest?'"
253,4607,6,29,153,188,1.2180851063829787,0.03540097131442949,660,I'm monetizing sloth and body heat capital in this gig economy.
4195,4609,3,28,125,156,1.2179487179487178,0.0367123617007086,660,The rent is too damn high.
2063,4609,4,26,126,156,1.2179487179487178,0.03782208994202261,660,"I'm still not sure I like worms, but I definitely like crumbs."
1265,4609,4,26,126,156,1.2179487179487178,0.03782208994202261,660,Oversight is BACK baby!
3205,4612,7,25,147,179,1.217877094972067,0.037372927544765004,660,They took away my hammock.
5218,4612,6,27,146,179,1.217877094972067,0.03652348579514802,660,Not another tried joke about bird's eye view at a steal ... I'm just thinking ahead of when the earth's surface becomes too hot.
3112,4614,3,31,136,170,1.2176470588235293,0.03487686999555318,660,"A great spot, really.  The cops don't bother me, even if the squirrels get a little squirrely."
3445,4614,8,21,141,170,1.2176470588235293,0.03955330936923113,660,But Dad. I can see clearly now...!
5629,4614,4,29,137,170,1.2176470588235293,0.03586097746800825,660,Our nest egg is actually quite comfy!
4797,4617,5,32,156,193,1.217616580310881,0.034009272310043547,660,"It's an Airbnb ""Bird's Nest""."
5067,4618,7,26,151,184,1.2173913043478262,0.036680520109975794,660,I'm in town visiting my mother-hen.
3878,4618,7,26,151,184,1.2173913043478262,0.036680520109975794,660,You hang out with the best chicks in town here!
2860,4618,7,26,151,184,1.2173913043478262,0.036680520109975794,660,Better than any hotel!  Free food and they keep me warm at night - but ya haveta like worms.
2620,4618,6,28,150,184,1.2173913043478262,0.03586173481994093,660,Tell mom she can stop crying. I'm back in the nest.
775,4618,8,24,152,184,1.2173913043478262,0.03748142322245667,660,It's the new way of birding.
463,4618,5,30,149,184,1.2173913043478262,0.035023813228333485,660,Bird watching at its finest
141,4618,7,21,133,161,1.2173913043478262,0.040084975901273426,660,You want me to bring you what?
1542,4618,4,27,130,161,1.2173913043478262,0.03706596873612352,660,All that's missing is a good book and a cup of joe.
790,4626,4,30,141,175,1.217142857142857,0.03520923684066699,660,Even the birds are Airbnb'ing their homes.
4456,4626,6,26,143,175,1.217142857142857,0.037027736210653785,660,Waiting on that nest egg
4588,4626,4,30,141,175,1.217142857142857,0.03520923684066699,660,I’m trying out the empty nester.
5260,4626,10,18,147,175,1.217142857142857,0.04042003251919673,660,I recommend it unless you’ve got a stick up your butt.
5583,4626,5,28,142,175,1.217142857142857,0.036129929475352866,660,My nesting instinct has sprung.
4424,4631,6,21,125,152,1.2171052631578947,0.04060127035236401,660,I think I'd like to stay here.
5458,4632,4,33,152,189,1.216931216931217,0.0335964874667931,660,"When I fall, it's time to rake."
5685,4632,7,27,155,189,1.216931216931217,0.03602201883703794,660,It’s the new age version of « tree hugging. »
1300,4634,1,34,131,166,1.216867469879518,0.03320132921386776,660,Got any bread crumbs?
3855,4634,5,26,135,166,1.216867469879518,0.037341741551228755,660,"It can't be a sanctuary city, if you can't prove intent..."
4508,4634,7,22,137,166,1.216867469879518,0.03924849503273128,660,"They’ve got a timeshare in Florida.  Will the breadcrumbs keep?”
——————
“Well, I owed them a favor.  Who should I say stopped by?”
——————"
1548,4637,2,35,143,180,1.2166666666666666,0.03274622622672525,660,I can't leave yet. It's winter.
2116,4637,5,29,146,180,1.2166666666666666,0.035475837853167526,660,I liked the idea that it's rot-controlled.
484,4637,8,23,149,180,1.2166666666666666,0.03800993042188579,660,"I killed their mother, now I'm their queen."
1340,4637,6,27,147,180,1.2166666666666666,0.03634017498327467,660,I'm practicing the original outdoor version of hygge.
4075,4637,6,27,147,180,1.2166666666666666,0.03634017498327467,660,"The buzzard’s broken, so you’ll have to wait for somebody to come out."
4130,4642,4,26,127,157,1.21656050955414,0.03760604401679526,660,How do you like your nesting doll?
1151,4643,3,36,155,194,1.2164948453608246,0.03223558539123921,660,"Guess who has the ""nesting"" instinct!"
2419,4644,5,27,139,171,1.2163742690058479,0.03662496551949997,660,"Spring and summer won't take that long, John. I 'll be back on the ground in the fall."
5495,4644,6,25,140,171,1.2163742690058479,0.037552463952568615,660,Enough with being sent to the doghouse. It's time we moved up!
53,4646,7,26,152,185,1.2162162162162162,0.036500628325222786,660,"Bro, just diversify your assets!"
314,4647,3,37,159,199,1.2160804020100502,0.03174554893209994,660,Rent is theft.
3407,4648,1,33,128,162,1.2160493827160495,0.033595855811090154,660,Just waiting on my family nest egg to hatch!
3050,4648,7,21,134,162,1.2160493827160495,0.039859364574572884,660,Who said we need to migrate?
3442,4648,6,23,133,162,1.2160493827160495,0.03888557197968405,660,Shouldn't you be hunting?
861,4648,5,25,132,162,1.2160493827160495,0.037886758532311306,660,What's on your mind buddy? Like the hat?
2170,4648,3,29,130,162,1.2160493827160495,0.03580564201187589,660,"I call it nest, sticks, and chill."
1719,4653,6,26,144,176,1.2159090909090908,0.03683741681293388,660,Rents are just too darn high.
1985,4653,3,32,141,176,1.2159090909090908,0.034090909090909095,660,"When you accused me of having a nesting instinct, 
I decided to take to take it to heart."
2448,4653,6,26,144,176,1.2159090909090908,0.03683741681293388,660,Tweet tweet tweet. Tweet. Tweet tweet. K?
3068,4653,6,26,144,176,1.2159090909090908,0.03683741681293388,660,When are we going to get pregnant? I’m already nesting!
4370,4653,2,34,140,176,1.2159090909090908,0.03312483988956873,660,It has wonderful views and would be great for having our first.
3886,4658,4,25,124,153,1.2156862745098038,0.03816974614841471,660,"Even after his brother moved only a block away, John still felt isolated."
2566,4658,10,24,170,204,1.2156862745098038,0.03628057882561922,660,"Well, if you won't build the addition..."
3215,4658,3,27,123,153,1.2156862745098038,0.03702607471808098,660,Nest-sitting for the whole winter.
3539,4658,5,23,125,153,1.2156862745098038,0.03928013280323685,660,"Yes,I know I left you, but
 I was seeking a different kind
of worm."
2351,4662,5,26,136,167,1.215568862275449,0.03714017467354157,660,"I had to wait for this until the birds left. It's nice, isn't it?"
2354,4662,3,30,134,167,1.215568862275449,0.03514402994813966,660,Catching's overrated; brooding's where it's at.
2348,4662,3,30,134,167,1.215568862275449,0.03514402994813966,660,I’m actually just part hedgehog and am stuck in this tree
210,4665,5,29,147,181,1.2154696132596685,0.03529959692923228,660,Don't fret. Pretty soon I'll have to come down to go to the toilet.
1186,4666,4,23,117,144,1.2152777777777777,0.03962135573486219,660,I’ll stay here and wait for you to return with the worms.
1363,4667,6,22,130,158,1.2151898734177216,0.03948978412477864,660,"Appropriation, appreciation; potato, potahto."
2022,4667,5,24,129,158,1.2151898734177216,0.03845539487689824,660,Gotta keep the eggs warm while my husband catches the worm!
4971,4669,6,25,141,172,1.2151162790697674,0.03735468589012319,660,"Performance art? No, Seussical the Musical audition."
1829,4669,4,29,139,172,1.2151162790697674,0.03548765483856414,660,"Rent only costs me $3,000 a month!"
3580,4669,7,23,142,172,1.2151162790697674,0.03825404572008195,660,"Thanks for the nest Dad,now I need some eggs."
3581,4669,7,23,142,172,1.2151162790697674,0.03825404572008195,660,"I don't mind warming the eggs 
Let me know when the Mueller report comes out"
3920,4669,6,25,141,172,1.2151162790697674,0.03735468589012319,660,"It's rent-controlled and there's no heating bill.""
- Carl Yaffe   Rockville, Marylan"
2802,4674,4,32,150,186,1.2150537634408602,0.03383716132101834,660,"Cheapest rent in the whole city.""
-Megan, Seattl"
2268,4674,7,26,153,186,1.2150537634408602,0.03632246415880976,660,I call it my back to nature retreat.
597,4674,5,30,151,186,1.2150537634408602,0.03468538777399526,660,I'm making it here!
87,4674,6,28,152,186,1.2150537634408602,0.035513360356353496,660,"It’s a great location in the city, and the rent is a little cheaper too."
955,4674,7,26,153,186,1.2150537634408602,0.03632246415880976,660,"The webcam is out of order, so I'll be doing some of the old standards for a few days."
2321,4679,5,22,122,149,1.2147651006711409,0.039911654648582935,660,"Go hibernate then, I’m gonna nest."
5036,4679,5,22,122,149,1.2147651006711409,0.039911654648582935,660,Who's cuckolding whom?
169,4681,7,21,135,163,1.2147239263803682,0.039636242018013995,660,Yea she caught me fuckin the maid
137,4681,6,23,134,163,1.2147239263803682,0.03866899687439083,660,"John, I think there's a bun in the oven."
5007,4681,4,27,132,163,1.2147239263803682,0.03665802224880369,660,the birds are smart!
3291,4684,6,26,145,177,1.2146892655367232,0.036649010510758834,660,"I don't have to fly the nest now, do I?"
4178,4684,3,32,142,177,1.2146892655367232,0.033919698778945295,660,Almost an empty nester.
3072,4684,7,24,146,177,1.2146892655367232,0.037514681216898105,660,I'm hatching a new feminist agenda.
2493,4684,8,22,147,177,1.2146892655367232,0.03836082170904663,660,Man I feel sorry for you. You gotta work everyday and all I have to do is push a giant egg or two out my cloaca.
2231,4684,4,30,143,177,1.2146892655367232,0.03485322511105908,660,And how exactly do you plan on feeding the chicks?
2216,4684,3,32,142,177,1.2146892655367232,0.033919698778945295,660,I'M AFRAID YOUR CHARCOAL GRAY PLUMAGE JUST DOESN'T MAKE THE CUT.
1482,4684,3,32,142,177,1.2146892655367232,0.033919698778945295,660,It's nesting time. Wouldn't you like to join me?
1107,4684,4,30,143,177,1.2146892655367232,0.03485322511105908,660,"Well, I thought even rent control was too pricy."
542,4692,8,25,158,191,1.2146596858638743,0.03644393954646034,660,Every egghead should have one!
4399,4692,5,31,155,191,1.2146596858638743,0.034100233528379674,660,This one's not empty!
4151,4694,5,26,137,168,1.2142857142857142,0.036940732306882766,660,...and they're only charging $500 in rent!
3250,4694,4,25,125,154,1.2142857142857142,0.03794693567819258,660,I wanted to get better at babysitting. I figured I'd take a lesson from those who have some real experience in the field.
3192,4694,1,28,111,140,1.2142857142857142,0.0362498386227606,660,This time of year it's better than up a creek.
1754,4694,3,33,146,182,1.2142857142857142,0.033351831139587874,660,"How do you like my new seat, Dad?  I shooed a Catbird out for it!"
1577,4694,5,23,126,154,1.2142857142857142,0.03904935806371853,660,I also decided to get my own place on the billionaire row.
1310,4694,6,24,138,168,1.2142857142857142,0.0378933200287133,660,And it comes with eggs
1382,4694,4,31,147,182,1.2142857142857142,0.03424992566792915,660,"Hi honey, now I'm free as a bird!"
1157,4694,8,20,140,168,1.2142857142857142,0.03973003525870457,660,That's close enough.
980,4694,4,31,147,182,1.2142857142857142,0.03424992566792915,660,It's no IRA but it's still a great nest
978,4694,4,31,147,182,1.2142857142857142,0.03424992566792915,660,"Hi, dad!""
 ""Hey bud, you came back to the nest I see. We've missed you."
1479,4694,5,26,137,168,1.2142857142857142,0.036940732306882766,660,me for awhile!
3079,4705,7,26,154,187,1.213903743315508,0.03614600336862234,660,I've been branched out!
5202,4706,6,25,142,173,1.2138728323699421,0.03715894566570339,660,We went to the Stork Club.
1404,4706,6,25,142,173,1.2138728323699421,0.03715894566570339,660,I decided I needed to move up in the world
4339,4706,7,23,143,173,1.2138728323699421,0.03805260277710824,660,"OK, so I'm rushing the season a bit."
321,4706,4,29,140,173,1.2138728323699421,0.03530383226698369,660,My philosophy professor told me that existentialism is for the birds
911,4706,9,19,145,173,1.2138728323699421,0.03977973414144146,660,I've decided to soar like an eagle.  Aren't we loving it?
3602,4711,4,26,129,159,1.2138364779874213,0.03718112561180088,660,"Great price, the host has good reviews, and it's actually in the air!"
3648,4711,6,22,131,159,1.2138364779874213,0.03926396685971161,660,They tell me this loft is rent controlled.
5130,4711,5,24,130,159,1.2138364779874213,0.03823673100123131,660,My biological clock is clucking.
5618,4711,4,26,129,159,1.2138364779874213,0.03718112561180088,660,Care to join me for a few worms!
4038,4715,2,34,142,178,1.2134831460674158,0.032796238116652124,660,I have wings now! I'm becoming everyday...A better me
760,4716,10,22,165,197,1.2131979695431472,0.037064989666897884,660,It's free real estate!
1943,4717,6,27,150,183,1.2131147540983607,0.03580093207207664,660,I figure if I'm going to have a little nest egg I better get a nest first.
466,4717,5,29,149,183,1.2131147540983607,0.034952217338136596,660,Wanna Lay some eggs with me
5203,4719,5,26,138,169,1.21301775147929,0.03674338186822071,660,This universal basic income is a great thing.
3525,4719,6,24,139,169,1.21301775147929,0.03768976637296358,660,The joys of spring
121,4719,6,24,139,169,1.21301775147929,0.03768976637296358,660,I'm nesting for the future.
2579,4719,8,20,141,169,1.21301775147929,0.039514595348022326,660,I'm a bird now mom
2775,4719,4,28,137,169,1.21301775147929,0.03577196853653995,660,Nesting instinct” taken seriously
999,4724,5,23,127,155,1.2129032258064516,0.03882123291697811,660,"I’ve heard of nesting while pregnant, but this is going to far!"
1965,4724,4,25,126,155,1.2129032258064516,0.0377266609260996,660,The last thing on my Bucket List is to turn into a squirrel.
2613,4724,3,27,125,155,1.2129032258064516,0.03659936835618227,660,"Yes, they call it a Sleep Number nest. The little ones love it!"
1572,4727,5,30,153,188,1.2127659574468086,0.03435331477675901,660,I'm just nest-sitting for the Winter.
3172,4727,7,26,155,188,1.2127659574468086,0.035971222150783806,660,"My parents would like an empty nest, literally."
5285,4729,5,27,142,174,1.2126436781609196,0.03605532106729181,660,I just flew in from Florida and boy am I glad to get out of that hell hole.
4441,4729,3,31,140,174,1.2126436781609196,0.03416291324162709,660,"On the phone, I misunderstood when the landlord said ""migrate place is tree-mendous."""
1372,4729,6,25,143,174,1.2126436781609196,0.03696521263729962,660,My parents really do believe l’ll amount to something someday.
3262,4729,5,27,142,174,1.2126436781609196,0.03605532106729181,660,OK! So would you rather have me back in your nest?
1070,4729,5,27,142,174,1.2126436781609196,0.03605532106729181,660,Did I tell you I am deducting treehouse office rent?
116,4734,2,30,128,160,1.2125,0.034780872897281566,660,The view's better here.
1854,4734,6,22,132,160,1.2125,0.0390406778668338,660,Why don't you like being an empty nester?
5116,4734,2,30,128,160,1.2125,0.034780872897281566,660,"Definitely location over space, especially in low season!"
56,4737,8,25,160,193,1.2124352331606219,0.03609940408649132,660,I took my nest-egg out of the market.
1136,4737,3,35,155,193,1.2124352331606219,0.03214506407921948,660,You only pay 200$ for this organic experience that expands your horizon
5173,4739,4,23,119,146,1.2123287671232876,0.039131941475064144,660,My shrink says I'm a geomantic empath.
5530,4740,3,32,144,179,1.2122905027932962,0.03358226510700799,660,"It's obviously NOT empty. Besides, her dorm's one block over."
4711,4740,5,28,146,179,1.2122905027932962,0.035402117549563586,660,"My mother told me to move out, so I did."
4460,4740,3,32,144,179,1.2122905027932962,0.03358226510700799,660,I had the urge to nest since spring is coming
1226,4740,1,36,142,179,1.2122905027932962,0.03165797107272692,660,How's the bird watching this morning.
766,4740,4,30,145,179,1.2122905027932962,0.034504191460679706,660,"If it's good enough for David Attenborough, it's good enough for me."
1395,4740,4,30,145,179,1.2122905027932962,0.034504191460679706,660,It turns out I CAN have babies!
4620,4746,5,32,161,198,1.2121212121212122,0.03323740584311828,660,"Chirp,auk,geek,ak,gawk,tweet,coo,peep,ceep"
1216,4746,8,19,138,165,1.2121212121212122,0.040129022134033625,660,Come here often?
2723,4746,5,25,135,165,1.2121212121212122,0.0372640433583312,660,Can you believe this Airbnb rental was only $400 a night?
4388,4746,6,23,136,165,1.2121212121212122,0.038242891593327236,660,"I TOLD you I was a nest builder, but you wouldn't listen!"
5415,4750,5,29,150,184,1.2119565217391304,0.03478103093950716,660,You can’t believe the deal I got on this spot!
4576,4750,8,23,153,184,1.2119565217391304,0.03725466020436478,660,I meant what I said and I said what I meant.
4257,4750,5,29,150,184,1.2119565217391304,0.03478103093950716,660,I tried all those new mattresses but none satisfied me
5449,4753,3,26,122,151,1.2119205298013245,0.03712549152875948,660,"Swats been here and left, so don't flatter yourself."
2209,4754,5,26,139,170,1.2117647058823529,0.036548091414133344,660,"I'm a tree nester, not a tree hugger."
3737,4754,7,22,141,170,1.2117647058823529,0.03840560212474741,660,"Nope, no more “empty nest” I’m doing my part!"
4503,4754,8,20,142,170,1.2117647058823529,0.03930144932236826,660,I'm an ambassador from the Green New Deal
2904,4757,6,21,129,156,1.2115384615384615,0.03965276850371918,660,"Would you like to come over for dinner?"""
2965,4757,4,25,127,156,1.2115384615384615,0.03750887999036974,660,"Newest , and best I might add, use for porcupine quills."
4161,4757,6,21,129,156,1.2115384615384615,0.03965276850371918,660,Told you the hardwood floors are nice in this place!
5432,4760,4,29,142,175,1.2114285714285715,0.034941726227558804,660,Just making sure my nest egg is safe.
4869,4760,3,31,141,175,1.2114285714285715,0.033988862687208014,660,I'm part of a voluntary cross-species experiment. There are three eggs in here.
816,4762,4,33,157,194,1.211340206185567,0.03282175419411043,660,"It turns out homeless people don't usually climb trees!"""
4317,4762,6,29,159,194,1.211340206185567,0.03441074611780377,660,This au pair business is for the birds.
3806,4764,4,26,131,161,1.2111801242236024,0.036765517162000376,660,Because there are no property taxes!
112,4765,6,26,148,180,1.211111111111111,0.03609499234393096,660,I go by the Three Eyed Raven now.
190,4765,3,32,145,180,1.211111111111111,0.03341599516722597,660,"All-you-can-eat worms,though!"
5080,4765,5,28,147,180,1.211111111111111,0.03522463947122307,660,Cock a doodle you
5100,4765,7,24,149,180,1.211111111111111,0.036944846984920954,660,It's called 'outdoor performance art.'  I'm a Nestcafe coffee tree.
5758,4765,4,30,146,180,1.211111111111111,0.03433222945639939,660,You're late. The cuckoo above chimed like an hour ago.
69,4770,4,27,135,166,1.2108433734939759,0.03606233798299768,660,'Tis the season for nesting. Am I right John?
1948,4770,4,27,135,166,1.2108433734939759,0.03606233798299768,660,Had to claim it early.  Owners may come back soon.
651,4772,6,27,152,185,1.2108108108108109,0.035450093343300494,660,I'm laying an egg.
3973,4773,3,30,138,171,1.2105263157894737,0.0344103870644957,660,...and the rent isn't bad.
4113,4773,7,22,142,171,1.2105263157894737,0.038200425866029626,660,Let me guess...You identify as a raptor?
3519,4773,3,30,138,171,1.2105263157894737,0.0344103870644957,660,I'm just waiting for my mom to come back.
3861,4773,5,22,125,152,1.2105263157894737,0.039196774755293144,660,I've decided to leave the earth
4683,4773,8,20,143,171,1.2105263157894737,0.039090561340948134,660,"Well, I drew the short straw again. Maybe next winter will be my winter with the gang in Costa Rica."
3948,4778,1,39,155,195,1.2102564102564102,0.030146127143415146,660,"Leaving already huh"""
3341,4779,6,25,145,176,1.2102272727272727,0.03658364854964922,660,That’s what I get for making bird noises.”
3199,4780,2,34,145,181,1.2099447513812154,0.032315063589473364,660,Getting the grub is your job.
4212,4780,3,32,146,181,1.2099447513812154,0.03325132612388175,660,it's something like returning to the womb
100,4782,10,14,138,162,1.2098765432098766,0.042388704837331065,660,"You think living in an aerie is eerie, Dearie?"
1050,4782,3,28,131,162,1.2098765432098766,0.03549695261674855,660,"What a nice day for bird watching. This one over here, is a common species."
1042,4784,4,22,117,143,1.2097902097902098,0.03951486915808532,660,I migrated to San Francisco and I bought this after my start up got its C round
2889,4785,10,19,157,186,1.2096774193548387,0.03843138363425194,660,And it comes with free omelettes every morning!
4254,4785,3,33,150,186,1.2096774193548387,0.032712578263849025,660,Why should I?
4763,4785,3,33,150,186,1.2096774193548387,0.032712578263849025,660,Mother had empty nest syndrome.
4813,4788,6,23,138,167,1.2095808383233533,0.03782593280419043,660,"You know, honestly, I almost never read the NYT - can't stand the 1% advertising - but that day I just happened to pick it up - and, bam, there is was - right next to the fold down desk bed."
4808,4788,4,27,136,167,1.2095808383233533,0.03586797260400549,660,Do you have any spare seeds?
2492,4788,7,21,139,167,1.2095808383233533,0.03876784826889222,660,I'm an influencer for NestFix.
2916,4788,4,27,136,167,1.2095808383233533,0.03586797260400549,660,This is the way it use to be done.
4561,4788,5,25,137,167,1.2095808383233533,0.03685995558345681,660,They say it’s good luck when a bird poops on you.
3369,4793,4,23,121,148,1.2094594594594594,0.038654253962063526,660,Hey there! Got any spare bread?
4772,4793,7,17,124,148,1.2094594594594594,0.042070623235642805,660,Then I got to thinking: Do they really have to be INSIDE me?
4564,4795,1,30,122,153,1.2091503267973855,0.03426659826607747,660,"Spring just brought on a spell of 
broodiness."
2966,4796,6,25,146,177,1.2090395480225988,0.03639575911504273,660,"Goerge, aren't you happy for me? I was at tree hugging stage for years, now I've moved up to tree nesting."
2819,4796,2,33,142,177,1.2090395480225988,0.032677912112145595,660,I'm really excited about becoming an empty nester.
3214,4796,4,29,144,177,1.2090395480225988,0.03458682712803624,660,I guess my timing is a little off - I just flew in from the Mexico.
870,4796,4,29,144,177,1.2090395480225988,0.03458682712803624,660,Cristo suggested it.
2663,4796,6,25,146,177,1.2090395480225988,0.03639575911504273,660,"Nice to meet you, Batman. Need a sidekick?"
3271,4801,3,32,147,182,1.2087912087912087,0.0330882357029248,660,"I had to fight off a family of mocking birds for it, but it was worth it."
3913,4801,5,28,149,182,1.2087912087912087,0.03487487459077787,660,Sleeping is not allowed on the grounds.
5601,4801,4,30,148,182,1.2087912087912087,0.033993295071637224,660,My love nest--you finally found me from my on-line posting!
155,4804,2,30,131,163,1.2085889570552146,0.03421243378685645,660,"It's a little wet, but it's still better than paying into taxes"
905,4804,1,32,130,163,1.2085889570552146,0.03308701049628247,660,I decided to embrace the whole snowbird theme.
1435,4804,4,26,133,163,1.2085889570552146,0.036358923934818224,660,"Dad, you said you wanted to be Empty Nesters...so I just changed nests...and the view is GREAT from up here!"
810,4807,4,31,152,187,1.2085561497326203,0.03342792204231084,660,"Hey, I mean, it's free real estate."
5038,4808,2,31,135,168,1.2083333333333333,0.03361815158450208,660,We don’t have to be empty nesters.
4800,4808,5,30,157,192,1.2083333333333333,0.03370754175471738,660,I don't think I need to worry about that until September 23rd.
4691,4808,4,27,137,168,1.2083333333333333,0.03567565156823325,660,Would this be a bad time to tell you about bird mites?
2286,4808,2,31,135,168,1.2083333333333333,0.03361815158450208,660,You might be surprised how well it pays.
1804,4808,5,25,138,168,1.2083333333333333,0.03666112538163136,660,I figured this is safer... they walk out to the branch to do you know what!
389,4808,2,31,135,168,1.2083333333333333,0.03361815158450208,660,What to book it?  It’s “Air BirdsNestBest”.
4044,4808,5,30,157,192,1.2083333333333333,0.03370754175471738,660,I'm really digging this birds eye view.
386,4815,7,22,144,173,1.2080924855491328,0.03779649135451461,660,I'm just taking a nest.
811,4815,6,24,143,173,1.2080924855491328,0.03689663160216944,660,"Just until spring, when my place in Trump Tower opens up."
2047,4815,5,26,142,173,1.2080924855491328,0.03597426981135989,660,You want to join me? Bring me a couple of worms.
2097,4815,7,22,144,173,1.2080924855491328,0.03779649135451461,660,I'll lay my eggs where I want to lay me eggs.
2619,4815,4,28,141,173,1.2080924855491328,0.03502762842863945,660,"No empty nest syndrome, but the children do write jealous comments when I post pictures of the flowers in the yard."
3898,4820,4,29,145,178,1.2078651685393258,0.034412015086719386,660,I can see your house from here.
5452,4820,5,27,146,178,1.2078651685393258,0.035322326571128,660,"I know I'll miss your snoring,my dear""."
3857,4820,3,31,144,178,1.2078651685393258,0.03347695939388448,660,"Hey, when I worked for you I didn't get an office with a view!!"
1799,4820,5,27,146,178,1.2078651685393258,0.035322326571128,660,"I’m just watching it ‘til my folks get back from Florida...
Fine, dammit.  I still live here!"
2840,4820,7,23,148,178,1.2078651685393258,0.03707595849786003,660,Easier for the stork to get here rather than a hospital room.
1409,4820,2,33,143,178,1.2078651685393258,0.03251502480686395,660,"See, living in the city can be cheap and nesty"
1467,4826,4,24,126,154,1.2077922077922079,0.03762236316264341,660,"Beat it, schmuckold, I’m incubating here!"
236,4827,6,26,151,183,1.2076502732240437,0.035557213433772814,660,Think of me as your Nest Egg.
3414,4827,4,30,149,183,1.2076502732240437,0.033826275976238586,660,Best view of the skyline in town.
5004,4827,3,32,148,183,1.2076502732240437,0.03292670202196914,660,"They say it's hard to find a place in the city these days, but like I tell them, 'Early human gets the worm.'"
1797,4830,6,21,132,159,1.2075471698113207,0.0389695629547607,660,These tweets are lame.  Un-follow.
4185,4830,7,19,133,159,1.2075471698113207,0.03997797309500652,660,"Just keeping the egg warm while she's away trying to find some crumbs""."
5666,4832,6,22,136,164,1.2073170731707317,0.03817199018472044,660,Where the hell is Jonathan Franzen?
4495,4832,3,28,133,164,1.2073170731707317,0.03510912612698705,660,No one has figured out how I did it!
2672,4832,6,22,136,164,1.2073170731707317,0.03817199018472044,660,Do you hear a muffled squawking?
1354,4832,4,26,134,164,1.2073170731707317,0.03615891918307185,660,"No, you're NOT a bird, Robin!"
682,4832,5,24,135,164,1.2073170731707317,0.03717908196251163,660,The rabbit died.
1489,4832,5,24,135,164,1.2073170731707317,0.03717908196251163,660,You look like the type of man who will play it as it lays.
5056,4838,6,28,159,193,1.2072538860103628,0.03434475021648409,660,Hello Mother
5585,4838,5,30,158,193,1.2072538860103628,0.03354980627789304,660,"Oh, hi Dad. I dropped out of college to make sure your nest wasn’t empty."
3656,4840,4,27,138,169,1.2071005917159763,0.03548534361547313,660,It was a natural progression from bird-boxing.
1698,4840,7,21,141,169,1.2071005917159763,0.03834757809708793,660,"Planking is so over, Dad. It's all about porcupine selfies now!"
1962,4840,3,29,137,169,1.2071005917159763,0.03447850393177631,660,"It was around the time of the housing crisis and I wanted to get into DIY culture, so I thought I'd kill two birds with one stone."
2385,4843,2,32,140,174,1.206896551724138,0.032884354587308644,660,My folks even pay for the utilities.
1419,4843,8,20,146,174,1.206896551724138,0.038471098047177174,660,I got it on VRBO.
4378,4845,8,27,173,208,1.2067307692307692,0.034115195249246416,660,"And the rent is only $5,400 per month!"
1584,4846,6,25,148,179,1.2067039106145252,0.03602562369119437,660,"I'd tell you a bird joke, but that would be fowl."
1981,4846,7,23,149,179,1.2067039106145252,0.03688653224386132,660,"It's quite cozy, although that 'bird droppings' thing is going to get me in trouble."
2773,4846,4,29,146,179,1.2067039106145252,0.034238927627246056,660,"Don't just stand there Ed, get me some food!"
2933,4846,6,25,148,179,1.2067039106145252,0.03602562369119437,660,"You've heard of ""Horton Hatches an Egg?"" Well, there was this pigeon..."
3591,4846,6,25,148,179,1.2067039106145252,0.03602562369119437,660,What do you think happens if you don't sit on the nest egg???
3941,4851,4,23,123,150,1.2066666666666668,0.038187886698918753,660,"A place to sleep and, hey, I’m poaching a couple of eggs as we speak."
4454,4852,6,26,152,184,1.2065217391304348,0.03538144227394187,660,"My anger management class said I should be more realistic, so I'm giving you the bird."
4002,4852,3,32,149,184,1.2065217391304348,0.03276670358239526,660,"I sing for cash, not breadcrumbs."
4742,4854,2,28,125,155,1.206451612903226,0.03509132760418993,660,I think I’m going to win the Easter Egg hunt this year!
62,4855,6,27,156,189,1.2063492063492063,0.0347683270882042,660,Have a good day of hunting dear.
888,4855,4,31,154,189,1.2063492063492063,0.03310984729431211,660,This is just a logical egg-stension of my love for Nature.
1682,4857,3,27,130,160,1.20625,0.0355735518937823,660,"'It's a science project, I really think my idea could hatch'"
2215,4857,2,29,129,160,1.20625,0.0344508525603992,660,I found it on Air bird’n’bird
2562,4857,5,23,132,160,1.20625,0.0377188321497649,660,"The view is great, but the landlord can be a bit pushy."
2349,4860,4,32,158,194,1.2061855670103092,0.03258390463542082,660,"Y""know, I think I can do this. But what if it rains?"
1793,4860,4,32,158,194,1.2061855670103092,0.03258390463542082,660,Don’t knock it ‘til you’ve tried it.
4856,4860,5,30,159,194,1.2061855670103092,0.033393514209990975,660,"The owner calls me ""Cuckoo"" . What does he mean ?"
5731,4863,3,28,134,165,1.206060606060606,0.034918307890562376,660,This aerie B&B's not bad.
5491,4863,6,22,137,165,1.206060606060606,0.0379607391387771,660,So our empty nest drove you up a tree?
5743,4863,3,28,134,165,1.206060606060606,0.034918307890562376,660,I call it Errbnb.
1449,4863,3,28,134,165,1.206060606060606,0.034918307890562376,660,My girlfriend has driven me up the tree!
2129,4863,4,26,135,165,1.206060606060606,0.035961063053634855,660,"Rent was out of reach, so I chose a nest with a view."
5766,4868,4,27,139,170,1.2058823529411764,0.03529701809639166,660,We couldn't afford true Nest security.
4581,4868,5,32,167,204,1.2058823529411764,0.03235535584536797,660,Sure beats the IRA ratrace!
2961,4868,3,29,138,170,1.2058823529411764,0.03429673223825737,660,I'm nesting before I start asking the tree to give.
3608,4868,6,30,168,204,1.2058823529411764,0.033093265659668726,660,Homeless no more!
1963,4872,3,30,142,175,1.2057142857142857,0.0337061023716264,660,Trying to show the chicks that I've feathered my nest.
2263,4872,5,26,144,175,1.2057142857142857,0.035601463833249025,660,You should see my parents' place since all of us kids moved out.
544,4874,5,27,148,180,1.2055555555555555,0.03496670600731502,660,Working through separation anxiety.
1196,4874,9,19,152,180,1.2055555555555555,0.038353142175383145,660,I was undercover in the Spring.
2498,4874,6,25,149,180,1.2055555555555555,0.035843322605930227,660,No. It's my job to leep the kids warm and yours to fetch the worms
3906,4877,4,22,120,146,1.2054794520547945,0.038778964026104916,660,"This is my retirement nest! Don't you love it?

Susan Elwood Monterey CA"
3991,4877,3,24,119,146,1.2054794520547945,0.03754110733114273,660,I like my chairs organic and unprocessed.
3289,4879,6,26,153,185,1.2054054054054053,0.0352073739883416,660,...and I get all the free worms I can eat.
5602,4880,6,27,157,190,1.2052631578947368,0.03460189986546671,660,I call this my Central Perk.
336,4880,7,25,158,190,1.2052631578947368,0.035397546056706856,660,Join me for some incubation?
1496,4882,6,20,130,156,1.205128205128205,0.03934739418450387,660,It's the new hammocking.
2291,4882,6,28,161,195,1.205128205128205,0.03402463374804186,660,I’m just trying to incubate my nest egg.
4511,4882,5,30,160,195,1.205128205128205,0.03323864629588849,660,My nesting instincts kicked in just about where you’re standing
4582,4885,3,27,131,161,1.204968944099379,0.03537511102451714,660,I told my mate I’d do anything to be able to have a Pied-a-Terre in the city!
4666,4885,1,31,129,161,1.204968944099379,0.0331076875799462,660,It says on Pinterest that the eggs should hatch in about a month.
4995,4885,6,21,134,161,1.204968944099379,0.038526844338140374,660,"So, it's like this, as long as my parental units can't claim they are  'empty nesters', my student loans get paid.  I might have been born yesterday, but I'm not stupid."
4766,4888,6,22,138,166,1.2048192771084338,0.03775178080966941,660,"Interested in a bit of fledgling, big guy?"
5200,4888,3,28,135,166,1.2048192771084338,0.03472951056260326,660,"You would have preferred a sonogram, John? Really?"
3807,4890,2,31,138,171,1.2046783625730995,0.033093178907352895,660,I'm moving up in the world!
4719,4890,5,25,141,171,1.2046783625730995,0.03607709576736016,660,It may lack mod cons but what a view!
3679,4890,2,31,138,171,1.2046783625730995,0.033093178907352895,660,I-am trying to get use to the idea of an empty nest “
2383,4893,1,34,141,176,1.2045454545454546,0.031538660895015294,660,The chicks provide insulation.
3649,4893,7,22,147,176,1.2045454545454546,0.03720614896305659,660,I’m an empty nester protecting my nest egg.
867,4895,4,29,148,181,1.2044198895027625,0.03389782796270655,660,Shes more of a morning person.
2081,4895,8,21,152,181,1.2044198895027625,0.037344506388616056,660,Just doing a favor for my friend Horton the Elephant. He said he would be right back.
2336,4895,5,27,149,181,1.2044198895027625,0.034791523318105574,660,We should definitely do that cross country move when I'm 39 weeks pregnant.
3429,4895,6,25,150,181,1.2044198895027625,0.035662830075574734,660,I got this before rent control
3985,4895,5,27,149,181,1.2044198895027625,0.034791523318105574,660,You’re welcome to stay with me anytime.
4537,4895,6,25,150,181,1.2044198895027625,0.035662830075574734,660,I’m only against the gentrification of humans.
472,4901,5,28,153,186,1.2043010752688172,0.034195430923889124,660,New York sighting of wild bird man
754,4902,3,33,155,191,1.2041884816753927,0.03194643198855955,660,No one will be able to find me this summer!
3329,4903,8,14,125,147,1.2040816326530612,0.04310514838157809,660,Invitro fertilization honey! This is how the crows do it.
3355,4903,6,28,162,196,1.2040816326530612,0.03386676834700871,660,It's even more affordable than subsidized rent.
3357,4903,2,26,119,147,1.2040816326530612,0.036040616758104264,660,Hard benches are bad for my posterior.
4084,4903,3,24,120,147,1.2040816326530612,0.03731104416148252,660,I've got squatter's rights.
2870,4907,4,23,125,152,1.2039473684210527,0.03773245114514628,660,There really is a place in the world for me and I deserve it!
3026,4907,2,27,123,152,1.2039473684210527,0.03534771729460756,660,The rent is really cheap in this area!
926,4909,3,26,128,157,1.2038216560509554,0.03585002137512824,660,This way I get a birds-eye view  of  the  city.
1861,4910,4,26,137,167,1.2035928143712575,0.035571662940660276,660,"Nice to met you, Tom. I'm Robin Hatch."
2243,4910,5,24,138,167,1.2035928143712575,0.036571684009034426,660,I thought it was 'Occupy a Tall Tree' but here I am 8 years later with no regrets!
5127,4912,5,25,142,172,1.2034883720930232,0.035886467289230714,660,The rent’s cheap and they always serve me free eggs for breakfast.
1873,4912,2,31,139,172,1.2034883720930232,0.03292172787822611,660,I take my eggs over easy.
1791,4912,10,15,147,172,1.2034883720930232,0.04034644735937461,660,"Chirp chirp, Motherfucker!"
125,4912,4,27,141,172,1.2034883720930232,0.034926194732559604,660,"It's only $4,000 a month...and that's pretty good for New York!"
102,4912,2,31,139,172,1.2034883720930232,0.03292172787822611,660,Can’t wait for the cherry blossoms.
1649,4917,3,30,144,177,1.2033898305084745,0.03336444014411783,660,Just resting and nesting
5051,4917,3,30,144,177,1.2033898305084745,0.03336444014411783,660,"Grab a few twigs and join me. You can climb, can't you?"
4818,4919,5,27,150,182,1.2032967032967032,0.03461805876496286,660,"I know we agreed to start having children sweetie, but that is not a proper nest."
5002,4919,5,27,150,182,1.2032967032967032,0.03461805876496286,660,Once I learned that my spirit animal was a bird I decide to boost things up a notch.
2072,4921,9,20,158,187,1.2032085561497325,0.03725612624438985,660,At least no one minds when I throw up.
122,4922,4,31,157,192,1.203125,0.03264371374918253,660,My mom is bringing me some worms for lunch.
1191,4923,2,26,120,148,1.2027027027027026,0.03582282023093122,660,"OK, I'm more comfortable now. So what were you saying about Bernie?"
2980,4924,5,21,127,153,1.2026143790849673,0.03863810411310346,660,You might think this is crazy. But think about the owner of the building just a few blocks away and what he is doing to our Country.
2379,4924,3,25,125,153,1.2026143790849673,0.03634424941368324,660,It's a new cleanse I saw.
2533,4926,2,28,128,158,1.2025316455696202,0.034496287422202225,660,I've tried everything else.
4129,4926,5,22,131,158,1.2025316455696202,0.03784006885783284,660,‘No  nesting instinct?‘ Screw you!
5297,4926,4,24,130,158,1.2025316455696202,0.036759286664489056,660,"They call it the ""nesting instinct.""  I call it, ""Marry me, or else!"""
2082,4929,7,20,141,168,1.2023809523809523,0.038283236573738964,660,Empty-nesting was for the birds.
2978,4929,6,22,140,168,1.2023809523809523,0.03734059725193416,660,"I get lots of rest and am fed regularly, It's the good life, as long as they don't expect me to fly away someday."
3273,4931,7,21,145,173,1.2023121387283238,0.03753345738036131,660,"You’re right, it’s a lot more spacious than it looks!"
669,4931,7,21,145,173,1.2023121387283238,0.03753345738036131,660,"Nice coat, douchebag!” Henry felt very comfortable shitting on people from his perch"
1573,4931,5,25,143,173,1.2023121387283238,0.03569781159499867,660,Birds have it all figured out!
2847,4931,3,29,141,173,1.2023121387283238,0.03376251001363263,660,.....and the HOA fee is only one feather boa per month!
3115,4931,4,27,142,173,1.2023121387283238,0.034743638519106376,660,"It never has been merely a bird sanctuary city, you know."
3939,4936,5,26,147,178,1.202247191011236,0.03505629371350715,660,The rent has just gotten too much for me
3811,4936,4,28,146,178,1.202247191011236,0.034138889215363594,660,"Just because birds do it from up there is no reason you should do it, too."
890,4938,6,25,152,183,1.2021857923497268,0.035307166116735324,660,I am the Three-Eyed Raven now.
3416,4938,5,27,151,183,1.2021857923497268,0.03444628773638218,660,"If Ryan Gosling's a bird, I'm a bird"
5072,4940,5,28,155,188,1.202127659574468,0.033865379776980724,660,I'm a good egg...
0,4941,1,37,155,193,1.2020725388601037,0.02989581929726037,660,"Go ahead. Sit on the bench like all the rest of the sheeple. But when you're rested, can you find me a ladder?"
2381,4942,6,28,164,198,1.202020202020202,0.033555325978641456,660,Don’t you know that’s ill-eagle?
3489,4942,6,28,164,198,1.202020202020202,0.033555325978641456,660,I'm Sheryl Crow - get it?
2160,4944,2,27,125,154,1.2012987012987013,0.034937063875064685,660,"Hey, you wanted the scrambled eggs."
2831,4944,5,21,128,154,1.2012987012987013,0.038408927942357264,660,“Tree-hug·ger... I Love You!”
3835,4946,3,26,130,159,1.20125786163522,0.035443749678574984,660,"Hey Mike,does that place have rent control?"
1371,4947,5,23,136,164,1.201219512195122,0.03688032626507339,660,"Hey, it's not so bad.  At least I'm not homeless. 



Oliver Irwin
Vancouver, B.C."
701,4947,3,27,134,164,1.201219512195122,0.03479260075423782,660,I’m getting ready for our empty nest.
2241,4949,0,34,135,169,1.2011834319526626,0.030928937238335924,660,"I read some ""birds"" are impressed by good nests."
4483,4949,2,30,137,169,1.2011834319526626,0.03312829477896945,660,Rooftop and parkview. You couldn’t be better off. New owners even get a free subscription of The New Yorker!
4830,4949,4,26,139,169,1.2011834319526626,0.03519046278797234,660,"When you said 'on the nest' I thought, well, you know..."
3989,4952,7,21,146,174,1.2011494252873562,0.037335233720037914,660,The real question is: how did she climb up such a smooth tree?
4615,4952,6,23,145,174,1.2011494252873562,0.0364345839673596,660,Everyplace else is full.
5401,4952,6,23,145,174,1.2011494252873562,0.0364345839673596,660,Does this mean we have to get married?
3887,4955,3,30,146,179,1.2011173184357542,0.03302949785934387,660,I'm Julia Butterfly Hill's daughter & it's a life style choice.
5014,4955,4,28,147,179,1.2011173184357542,0.033966430891076524,660,What!? No binoculars?
2366,4957,4,29,151,184,1.201086956521739,0.033398508957599674,660,It’s my nest egg - what do think?!
3830,4958,4,31,159,194,1.2010309278350515,0.03234004938544969,660,I'm nesting so I can get away from the news.
385,4959,7,26,166,199,1.2010050251256281,0.03415308405508874,660,Surprise! I'm on the nest.
3381,4959,5,30,164,199,1.2010050251256281,0.03263304247257017,660,"No, Aunt Flo didn't visit this month, John. Why do you ask?"
4858,4961,4,28,148,180,1.2,0.033795676266743145,660,Spring is coming?
3979,4961,4,28,148,180,1.2,0.033795676266743145,660,"I'm fine, really... just fledging for a fraternity."
3302,4961,4,25,136,165,1.2,0.03565458001613713,660,Yeah man. I’m movin’ up in the world.
3019,4961,2,27,126,155,1.2,0.03473521844013346,660,Saved you a seat!
2529,4961,3,25,127,155,1.2,0.03592106040535498,660,This beats the storage container
2497,4961,4,28,148,180,1.2,0.033795676266743145,660,And you thought the Dodo was extinct.
2394,4961,5,24,141,170,1.2,0.0359835209992236,660,And when I read this poll that said New York was for the birds...
2078,4961,5,27,153,185,1.2,0.03410773006656662,660,A bird in the nest is worth two in the woods.
1348,4961,5,27,153,185,1.2,0.03410773006656662,660,"Come on, it’s the latest thing"
1228,4961,4,23,128,155,1.2,0.03706898651442383,660,It’s better and cheaper than acupuncture
1171,4961,1,32,137,170,1.2,0.03188038905666703,660,I wanted an eagle's eye view of the city.
1047,4961,6,24,150,180,1.2,0.03558502813246158,660,"Better hurry up.  Sanctuary City, baby."
1001,4961,5,25,145,175,1.2,0.03532629976156584,660,"Could not you pay your mortgage, neither?"
623,4961,5,24,141,170,1.2,0.0359835209992236,660,My parents said I needed higher aspirations.
497,4961,5,25,145,175,1.2,0.03532629976156584,660,"No, not yet - I'm still in my early follicular phase."
315,4961,4,26,140,170,1.2,0.03500285901504745,660,It’s more comfortable than you would think
5577,4961,5,17,113,135,1.2,0.04179499310101612,660,Too much nest and not enough egg!
5738,4961,7,23,155,185,1.2,0.03578890978298668,660,Typical millennials... His poor parents will never have an empty nest
2701,4979,6,26,159,191,1.198952879581152,0.03419740344239831,660,What’s the rent?
5042,4980,3,31,152,186,1.1989247311827957,0.03218290187500333,660,And aren't you the one who told me 'you can't have a deep sympathy with both man and nature'?
990,4981,7,22,152,181,1.1988950276243093,0.03626169251343299,660,I'm waiting to get my feathers.
587,4982,4,27,145,176,1.1988636363636365,0.034207053236799255,660,"I heard you talking to mom.  I figured, no better time than the present to start my nest egg."
4474,4982,5,25,146,176,1.1988636363636365,0.03514338566615748,660,That tree is made of the same material as my coat!
1389,4984,3,28,140,171,1.1988304093567252,0.0338147720043464,660,"If the bough breaks, Dada will catch you."
4904,4985,3,27,136,166,1.1987951807228916,0.03441460535238768,660,"My kid just left for college so I'm trying to fill the ""empty nest"""
3996,4985,7,19,140,166,1.1987951807228916,0.03842450340696319,660,"The name's Larry, Larry bird"
4496,4985,2,29,135,166,1.1987951807228916,0.03333685215242745,660,"'Country living!"""
2769,4985,4,25,137,166,1.1987951807228916,0.03545961663199949,660,Wanna snuggle?
2327,4985,4,25,137,166,1.1987951807228916,0.03545961663199949,660,Tree houses are overrated.
3603,4985,2,29,135,166,1.1987951807228916,0.03333685215242745,660,Looks like you are up a tree.
244,4991,6,20,135,161,1.1987577639751552,0.038225259705252077,660,Birds of a feather occupy the weather!
1520,4991,3,26,132,161,1.1987577639751552,0.03504641529280253,660,I'm a method actor preparing for a TV series about birds.Soon I'll  lay an egg.
1632,4991,2,28,131,161,1.1987577639751552,0.03392066439978421,660,Care to join me in my humble abode? It fits two.
1743,4991,3,26,132,161,1.1987577639751552,0.03504641529280253,660,"Are you stuck up there?""
""No, I'm Jeremy."
3359,4991,4,24,133,161,1.1987577639751552,0.03613711355972386,660,My hedge fund manager told me the investment was the beginning.
3662,4991,4,24,133,161,1.1987577639751552,0.03613711355972386,660,Momma bird asked me to keep the eggs warm
5358,4991,3,26,132,161,1.1987577639751552,0.03504641529280253,660,"This is what happens when I let Karen hire the divorce lawyer...You have to get over it, Karen, we're done!"
2003,4998,5,19,122,146,1.1986301369863013,0.03962490999463604,660,"Have high hopes, dear?"
1202,4999,6,27,164,197,1.1979695431472082,0.033479456746885586,660,My mother bird should be coming home soon.
5248,5000,6,25,156,187,1.1978609625668448,0.03461641765486452,660,I’m house sitting for some bird- friends.
4862,5000,5,27,155,187,1.1978609625668448,0.033775662317538736,660,"See, nest egg is covered!  When shall I expect a proposal?"
273,5002,3,30,149,182,1.1978021978021978,0.032539268356239937,660,It all started after I read how cuckoo birds lay their eggs in the nests of other birds.
3753,5002,4,28,150,182,1.1978021978021978,0.0334591804002203,660,"I decided to live off the grid.  I like it.  I like the pieces of bread. It's the worms that take a 'gitten used too.""
Judy Carroll, East Providence, RI"
5041,5002,4,28,150,182,1.1978021978021978,0.0334591804002203,660,It's my version of fireman meet-cute.
5693,5002,2,32,148,182,1.1978021978021978,0.03159258168089954,660,"Zip-a-dee-doo-dah. Zip-a-dee-ay. 
My, my what a wonderful day.
Plenty of sunshine. Headin' my way.

How about you?"
1556,5006,1,33,143,177,1.1977401129943503,0.03107344632768361,660,I was tired of the rat race.
2368,5006,8,19,150,177,1.1977401129943503,0.037616065907984934,660,Cat chased me up here and I made a nest.
4325,5006,4,27,146,177,1.1977401129943503,0.03403179502821975,660,"'""I'm a true emptynester, but unfortunately broke too!"""
4368,5006,5,25,147,177,1.1977401129943503,0.034962328415460805,660,That's the way you spent your nest egg?
371,5010,3,28,141,172,1.197674418604651,0.0336374689930509,660,"Once you get use to the regurgitated food from the mommy bird, this life can be pretty relaxing."
4005,5010,5,24,143,172,1.197674418604651,0.03560166052682325,660,"So, where do you keep your eggs?"
4587,5012,4,25,138,167,1.1976047904191616,0.03526673992326516,660,"It's comfortable enough, almost as roomy as my old studio and the price is right.  But until the trees leaf out, there isn't much privacy."
3300,5013,3,24,125,152,1.1973684210526316,0.036201040162359255,660,It takes thirty days to hatch them.
2682,5014,7,25,166,198,1.196969696969697,0.034085567613808335,660,"If you build it, the nest egg will come."
2261,5015,5,27,156,188,1.196808510638298,0.03361200528302614,660,now it feels like home to me.
4990,5015,6,25,157,188,1.196808510638298,0.034447876459676764,660,"I tell you, Joe, this is better than staying with any penguin"
508,5017,6,24,153,183,1.1967213114754098,0.035050654677039265,660,"If I'm going to watch the country burn, I might as well have a bird's eye view."
1064,5017,7,22,154,183,1.1967213114754098,0.03589704212976556,660,"I really laid an egg on my apartment search, so here I am."
149,5019,4,27,147,178,1.196629213483146,0.033858294439214856,660,"My dreams told me  how I should live the rest of my life, and so far my little nest is working out well for me."
975,5019,3,29,146,178,1.196629213483146,0.032907508721623936,660,My HMO does not cover a Ob/Gyn
19,5019,6,23,149,178,1.196629213483146,0.03568394662127765,660,I'm a snowbird : Just migrated back from Florida!
5565,5022,2,30,141,173,1.1965317919075145,0.03244211607029429,660,I always wanted a small ranch house so I started with a couple of branches first.
3598,5022,3,28,142,173,1.1965317919075145,0.03346198186366337,660,"I'm working on a new IPO, it's called Open AirBNB, and you schedule by tweeting. 
Drew Bridges Wake Forest, NC 27587"
3504,5022,4,26,143,173,1.1965317919075145,0.03445166999391793,660,I'll come down when you treat me nicer.
2156,5022,2,30,141,173,1.1965317919075145,0.03244211607029429,660,Baby's due in 3 months. Finally found a good place to nest.
2182,5022,1,32,140,173,1.1965317919075145,0.03138913123985368,660,"Sorry sir, I was trying to lay an egg"""
2979,5022,3,28,142,173,1.1965317919075145,0.03346198186366337,660,I hatched too early.
5691,5028,5,23,140,168,1.1964285714285714,0.03607777670159303,660,"my wife said,"" take a bird's eye view of the situation"""
2781,5029,3,26,134,163,1.196319018404908,0.03465773365749465,660,"If winter comes, can spring be far behind?"
67,5030,4,23,131,158,1.1962025316455696,0.03642809946540482,660,I only sit organic.
4902,5030,6,19,133,158,1.1962025316455696,0.03857794370917561,660,great part time gig for a robin couple.
5185,5030,4,23,131,158,1.1962025316455696,0.03642809946540482,660,I  would like to join you for coffee but not until my eggs hatch.
5673,5033,6,18,129,153,1.196078431372549,0.039408709686542885,660,I'm just not the empty nest type.
1474,5034,7,24,163,194,1.1958762886597938,0.03449665574046267,660,And it comes with a Continental breakfast of  regurgitated worms!
1418,5035,5,26,153,184,1.1956521739130435,0.034013837335563374,660,"Come join me, it’s cold down there."
2453,5035,11,14,159,184,1.1956521739130435,0.03890141794003938,660,I just got fed up with people like you peeing in front of my bench...
4729,5035,5,26,153,184,1.1956521739130435,0.034013837335563374,660,Mocking is so 2018.
3914,5038,6,23,150,179,1.1955307262569832,0.035501033969089484,660,You wouldn’t believe where they left the other fashion models.
2114,5038,5,25,149,179,1.1955307262569832,0.034605674595889174,660,It's got wi-fi and a great view - I'm never leaving the nest!
3876,5038,4,27,148,179,1.1955307262569832,0.033686525727636175,660,"Could you be happy with a crotchety woman, Frank?"
4996,5038,5,25,149,179,1.1955307262569832,0.034605674595889174,660,« It’s bedbugs free as well! »
4096,5042,4,25,140,169,1.1952662721893492,0.0348871167073119,660,I prefer spending our vacation nesting
3708,5042,8,17,144,169,1.1952662721893492,0.03871537710895174,660,Just chilling
981,5044,4,33,173,210,1.1952380952380952,0.030562150928614557,660,Fantastic rent control.
4357,5045,2,28,134,164,1.1951219512195121,0.03336355044977945,660,Peregrine shmeregrine.
5524,5045,6,20,138,164,1.1951219512195121,0.0375818213364377,660,Do you not remember what happened last time Horton? Let me guess Mazie ran off again?
2436,5047,5,21,133,159,1.1949685534591195,0.03730212760604782,660,They can’t get you for loitering in these lofty digs.
3494,5048,4,22,128,154,1.1948051948051948,0.03694229582892943,660,"Just imagine, Mom had the nerve to talk to me about 'leaving the nest'!"
519,5048,3,24,127,154,1.1948051948051948,0.03577500221227837,660,The eggs are coming along just fine.
2197,5048,0,30,124,154,1.1948051948051948,0.03201879869416839,660,"Yes, it's a bit drafty, and the smell is terrible, but my roommate is AWESOME!"
1846,5051,5,27,158,190,1.194736842105263,0.033289334722111034,660,"Sorry, no man cave, dear - the nest isn't empty after all!"
3427,5051,5,27,158,190,1.194736842105263,0.033289334722111034,660,"No more early bird for me, I tripled my worms in the market."
1231,5053,6,24,155,185,1.1945945945945946,0.034703120021212175,660,You want advice? I want worms.
4299,5053,2,32,151,185,1.1945945945945946,0.03113340509620949,660,Don't knock it till you tried it.
450,5055,6,23,151,180,1.1944444444444444,0.035319963583989096,660,Better than any penthouse view.
1602,5055,7,21,152,180,1.1944444444444444,0.036188023903013886,660,"Yes, I'm craving a coffee macchiato."
5604,5055,2,31,147,180,1.1944444444444444,0.03161023318248637,660,They’re still upstate shooting Planet Earth 3.
4170,5058,4,26,145,175,1.1942857142857144,0.03409360519339769,660,"Hey big bird, why don’t you come up and sesame?"
3087,5058,2,30,143,175,1.1942857142857144,0.03210936039692623,660,Can you please bring some Pablum for the baby?
491,5058,3,28,144,175,1.1942857142857144,0.033116347475098826,660,Its called free real estate Karl. Best home I've had since I took shelter in the dog house. I'm living the high life now.
1442,5058,7,20,148,175,1.1942857142857144,0.03687028953044231,660,"I just flew in from Cleveland and, boy, are more arms tired!"
2174,5062,3,27,140,170,1.1941176470588235,0.033682304785423396,660,"Surrogate mom, huh?"
4080,5062,5,23,142,170,1.1941176470588235,0.035689283324363795,660,Home is where the tree is
5606,5064,5,15,109,129,1.193798449612403,0.0427346454868216,660,And you also get free warms
1448,5065,7,17,136,160,1.19375,0.03915064739980553,660,The ladder was the least nuanced part of my voicemail.
4795,5066,3,24,128,155,1.1935483870967742,0.03556565963466911,660,The Birders are going to love this.
438,5066,5,26,155,186,1.1935483870967742,0.03367979984928223,660,Here in Boston they call me Larry.
1225,5066,5,26,155,186,1.1935483870967742,0.03367979984928223,660,You better believe it's a fetish thing!
1877,5066,4,28,154,186,1.1935483870967742,0.03280558304801046,660,The birds are on strike.
2094,5066,7,22,157,186,1.1935483870967742,0.03536345847655899,660,My name's not Stella.
3376,5071,6,23,152,181,1.1933701657458564,0.03514070821447786,660,"Why yes--it is rent controlled"""
2122,5071,4,27,150,181,1.1933701657458564,0.03334808338428168,660,"I 'm sorry, I can't come down until the eggs hatch."
5416,5073,6,17,127,150,1.1933333333333334,0.039794400769299465,660,"I felt really badly for my parents when they said, 'They were empty nesters.'"
517,5074,3,28,145,176,1.1931818181818181,0.03294614760889085,660,Building a nest becomes easier with the nestpresso.
4184,5074,3,28,145,176,1.1931818181818181,0.03294614760889085,660,Well lookie here. Finally got some privacy!
5270,5074,5,24,147,176,1.1931818181818181,0.03486142240553237,660,"Some birds mate for life--
Look, I've already built the next!"
530,5077,3,27,141,171,1.1929824561403508,0.03350398984674494,660,"You know, we do have easier ways to keep things warm."
2017,5077,2,29,140,171,1.1929824561403508,0.03246102102593794,660,"You know what they say: ""birds of a feather..."""
5434,5077,3,27,141,171,1.1929824561403508,0.03350398984674494,660,It's the breeding season.  I thought I would just relax and nest.
1394,5080,5,28,164,197,1.1928934010152283,0.03245459608498947,660,"I know, I must look a little cuckoo sitting all the way up here."
4673,5080,4,30,163,197,1.1928934010152283,0.03164653912114473,660,You said this weather is for the birds
3231,5082,5,22,139,166,1.1927710843373494,0.036168909906929704,660,Nobody loves me. Everybody hates me.
3136,5082,4,24,138,166,1.1927710843373494,0.035144995287064905,660,Badminton tomorrow? I'll bring the birdies.
1333,5084,4,23,134,161,1.1925465838509317,0.0358086789315852,660,You think it's funny?  Why don't YOU walk under the tree while I sit on a branch!
1621,5084,4,23,134,161,1.1925465838509317,0.0358086789315852,660,It’s a back to the roots style Airbnb.
2080,5084,6,19,136,161,1.1925465838509317,0.03791491777560574,660,Sometimes in the summer my boyfriend Waldo likes to hide up here.
2188,5087,3,30,154,187,1.1925133689839573,0.031753209408845434,660,"Expecting? No, I'm feathering."
2959,5087,3,30,154,187,1.1925133689839573,0.031753209408845434,660,It’s an ideal sublet opportunity.
4058,5087,5,26,156,187,1.1925133689839573,0.03351519536415101,660,"Yeah, but the food is terrible."
2039,5090,6,18,132,156,1.1923076923076923,0.038708882094012007,660,"Commit or nest not.
There is no try."
5097,5091,6,22,149,177,1.192090395480226,0.03559464700673274,660,I create a nest wherever I go
4984,5091,2,30,145,177,1.192090395480226,0.031783227557672676,660,"Hey Charlie! Who the hell needs a 401k, I have all I need right up here!"
4464,5091,6,22,149,177,1.192090395480226,0.03559464700673274,660,My baby is coming soon.  I am nesting!
4041,5091,6,22,149,177,1.192090395480226,0.03559464700673274,660,"I  knew pigeons are evolving, but this is ridiculous!"
3379,5091,3,28,146,177,1.192090395480226,0.032777658387544706,660,I prefer off-season.
1297,5091,6,22,149,177,1.192090395480226,0.03559464700673274,660,I'm keeping my eggs safe and warm.
944,5097,7,24,167,198,1.1919191919191918,0.03385496734911856,660,I tend to hatch in springtime.
4286,5098,5,23,144,172,1.191860465116279,0.0353089589815228,660,Remaining here until the GRATEFUL DEAD agree to come and play.
5043,5098,3,27,142,172,1.191860465116279,0.03332752124521348,660,Your Marie Condo?
5505,5098,4,25,143,172,1.191860465116279,0.0343325374587214,660,I eloped with my cat.
687,5101,4,20,122,146,1.1917808219178083,0.03803768175341878,660,I'm parking up the tree.
2572,5102,2,28,137,167,1.1916167664670658,0.03282409094384932,660,You've heard of snowbirds? Well I'm a tree bird.
5582,5102,4,24,139,167,1.1916167664670658,0.034952978128845215,660,I think i've found my true calling
2373,5104,2,32,154,188,1.1914893617021276,0.030687120554454717,660,No it's chill. The mom didn't like being an empty nester anyway.
4970,5105,6,19,137,162,1.191358024691358,0.03769888915045075,660,Did you know I was a bird in my first life?
907,5105,4,23,135,162,1.191358024691358,0.03560679388789338,660,Up here I'm untouchable like Eliot Nest
4531,5105,3,25,134,162,1.191358024691358,0.0345132226092174,660,It's just me and the Missus now that we're empty nesters.
929,5108,3,29,151,183,1.1912568306010929,0.0320940017499607,660,"Why yes, I’ve read most of Kim Stanley Robinson’s books!"
1127,5109,2,26,129,157,1.1910828025477707,0.03397282776631841,660,No worries. I’m just nesting.
2632,5110,5,24,149,178,1.1910112359550562,0.03450257658231503,660,Happy to Share!
4204,5110,3,28,147,178,1.1910112359550562,0.03261085473704866,660,Just think of it as a snowbird sublet.
5579,5110,2,30,146,178,1.1910112359550562,0.03162258488188587,660,"With my biological clock ticking, I can't count my eggs until they hatch."
1309,5113,3,27,143,173,1.1907514450867052,0.033152871092555755,660,Rent control really has its advantages.
3232,5113,3,27,143,173,1.1907514450867052,0.033152871092555755,660,I like my snow pristine.
5180,5113,4,25,144,173,1.1907514450867052,0.03415151822108803,660,Glad you made it! Have a seat across the street.
2998,5116,3,26,139,168,1.1904761904761905,0.03372212062539924,660,Dad and Mom believe in slow parenting.
429,5116,4,24,140,168,1.1904761904761905,0.034763017977495696,660,"Thanos snapped all my eggs, so I have to make new ones!"
2832,5118,5,29,171,205,1.1902439024390243,0.031532091327311114,660,"Harry, I said I was nested in a tree, not invested in a tree!"
1138,5119,2,31,151,184,1.190217391304348,0.03099214300083406,660,We'll be home when they hatch.
5349,5119,5,25,154,184,1.190217391304348,0.03374466656394568,660,I was way off on that chapter in the pregnancy book.
196,5121,1,29,133,163,1.1901840490797546,0.032038173142467624,660,And birds drop off my bait for fishing.
1102,5121,4,23,136,163,1.1901840490797546,0.03540714086767703,660,I wasn’t ready for the empty nest so I made my own
3578,5121,3,25,135,163,1.1901840490797546,0.03432091581506232,660,"I'm house sitting for Pale Male while he looks 
for a rent-controlled apartment."
3605,5124,3,24,131,158,1.1898734177215189,0.03495184918142526,660,I couldn't retire with a nest egg
4857,5125,1,31,142,174,1.1896551724137931,0.03089983265607928,660,I'm waiting for momma bird to keep me warm.
4659,5125,3,27,144,174,1.1896551724137931,0.03298001204190595,660,I'm incubating Spring.
4501,5125,3,27,144,174,1.1896551724137931,0.03298001204190595,660,"WELL I CAN’T AFFORD RENT AND I DON’T OWN AN RV SO THIS WAS THE NEXT BEST OPTION.,.."
3480,5125,4,25,145,174,1.1896551724137931,0.033972370572857284,660,I've been here since 4 am. Still no worms.
540,5125,7,19,148,174,1.1896551724137931,0.03678918681495116,660,"I married a crow so I could move in with it. It’s the only way to afford rent in New York anymore, and I’d do it again. Tiniest little dick, though."
434,5125,4,25,145,174,1.1896551724137931,0.033972370572857284,660,I thought 'Pale Male' was just his cute username.
422,5125,5,23,146,174,1.1896551724137931,0.034936552926624266,660,Go on and run the rat race. I’m outside of that system. I trade pine cones son.
1480,5125,4,25,145,174,1.1896551724137931,0.033972370572857284,660,Just warming up!
3888,5133,4,21,128,153,1.1895424836601307,0.03680529426371062,660,I'm hoping to get free food!
2390,5133,3,23,127,153,1.1895424836601307,0.03561783786016251,660,"Yep, it's Springtime in Paradise. Care to join me?"
2911,5133,7,15,131,153,1.1895424836601307,0.04015753505700819,660,Scrambled eggs.
4730,5133,3,23,127,153,1.1895424836601307,0.03561783786016251,660,"I’m incubating shredded Mueller Report redactions : 
Congress rests, I nest."
882,5137,4,28,158,190,1.1894736842105262,0.03217665116528174,660,The rent is free up here.
3344,5138,3,26,140,169,1.1893491124260356,0.033540929565641434,660,Just keeping the nest warm for the rest of my flock; they're watching Bernie on Fox !
2187,5138,6,20,143,169,1.1893491124260356,0.03655572582416299,660,"I'd really like a hamburger now, with lettuce, tomato, pickles and worms."
1838,5138,3,26,140,169,1.1893491124260356,0.033540929565641434,660,It's the perfect inexpensive birth control...
3011,5141,6,23,156,185,1.1891891891891893,0.034441309936646236,660,I hope I don’t lay an egg by doing this.
4432,5141,2,31,152,185,1.1891891891891893,0.030841306778898854,660,"New place, nice."
1619,5143,5,21,138,164,1.1890243902439024,0.03625656529444611,660,This time you’ve really made a nest of things!
2484,5143,1,29,134,164,1.1890243902439024,0.031863328931571,660,I need to grow up and start a little nest egg for myself.
2636,5145,2,30,148,180,1.1888888888888889,0.031306031221928085,660,Nest Egg: City Living Made Easy
1531,5146,6,18,135,159,1.1886792452830188,0.03803322047192668,660,I 've already seen your etchings. Come up to my aerie and I'll show you mine.
1746,5146,2,26,131,159,1.1886792452830188,0.033586900361095406,660,I'm contemplating the saying...'a bird in the hand is worth two in the bush.
4198,5146,4,22,133,159,1.1886792452830188,0.035879003158758,660,Meet the new Pale Male.
679,5149,4,25,146,175,1.1885714285714286,0.03379506617498362,660,"Miss, are you resting ?
Miss: No mister, can’t you see ?
I’m nesting."
3203,5150,3,30,158,191,1.1884816753926701,0.031150732524907885,660,"Well, I needed a short-term lease."""
479,5150,4,28,159,191,1.1884816753926701,0.03202311255687621,660,I know I called you a freeloader but this is ridiculous.
2222,5152,5,22,143,170,1.188235294117647,0.03538681411043828,660,Turns out I'm the three-eyed pigeon!
4667,5152,4,24,142,170,1.188235294117647,0.03438914027149321,660,zero gravity my @ss ... get down from there
223,5154,4,23,138,165,1.187878787878788,0.035014387062967826,660,This is cheaper than the rents over on 5th Avenue.
896,5154,4,23,138,165,1.187878787878788,0.035014387062967826,660,"I know I'm back early, but you can't beat the early spring discount flights."
2171,5154,5,21,139,165,1.187878787878788,0.03605436355564635,660,"Less judgmental glares than at the family nest, so.."
1179,5157,4,26,151,181,1.1878453038674033,0.03306209147699644,660,I discovered the perfect  rent control play.
3378,5157,2,30,149,181,1.1878453038674033,0.031150075191293085,660,The hardest part will be to sprout my wings
4603,5159,4,25,147,176,1.1875,0.03361957724341539,660,"Hey there, stranger! When you didn't show up for a few weeks, I thought I'd take a different tack."""
4009,5159,8,14,138,160,1.1875,0.03983801714522063,660,I said Nestea.
3473,5159,4,25,147,176,1.1875,0.03361957724341539,660,"I'm not retired. Just preparing for that egg."""
3005,5159,3,24,133,160,1.1875,0.03455410032190975,660,"'""Is this negotiable?"""
2862,5159,3,24,133,160,1.1875,0.03455410032190975,660,"They rejected me from Capistrano"""
1087,5159,6,21,149,176,1.1875,0.03549853664443232,660,"You were at my wedding, Denise..."
3122,5165,5,25,157,187,1.1871657754010696,0.033248064358604196,660,"Just wanted to see what it felt like to be ""up a tree without a ladder""!"
3459,5165,4,27,156,187,1.1871657754010696,0.032371789838164286,660,Are you a birder from the UK?
2305,5167,3,26,142,171,1.1871345029239766,0.03318423616166341,660,The wintering birds and I are NOT homeless.
3061,5167,3,26,142,171,1.1871345029239766,0.03318423616166341,660,"Hi, empty nester!"
4087,5167,3,26,142,171,1.1871345029239766,0.03318423616166341,660,I got it for a handful of seeds.
5597,5170,7,20,155,182,1.1868131868131868,0.03555690303470898,660,Actually this ain't too bad...getting cable next week...my girlfriend who thought I was crazy may move in with me...not bad at all...
1997,5170,3,28,151,182,1.1868131868131868,0.031960010667071805,660,"Well, we are between 25 and 40..."
854,5170,4,26,152,182,1.1868131868131868,0.032896125147719626,660,I heard they mate for life.
1209,5170,4,26,152,182,1.1868131868131868,0.032896125147719626,660,The birds seem to have everything going for them.
1352,5174,1,29,136,166,1.1867469879518073,0.03151918542381326,660,"Don't worry Mr. Henderson, I'll keep an eye on the kids."
4093,5174,2,27,137,166,1.1867469879518073,0.032656980875587785,660,Walking's OK but Nesting is Best
4779,5174,5,21,140,166,1.1867469879518073,0.03585437839778927,660,The birds were chirping extra loud this morning.
601,5177,2,24,124,150,1.1866666666666668,0.0346108654321977,660,"Now do you have empty nest syndrome?
Frank Buckley Andover, MA"
3535,5178,4,28,161,193,1.1865284974093264,0.03172032687095283,660,I'm only here for the free health insurance.
4935,5179,8,17,152,177,1.1864406779661016,0.03708681704886635,660,I convinced them that working on a PhD was good preparation for egg sitting.
3944,5179,3,27,147,177,1.1864406779661016,0.03247191589477288,660,Eggsactly!
4394,5179,5,23,149,177,1.1864406779661016,0.034392266465773313,660,"Yeah, the Nest.com sponsorship makes it all worthwhile, but I'm not proud of some of the things I did to feed my family."
5572,5182,4,22,135,161,1.186335403726708,0.03547040685896674,660,Its great! Except for the draft...
3904,5182,7,16,138,161,1.186335403726708,0.03861436283818522,660,"Well, you made it into the cuckoo’s nest."
3782,5182,5,20,136,161,1.186335403726708,0.03654845433521683,660,"I’m waiting to say hello to meet my new neighbor across the street. 
He just bought that penthouse  for 285 million I renting for a bag of birdseed"
357,5182,4,22,135,161,1.186335403726708,0.03547040685896674,660,"Yep, we're surrogate parents for busy robins. It's all for the birds."
2734,5186,6,26,172,204,1.1862745098039216,0.032193981493424985,660,I’m enjoying the Bird-Eye View
2776,5187,4,19,122,145,1.186206896551724,0.0378874706295391,660,"Yes, it's a Patagonia."
5324,5187,5,17,123,145,1.186206896551724,0.039131136851837243,660,"Hey handsome, do ya wanna come up and sit on an egg?"
3475,5189,3,23,130,156,1.185897435897436,0.03499318990757995,660,Mid Century design is so in right now
4156,5189,6,17,133,156,1.185897435897436,0.03837528237973413,660,I heard that others tweet also on the internet
5079,5191,2,27,138,167,1.18562874251497,0.032480096618689766,660,Haven't you read 'The Overstory'?
2430,5192,4,20,127,151,1.185430463576159,0.036880540415818286,660,Just waiting for the stork
4547,5193,6,21,151,178,1.1853932584269662,0.035129970826174806,660,"It's the new All-natural line of bedding from the ""My Pillow"" guy."
3881,5193,2,29,147,178,1.1853932584269662,0.03130806544602595,660,"So, George, what do you have better for us to do?"
586,5193,3,27,148,178,1.1853932584269662,0.032305958181757376,660,Woody says I should stay here.  They need the eggs.
626,5196,3,24,135,162,1.1851851851851851,0.034165169635348186,660,Just waiting for spring.
1294,5197,3,26,144,173,1.1849710982658959,0.03283493530870879,660,"The rent's acceptable, and there're no heating bills!"
817,5198,6,22,156,184,1.184782608695652,0.03434439745782628,660,I bet Robert a dinner I could sleep all night on a porcupine!
4677,5199,7,22,166,195,1.1846153846153846,0.03385288184397473,660,What do you mean “the floor is lava”?
2042,5200,3,25,140,168,1.1845238095238095,0.03339018635246278,660,I'm the chap who figured out how to monetize the snarky tweet.
2641,5200,1,29,138,168,1.1845238095238095,0.031182247285799783,660,Yeah my wife did leave me...but look at this awesome time share I got.
5663,5200,2,27,139,168,1.1845238095238095,0.03230508543902152,660,"Sure, I'm in Congress -- so you just assume I feather my nest?"
1255,5203,4,25,150,179,1.1843575418994414,0.03310373345949561,660,I can't sit on that bench alone since he left me.
4634,5204,3,29,158,190,1.1842105263157894,0.031019362077526157,660,"Gee, those pigeons really know how to find the cheapest real estate!"
4972,5205,5,20,138,163,1.1840490797546013,0.03613458290579025,660,I need to focus on the visionary conceptualization paradigm while my staff prefers to attend to infrastructure implementation.
2019,5205,3,24,136,163,1.1840490797546013,0.033973921729726284,660,"ErNesto, you?"
2208,5207,5,22,147,174,1.1839080459770115,0.03463744014705363,660,It beats morning TV.
3892,5207,3,26,145,174,1.1839080459770115,0.03266298706227227,660,"Gee, Frank. I don't know what to say. It started from a seedling, now I'm here. I've really come up in the world."
4539,5209,6,22,157,185,1.1837837837837837,0.03417284784314403,660,"You are absolutely out of your tree.

Last time I checked, this tree was absolutely mine."
3049,5210,2,25,131,158,1.1835443037974684,0.033402796331812465,660,"Hi, my name’s Cindy Waxwing, what’s yours ?"
5001,5210,4,21,133,158,1.1835443037974684,0.03573511036713668,660,"Yes, I know its getting cold, but its going to be a big nest egg."
1116,5212,4,23,142,169,1.183431952662722,0.03425412292803422,660,Hey...I like it here...I've found my niche...see ya!!
1262,5212,2,27,140,169,1.183431952662722,0.03213191841922153,660,Heavenly Bed
5363,5212,3,25,141,169,1.183431952662722,0.03320997680568587,660,"""Well...you always said being on nest is the best policy."
2252,5215,5,23,152,180,1.1833333333333333,0.03386448327981418,660,So when she wins I'll have the best seat in the house.
2232,5215,3,27,150,180,1.1833333333333333,0.03197900459594134,660,Its for kids who want to fly away.
747,5217,1,26,126,153,1.1830065359477124,0.03270552817959627,660,How much is the rent?
3992,5218,3,24,137,164,1.1829268292682926,0.03378477261230318,660,I am filling in for the storks.
5178,5218,2,26,136,164,1.1829268292682926,0.03265875321223691,660,This Airbnb was overbooked for the summer. So I opted for a winter vacation instead.
265,5220,4,24,147,175,1.1828571428571428,0.033488262987455164,660,Rent is too damn high!
1080,5220,3,26,146,175,1.1828571428571428,0.03249280401758472,660,Say I'm a bird...
5588,5220,2,28,145,175,1.1828571428571428,0.03146586830096033,660,So you want to be a lawyer .   Step forward to the bench and look up to justice.
3544,5223,2,30,154,186,1.1827956989247312,0.030392638486658855,660,"Hi, are you the worm by any chance?"
4065,5223,4,26,156,186,1.1827956989247312,0.03224837595471029,660,It's like you don't even care if we're late to brunch!
342,5225,3,30,164,197,1.1827411167512691,0.030288043524955916,660,My nest is my crib.
1650,5226,3,23,133,159,1.1823899371069182,0.03438977042904448,660,That's not what I meant when I said it's time to feather your nest.
4252,5226,5,19,135,159,1.1823899371069182,0.03663167075035478,660,This is so liBIRDating.
1410,5226,5,19,135,159,1.1823899371069182,0.03663167075035478,660,Come on up!  The feathers are fine!
4640,5229,6,19,145,170,1.1823529411764706,0.036054575768074866,660,My wife is at her baby shower!
1126,5229,2,27,141,170,1.1823529411764706,0.031960567215222266,660,Got any popcorn?
4545,5229,5,21,144,170,1.1823529411764706,0.035075900409562884,660,"You know the expression, ""walking on eggs? Well, I'm sitting on them."
1458,5232,3,27,151,181,1.1823204419889504,0.03181796048466113,660,"Thought I'd just check out this Bird's Eye view""            
  JK Fuller, Genoa, NV"
1855,5232,5,23,153,181,1.1823204419889504,0.03369209577651002,660,"Wow, they were right when they called you a cheep-skate."
3471,5232,6,21,154,181,1.1823204419889504,0.03459110683425089,660,"Live your best bird life, man."
4509,5232,5,23,153,181,1.1823204419889504,0.03369209577651002,660,"I'm not coming down until you apologize.""

""You've got me up a tree, and I can't be free ... it's getting to be a habit with me.""""

""Don't look at me that way.  It's called communing with nature."" 

""It's called the nesting instinct, Bob."
4982,5232,4,25,152,181,1.1823204419889504,0.03276842937353713,660,What makes you think I wanna pledge?
482,5237,5,27,171,203,1.1822660098522169,0.031332312998953796,660,The pigeons have been replaced!
4883,5238,2,28,146,176,1.1818181818181819,0.03130382024206221,660,Just getting another point of view!
3265,5238,3,24,138,165,1.1818181818181819,0.033597688558538015,660,"Honeybird..., are you nesting?
Early pregnancy symptoms...!!"
2970,5238,3,26,147,176,1.1818181818181819,0.03232435964845102,660,I'm embracing another perspective.
2190,5238,3,24,138,165,1.1818181818181819,0.033597688558538015,660,"Just found out I’m going to a parent, I’m starting to nest"
1931,5238,3,26,147,176,1.1818181818181819,0.03232435964845102,660,"I guess when I saw the Batmobile go by, I should have expected the first Robin of Spring."
840,5238,4,22,139,165,1.1818181818181819,0.03468017454517649,660,"A much better view for people watching, thanks."
1083,5238,4,22,139,165,1.1818181818181819,0.03468017454517649,660,The view up here is SPECTACULAR
693,5238,4,20,130,154,1.1818181818181819,0.03621904876770889,660,I said winter is for the birds
164,5238,5,20,140,165,1.1818181818181819,0.035729880163405225,660,My realtor actually hooked me up with this.
1113,5238,3,30,165,198,1.1818181818181819,0.030148815407320458,660,"Yes , I agree the spring is coming next week"
736,5248,5,25,163,193,1.1813471502590673,0.032296948454163636,660,"Imagine Julie and Julia, but instead of cooking, the focus is tweeting."
4408,5249,5,23,154,182,1.1813186813186813,0.03352143472487884,660,"What exactly do you mean by ""manscaping""?"
2670,5249,5,23,154,182,1.1813186813186813,0.03352143472487884,660,Just waiiting on the wings
1314,5249,3,27,152,182,1.1813186813186813,0.031658506759228815,660,The condo fee is birdseed.
1351,5249,5,23,154,182,1.1813186813186813,0.03352143472487884,660,My life's in a rut and I'm finding new ways to be free.
1268,5253,4,23,144,171,1.1812865497076024,0.03388608618971974,660,I’’m napping here!
1729,5253,0,31,140,171,1.1812865497076024,0.029547741687640065,660,The rent is so much cheaper here.
2328,5253,4,23,144,171,1.1812865497076024,0.03388608618971974,660,"Do come up, I'm running low on food."
4627,5253,3,25,143,171,1.1812865497076024,0.032855249012185436,660,I’m designing a new merit badge.
4713,5253,4,23,144,171,1.1812865497076024,0.03388608618971974,660,Our baby will hatch in another two weeks.
8,5258,3,23,134,160,1.18125,0.03419316544125568,660,There’s nobody here but us chickens.
4340,5259,1,23,114,138,1.181159420289855,0.034475574592088394,660,And I'm not even buying anything at West Elm!!!
1317,5260,1,32,155,188,1.1808510638297873,0.02913937138614138,660,"wow, top floor with a view!"
333,5260,10,14,164,188,1.1808510638297873,0.03689317830838453,660,I fucked a bird!
2277,5262,3,26,148,177,1.1807909604519775,0.03215762794384648,660,"Yeah, there were some other eggs but I pushed them out and now it's just me and an unending stream of natures bounty."
654,5263,2,26,138,166,1.180722891566265,0.0323014694826967,660,"So, smart guy. Are you going to tell me I've talked myself into a corner again?"
2901,5263,6,18,142,166,1.180722891566265,0.03654397804362194,660,I lease this every winter
3308,5263,3,24,139,166,1.180722891566265,0.033412636544717184,660,Yeah well the girl last night asked me to come to her nest for a while.
3776,5263,2,26,138,166,1.180722891566265,0.0323014694826967,660,Best B&B offer ever!
2427,5267,3,22,130,155,1.1806451612903226,0.03482070629799701,660,When spring comes I go into stealth mode.
1710,5267,5,18,132,155,1.1806451612903226,0.03714910427202945,660,I missed Spring last year.
5490,5267,3,22,130,155,1.1806451612903226,0.03482070629799701,660,To get that nest egg you said I needed I figured I'd better have a nest to put it in.
334,5267,5,18,132,155,1.1806451612903226,0.03714910427202945,660,What am I doing? Grow up man! The Easter Bunny has always relied on the gig economy.
656,5267,5,18,132,155,1.1806451612903226,0.03714910427202945,660,I'll bet it's rent protected
948,5272,10,17,178,205,1.1804878048780487,0.03468859596594774,660,I know your sleeves are taped to the back of your head and you’re masturbating Larry.
5710,5273,3,27,153,183,1.180327868852459,0.03150062042067287,660,I’m a full nester! Get it?
1452,5273,5,23,155,183,1.180327868852459,0.03335247468541924,660,My ovaries love it !
4056,5275,3,25,144,172,1.180232558139535,0.03268067226221355,660,"I finally found an apartment with a view we can afford!

Leslie Hardin
Summit, New Jersey"
4082,5276,4,21,136,161,1.1801242236024845,0.03512201309968182,660,"Gee, Huck, you sold out."
4147,5276,4,21,136,161,1.1801242236024845,0.03512201309968182,660,"Hell, I wont even look at Airbnb anymore. The properties on VRBO are just so much better..."
3514,5278,4,28,168,200,1.18,0.0307036409541148,660,My wife is pregnant and my therapist said nested was to be expected.
1289,5279,5,24,160,189,1.17989417989418,0.032652450695262666,660,You don't want to know what we do with our kids up here
2920,5279,3,28,158,189,1.17989417989418,0.030880543320137236,660,"There’s room for two, want come try it ?"
2229,5281,1,23,115,139,1.1798561151079137,0.03425145529277146,660,I figure this is the place to be when it trickles down...
3787,5282,5,22,151,178,1.1797752808988764,0.033918805056827706,660,Hi there! Don't walk under that branch..
5209,5282,3,26,149,178,1.1797752808988764,0.03199258339592875,660,"What do you mean I have to get a job, an apartment and get married ? I'm this tree now."
3653,5284,2,26,139,167,1.1796407185628743,0.03212569689886557,660,Just wait till I fly down !
1742,5284,4,22,141,167,1.1796407185628743,0.03429796109134218,660,Hey..it beats flipping burgers!
1170,5286,7,14,135,156,1.1794871794871795,0.03910408951722324,660,"""Boy Scouts are allowing girls to be Eagle Scouts now.  Please take my picture so I can send it in with my application.""

Joan Black:  Easton, Connecticut"
2064,5286,3,22,131,156,1.1794871794871795,0.03461615046789343,660,I'm a 'sanctuary city' of one.
5129,5286,7,21,167,195,1.1794871794871795,0.03360369423740448,660,I was just wondering what it would be like to be LBJ's wife.
11,5289,2,29,153,184,1.1793478260869565,0.030382022456092752,660,Keep Calm. Spring is Coming.
2528,5289,2,29,153,184,1.1793478260869565,0.030382022456092752,660,"Sorry, I'm not ready to empty-nest."
1192,5291,4,23,146,173,1.1791907514450868,0.03352577978977138,660,"'Free at last! Free at last! Thank God A'mighty, I'm free at last!'"
2223,5291,3,25,145,173,1.1791907514450868,0.03250791558046369,660,I'm ready to commit.
2478,5291,2,27,144,173,1.1791907514450868,0.03145713337640391,660,My rent was too damn high.
4536,5291,5,21,147,173,1.1791907514450868,0.03451363854533352,660,Your little birdie is about to hatch!
5569,5295,4,28,169,201,1.1791044776119404,0.03056362697195556,660,"But, they said the groundhog did NOT see his shadow!"
5206,5296,2,26,140,168,1.1785714285714286,0.03195179727300983,660,"It's not a tree. It's my dank, Central Park hizzy, brah."
3668,5296,5,20,143,168,1.1785714285714286,0.03513937033107813,660,"Congratulations, you caught me in the rye."
3058,5298,0,33,152,185,1.1783783783783783,0.028222671709094788,660,"Actually, the view is not bad from here."
2247,5299,3,22,132,157,1.178343949044586,0.03441395302457576,660,I really don’t see what’s so hard to understand. It’s like shitting an egg but backwards.
1465,5300,6,19,149,174,1.1781609195402298,0.0352845676471646,660,Come down you silly old crow
2642,5300,4,23,147,174,1.1781609195402298,0.03334845090760255,660,#TreeLife
3093,5300,3,25,146,174,1.1781609195402298,0.03233695115315448,660,It’s comfortable and convenient.  The rent is reasonable.
5365,5300,4,23,147,174,1.1781609195402298,0.03334845090760255,660,"After they hatch, because the view is so great, I just might stay."
5303,5304,5,16,125,146,1.178082191780822,0.0384942517371362,660,It’s only one egg!
41,5305,3,23,137,163,1.177914110429448,0.03361643628067608,660,"You know what they say: if you want to win in the jungle, you have got to dominate the high ground."
648,5305,3,23,137,163,1.177914110429448,0.03361643628067608,660,"Bet you don’t see this everyday.”
“Sir, this is New York. Not much room to branch out of the ordinary."
4494,5307,4,16,115,135,1.1777777777777778,0.039154506304142495,660,Well that makes it more difficult to get Robin’s eggs.
3741,5307,5,22,153,180,1.1777777777777778,0.03357043750218141,660,No collusion!
1234,5309,2,23,127,152,1.1776315789473684,0.033788825162162535,660,"The cool thing is, now I don't have to fly south for winter!"
1454,5309,2,23,127,152,1.1776315789473684,0.033788825162162535,660,No matter you migrate or not... global warming will catch you anyway.
2542,5311,2,26,141,169,1.1775147928994083,0.031779741436972875,660,Your parents must be proud of you.
2788,5311,1,28,140,169,1.1775147928994083,0.030651420646785114,660,"Oh, hey Bill! Monday's, am I right...?"
3301,5311,1,28,140,169,1.1775147928994083,0.030651420646785114,660,Beats sitting in front of a fireplace!
4207,5314,5,23,158,186,1.1774193548387097,0.032855553500504966,660,Wanna mate?
3797,5315,5,26,172,203,1.1773399014778325,0.031082097021835405,660,Sing Baby Sing!
2491,5316,4,17,120,141,1.177304964539007,0.038041847516096454,660,I have always wanted the carefree life of a bird.
1420,5317,3,25,147,175,1.177142857142857,0.032167751717019286,660,"Thank you, Nest!"
4442,5317,4,23,148,175,1.177142857142857,0.03317296633585226,660,It’s the new piney house trend.
5236,5319,7,20,165,192,1.1770833333333333,0.03383370891477331,660,Sup bitch?
4696,5320,4,21,139,164,1.1768292682926829,0.034529365645152806,660,Is the President going to pass through here?
3933,5321,3,26,152,181,1.1767955801104972,0.03150732491858998,660,The movie Failure to Launch is based on me.
2502,5322,3,24,143,170,1.1764705882352942,0.032692111978621624,660,Is this some kind of meet-cute?
2600,5322,2,26,142,170,1.1764705882352942,0.031609500808276896,660,"1. ""No, I'm not... but I do live on a bundle of sticks""

2. ""...and I get to work from home, so that's nice."""
4555,5322,1,22,113,136,1.1764705882352942,0.03443024102239456,660,... and an egg once over easy on an English muffin.
5177,5325,4,26,163,193,1.1761658031088082,0.03117342201682567,660,Thanks for your concern John but I just love the alone time without the 'snowbirds'
393,5326,5,21,150,176,1.1761363636363635,0.03396893764767235,660,"Your crotch, my crotch, what does it matter."
3195,5326,2,27,147,176,1.1761363636363635,0.03096907376894338,660,"Hurry up here, Jeff! My mama bird will bring us some premium, pre-chewed worms soon!"
5244,5328,3,22,134,159,1.1761006289308176,0.034016474645773204,660,"Horton came down with the flu and needed to mend, so I have been nest-sitting all this weekend."
4227,5328,4,20,135,159,1.1761006289308176,0.035167201242443775,660,The eagle went south for the winter
4216,5328,4,20,135,159,1.1761006289308176,0.035167201242443775,660,"Sir, can I interest you in a gluten-free worm?"
664,5328,6,16,137,159,1.1761006289308176,0.037362481649731924,660,Caw! Caw!
64,5328,4,20,135,159,1.1761006289308176,0.035167201242443775,660,Empty Nesters find new home.
3829,5328,6,16,137,159,1.1761006289308176,0.037362481649731924,660,"So, has looking up always helped you?"
2075,5334,2,28,152,182,1.1758241758241759,0.030365003936720567,660,A Philadelphia Eagle got Patriotic and flew North
4384,5334,4,24,154,182,1.1758241758241759,0.03230261599108085,660,It's one of those equal rites of spring.
4874,5334,2,28,152,182,1.1758241758241759,0.030365003936720567,660,keeping the nest warm for the Kebler Elf
5025,5337,5,19,141,165,1.1757575757575758,0.035396095875339095,660,"You said I act like a bird, so I found myself  a nest"
414,5338,3,27,158,188,1.175531914893617,0.030733924136983403,660,"Hey, the food’s not great but the rent’s chip."
1559,5338,2,29,157,188,1.175531914893617,0.029794039662705617,660,Nesting is the newest resodental trend!
3781,5340,4,22,145,171,1.1754385964912282,0.03355798503060304,660,I was inspired by that lady in Berkeley.
5331,5340,3,24,144,171,1.1754385964912282,0.032516748141684995,660,No I’m all good- just nestled up.
5084,5340,3,24,144,171,1.1754385964912282,0.032516748141684995,660,"When I said we’re just ‘resting’, not ‘nesting’, she flew the coop."
3531,5340,3,24,144,171,1.1754385964912282,0.032516748141684995,660,"I've been reading a lot about making the city great again, so I'm looking for a new perspective."
1530,5340,2,26,143,171,1.1754385964912282,0.03144104737608739,660,"It's the nesting season, right?"
3330,5340,2,26,143,171,1.1754385964912282,0.03144104737608739,660,I wanted to see what you looked like from a birds eye view.
1399,5340,1,28,142,171,1.1754385964912282,0.03032721567340082,660,Really? The saying says two in the bush. This is a damn tall tree.
3426,5340,1,28,142,171,1.1754385964912282,0.03032721567340082,660,"You know. The ‘catbird’ seat!

Digger Smith, Woodbridge, Va."
1426,5348,3,21,130,154,1.1753246753246753,0.0346360132677686,660,Told you the early bird gets the worm.
1495,5348,2,23,129,154,1.1753246753246753,0.03338818619304481,660,Doing my bit for magic after storks removed from DUMBO.
509,5350,4,26,164,194,1.175257731958763,0.03102560974166252,660,the sublessor's south for the winter
3292,5351,5,21,151,177,1.1751412429378532,0.03379113344413133,660,I bet we could hatch something extra special
3293,5351,5,21,151,177,1.1751412429378532,0.03379113344413133,660,There’s a baby bird tickling my taint right now. What have YOU accomplished today?
4712,5351,4,23,150,177,1.1751412429378532,0.032827417870604975,660,Spring is on the way; I'm Nesting
5511,5354,4,24,155,183,1.174863387978142,0.032139978059365595,660,Some people pray for Spring; I  pray for constipated birds!
4650,5354,4,24,155,183,1.174863387978142,0.032139978059365595,660,What? I’m nesting! And it feels GREAT!
1288,5356,3,19,121,143,1.1748251748251748,0.03621331315291399,660,That was the last straw and I'm feeling a bit under the weather.
267,5357,2,25,139,166,1.1746987951807228,0.03193511524907163,660,'Catcher in the Rye pt. 2'
2588,5357,4,21,141,166,1.1746987951807228,0.03414513561588319,660,"You see, tomorrow, the ground will turn to tar, trapping all who stand on it. I am simply taking a precaution against this and you are welcome to join me."
3731,5357,5,19,142,166,1.1746987951807228,0.03519814819496672,660,"It's even cheaper than rent control, but the worm eating sucks."
4379,5360,7,19,163,189,1.1746031746031746,0.03406743782056705,660,"I'm Emily,  the thing with feathers."
5045,5361,6,18,148,172,1.1744186046511629,0.03535651315658309,660,"After hatching, it will be my ample breasts providing nutrients for the young ins. It’s only fair that you climb up here and drape your ample scrotum over the eggs while I slip out for pizza and beer."
4624,5361,4,22,146,172,1.1744186046511629,0.0333778985345532,660,Custom home have organic homier feel.   Chirp if you agree.
2339,5361,6,18,148,172,1.1744186046511629,0.03535651315658309,660,I fuck birds now.
1401,5361,5,20,147,172,1.1744186046511629,0.03438144218306267,660,Trading from the catbird’s seat again Larry?
1656,5361,4,22,146,172,1.1744186046511629,0.0333778985345532,660,"I made it passed the ""Par"", now go home and teach me the ""Cor"" part."
997,5361,4,22,146,172,1.1744186046511629,0.0333778985345532,660,"Sorry sir, my mom's not home yet. She's bringing back groceries and larva tonight"
4515,5367,3,26,155,184,1.173913043478261,0.03103637848206145,660,"... and a steady diet of worms, of course."
899,5368,7,15,145,167,1.1736526946107784,0.03700616780198631,660,"What's the elephant in this park, Fred?"
1094,5368,4,21,142,167,1.1736526946107784,0.03395617550182303,660,My wife has started nesting and I thought I’d help
5654,5368,5,19,143,167,1.1736526946107784,0.035002381656157724,660,I finally figured out that housekeeping is for the birds - but birds don't keep house!
473,5371,4,22,147,173,1.1734104046242775,0.033199713745508355,660,It's a Bird! It's a plane! Its a middle aged woman that thinks minion memes are funny!
2130,5371,1,28,144,173,1.1734104046242775,0.03000968156123336,660,“It’s my own Green New Deal right of shelter.”
2887,5373,3,20,127,150,1.1733333333333333,0.03507316311749439,660,Nest control!
1840,5374,3,29,170,202,1.1732673267326732,0.02933328221246812,660,Easter is Coming.
3089,5375,2,27,150,179,1.1731843575418994,0.03049570835156888,660,Talk about a fowl playing!
5468,5375,2,27,150,179,1.1731843575418994,0.03049570835156888,660,Mr. Byrd was still adjusting to being an empty nester.
2443,5377,2,23,131,156,1.1730769230769231,0.032996806044473505,660,It's cheaper than Rbnb!
3918,5378,2,29,160,191,1.1727748691099475,0.029367554786922635,660,I need to keep the eggs warm!
4937,5378,5,23,163,191,1.1727748691099475,0.03205913406720352,660,With rents so high I found my own nest home right here.
5089,5378,6,21,164,191,1.1727748691099475,0.03290744107540022,660,I won't be  flying South in a Boeing this Winter.
3088,5381,5,19,144,168,1.1726190476190477,0.03480876081667539,660,"Help me, I’m stuck in a tree."
4410,5381,4,21,143,168,1.1726190476190477,0.03376927346216977,660,A squirrel chased me up this tree & now Im waiting for a momma bird to fly home & feed me.
1732,5383,2,26,146,174,1.1724137931034482,0.030946138440570942,660,Eagle. Inbound.
5238,5383,5,20,149,174,1.1724137931034482,0.0340144938011551,660,"Hi, this is the new house sitting"
4912,5385,4,23,153,180,1.1722222222222223,0.03232224037047978,660,"My wife's expecting a baby and, unexpectedly, I'm starting to nest."
2721,5386,4,20,139,163,1.1717791411042944,0.03436826902782694,660,"And what are you doing, porcupine?"
1851,5387,3,23,143,169,1.1715976331360947,0.03251875319921336,660,"The consulting room was very boring, Doc."
1988,5387,4,21,144,169,1.1715976331360947,0.03358439649250876,660,You look awfully comfortable up there
3367,5387,5,19,145,169,1.1715976331360947,0.034617250987054426,660,"Know any Hall & Oates?"""
4705,5387,2,25,142,169,1.1715976331360947,0.03141698476137809,660,You can add this to your bird watching record.
161,5391,5,18,141,164,1.170731707317073,0.03525176767005603,660,"Yeah, Baba Yaga's usually run around in a rustic A-frame cabin, but you wouldn't believe the rent hikes this city has."
3837,5391,6,16,142,164,1.170731707317073,0.0362974354872468,660,I had to do something ...  you would not leaf me alone.
5400,5391,2,24,138,164,1.170731707317073,0.0319098264896865,660,The doctor said it's a boy!
2880,5394,5,19,146,170,1.1705882352941177,0.03442781821109007,660,Both: “Not working—damn blissful.”
1924,5394,5,19,146,170,1.1705882352941177,0.03442781821109007,660,"Me? I’m waiting for my sister. And, fewer guys try to hit on me here. 
Besides, those that do are probably my kind of guy."
168,5396,2,26,148,176,1.1704545454545454,0.03062464610787503,660,"No way I'm coming back, it's tax-less up here!"
5169,5396,3,24,149,176,1.1704545454545454,0.03166708092274453,660,I'm not cuckoo. I forgot who I really am and decided to laugh at myself.
612,5398,4,23,155,182,1.1703296703296704,0.03199391496798187,660,Do you know Robin Meade is the sexiest women on television?
2605,5398,2,27,153,182,1.1703296703296704,0.030036395575838946,660,This Nest-in-a-Tree© has the best twig/leave memory support in the park!
4203,5400,1,23,123,147,1.1700680272108843,0.03255662459241948,660,"My dating profile did say that I am a potential empty nester, after I hatch this egg."
3233,5401,7,13,139,159,1.169811320754717,0.03807269450483687,660,"I'm filling in for this elephant, who was off to find some bird..."
3842,5401,5,17,137,159,1.169811320754717,0.03592084457607615,660,"My parents kicked me out of their nest, so I made my own."
5137,5401,0,27,132,159,1.169811320754717,0.02987054729258538,660,"Ever since I became a treehugger, I feel I’ve really been helping nature."
1400,5404,4,20,141,165,1.1696969696969697,0.033982129150040376,660,"$1,500/month! Now let me see your display...DANCE!!!!!"
885,5405,3,23,145,171,1.1695906432748537,0.03216843321960582,660,"What are you looking at?  Never seen a bird nesting yet? It’s much safer up here, no one can mug me or steal anything from me, or attack me. Frankly it’s so much better up here than down there."
3880,5405,3,23,145,171,1.1695906432748537,0.03216843321960582,660,Spare eggs?
377,5405,2,25,144,171,1.1695906432748537,0.03108067962898875,660,What? Have you not heard of a high roost building?
3701,5408,4,23,156,183,1.169398907103825,0.031832215036390776,660,I’ve decided to lay my eggs BEFORE I harvest them
2586,5408,6,19,158,183,1.169398907103825,0.0336658342370606,660,"Freddy took a walk in the park with the desire to find the perfect tree. In his standards, the perfect tree was one that had an even amount of  branches and a bird's nest in it. He wondered around and found the perfect one. He laid there, satisfied."
706,5410,2,28,159,189,1.1693121693121693,0.029337505930974915,660,Global Warming has caused you to do this?
3070,5410,4,24,161,189,1.1693121693121693,0.0311971767137617,660,Still waiting for the stork?
4053,5412,3,18,121,142,1.1690140845070423,0.03599663546847113,660,It’s Rosen-steen
2661,5413,5,15,128,148,1.1689189189189189,0.03761177313491139,660,I killed a bald eagle for this spot!
833,5414,1,25,134,160,1.16875,0.03099740681992202,660,This is way easier than carrying them inside
4024,5414,2,23,135,160,1.16875,0.032240589041780954,660,Waiting for Vitro.
1120,5416,2,24,140,166,1.1686746987951808,0.03155754055052784,660,Back home for the job hunt
3227,5416,5,18,143,166,1.1686746987951808,0.03485593803043552,660,"Just sent in my application for Sky Patrol, Robin. You still working undercover for the Batman?"
4042,5418,4,21,147,172,1.1686046511627908,0.0330415962080655,660,"Treetop Inn manager, Mr. Chim Pan Zee, 
""Good Morning Sir, Welcome to climb down for Breakfast at our Floating Restaurant. Today's Special, ""Fruits n' Nuts"", Thank You."
3223,5418,5,19,148,172,1.1686046511627908,0.034055051548649885,660,Just waiting for my nest egg to hatch!
2703,5418,3,23,146,172,1.1686046511627908,0.031996056381568286,660,"I'm warming up for my roll in our garden clubs producton of Shakespeares' ""Omelette."""
1849,5418,2,25,145,172,1.1686046511627908,0.030915176984260412,660,It's got in-unit laundry!
843,5422,4,22,152,178,1.1685393258426966,0.032336301486913605,660,I'm like Nelly Furtado: I'm like a bird; I'll only fly away.  I don't know where my soul is; I don't know where my home is.
3966,5422,5,20,153,178,1.1685393258426966,0.03330339871426614,660,There's a much better view of the outline from here.
2627,5424,5,21,158,184,1.1684782608695652,0.03259631902605831,660,"Grounded, like a Boeing 737 MAX."
1115,5425,3,26,161,190,1.168421052631579,0.030135000395527956,660,I’m staying on the Iron Throne until GOT ends.
2356,5425,7,18,165,190,1.168421052631579,0.033628818281141865,660,Got milk?
1286,5427,6,21,169,196,1.1683673469387754,0.03212509788228065,660,I ate the crows.
4812,5428,1,25,135,161,1.1677018633540373,0.030822101306334185,660,Our parenting style will now be nesting.
3247,5429,3,22,142,167,1.1676646706586826,0.032513331147612276,660,In a few years you'll never see me again.
884,5430,6,18,155,179,1.1675977653631284,0.03406436905427044,660,"With the baby on the way, we've both surrendered to our evolutionary urges... my wife has her's in our cold water walkup while I prefer a bit of open sky."
4119,5431,5,23,169,197,1.16751269035533,0.031152489519957353,660,All the sushi I want! What's not to like?
5551,5432,5,18,145,168,1.1666666666666667,0.03446882635796003,660,"""The City said my apartment was no longer rent-controlled.  So I decided I'd show them.""
John Canning
Sea Cliff, N"
4637,5432,0,28,140,168,1.1666666666666667,0.028838689175249285,660,"If you think you can provide for me better, I'm ready to listen now. These porcupine quills aren't that soft."
4621,5432,1,28,151,180,1.1666666666666667,0.028948036665992435,660,"'A little birdie told me to nest here,I'll be home later then usual!"""
4307,5432,3,21,138,162,1.1666666666666667,0.0330561282434399,660,"The bottom number of my paycheck was less than half of of the number on the top and some recipient of the dole called me “privileged”.

That’s when I checked out."
3261,5432,4,22,154,180,1.1666666666666667,0.03200325867951587,660,Aha! It looks like method tweeting is already boosting engagement.
3110,5432,5,17,140,162,1.1666666666666667,0.03529971794008837,660,"If you wanted, Mom should be back soon with more worms."
3976,5432,3,23,148,174,1.1666666666666667,0.0316567252175656,660,I get the freshest worms in New York City!
2449,5432,2,27,157,186,1.1666666666666667,0.02944479628536002,660,Hi Dan. There is room for one more up here!
1696,5432,5,20,155,180,1.1666666666666667,0.0329587896097353,660,The new Drake album changed my life.
1373,5432,4,18,134,156,1.1666666666666667,0.035027264972095955,660,Hey! Want to spread your wings?
1101,5432,2,24,142,168,1.1666666666666667,0.031212849793091055,660,"Cliff, you should really consider ""Tree Nesting""  it elevates your sense of your surroundings."
645,5432,3,22,143,168,1.1666666666666667,0.03233462527439859,660,This new 'regurgitated-worm-only' diet has done wonders for my indigestion
459,5432,2,21,127,150,1.1666666666666667,0.03333333333333334,660,Peon.
3029,5432,3,24,153,180,1.1666666666666667,0.031018306202583324,660,"Pretty good aim for no hands, don’t you think?"
368,5446,4,25,170,199,1.1658291457286432,0.03002783600687777,660,Oh look it's a boy in a tree...
1594,5447,3,25,159,187,1.1657754010695187,0.03026580090009372,660,Tell me more about your mom and her box of chocolates.
2941,5447,6,19,162,187,1.1657754010695187,0.032992752581846564,660,It's laying season.
4366,5447,1,29,157,187,1.1657754010695187,0.028302238278780967,660,Where else will I finally meet one of those nesting dolls...
2033,5450,1,28,152,181,1.1657458563535912,0.028802381384194983,660,My mother was a pigeon.
5704,5451,2,24,143,169,1.165680473372781,0.03104327750716642,660,"Oh, it was a little birdie told me about the cheep rent."
5059,5452,4,19,140,163,1.165644171779141,0.03400126493071554,660,So this is where the ducks go in the winter.
3977,5453,5,14,126,145,1.1655172413793105,0.03792232571568649,660,Early start.
1905,5454,5,19,152,176,1.1647727272727273,0.033333025874221545,660,In a few short weeks I'll be regurgitating worms !!
4493,5454,5,19,152,176,1.1647727272727273,0.033333025874221545,660,This was an open space- I don't care if the bushes have two!
2718,5456,3,22,145,170,1.1647058823529413,0.03198298108067382,660,You can’t hug this
89,5457,3,21,140,164,1.1646341463414633,0.03268318924499519,660,I'm Eddie the Eagle Jr.
381,5457,5,17,142,164,1.1646341463414633,0.03489733882975379,660,"This home is roomy. I think the rooms are invisible. maybe that's why I can't find any rooms. Oh well. Time to shower, and after, to cook the eggs the past owner left for me."
1222,5457,1,25,138,164,1.1646341463414633,0.030307712897044817,660,I'm nesting instead of cocooning...you should try it some time!
1444,5457,3,21,140,164,1.1646341463414633,0.03268318924499519,660,Come on up if you want to make a batch of eggs with me.
4052,5457,5,17,142,164,1.1646341463414633,0.03489733882975379,660,It’s not cheap but the sap is free
4015,5462,7,16,160,183,1.1639344262295082,0.03425523641423767,660,I'm a bird!
4088,5463,2,25,150,177,1.1638418079096045,0.03011309553045346,660,And it makes a nice umbrella during spring and summer!
671,5464,1,26,144,171,1.1637426900584795,0.029568159339520936,660,This is so much better than the bird nest on the ground you seem to be so proud of!
1604,5465,1,25,139,165,1.1636363636363636,0.03013999007208509,660,My wife wishes I were more of a nester.
3707,5466,3,25,162,190,1.1631578947368422,0.029824561403508767,660,"With OK Cupid, I don't climb down without first taking a good look."
2500,5467,2,26,156,184,1.1630434782608696,0.029402002914214596,660,You are a hard egg to crack.
3809,5467,4,22,158,184,1.1630434782608696,0.031357149708681024,660,How about I just do this for wilderness therapy?
1254,5469,2,25,151,178,1.1629213483146068,0.0299575870331582,660,I'm waiting for my mom to come back
5370,5470,2,24,146,172,1.1627906976744187,0.030545307195829943,660,"So the hell what, it’s not like this is weirder than any of the anime you watch in your free time bro"
5522,5471,2,23,141,166,1.1626506024096386,0.03116833761402348,660,I'm sick of those Audubon walks.
3286,5472,2,22,136,160,1.1625,0.03183030378418828,660,"Hey Shaun, why are you up there? You told me to lay some chicks so I'm laying on some chicks"
5105,5472,6,14,140,160,1.1625,0.03643670742258063,660,IT'S MORE COMFORTABLE UP HERE
2590,5472,2,22,136,160,1.1625,0.03183030378418828,660,'I'd rather be a bird.' No John. You wouldn't.
4771,5475,4,22,159,185,1.162162162162162,0.031199641038234128,660,How did people enjoy walks before Instagram?
2144,5476,3,23,153,179,1.1620111731843576,0.03083875298237478,660,It's really just a marketing gimmick.  I'm the blowbird of happiness.
3146,5476,3,23,153,179,1.1620111731843576,0.03083875298237478,660,"Your passion?"" Really?"
3270,5478,2,24,147,173,1.1618497109826589,0.030382806616756068,660,"Seven months to go.  It feels surprisingly comfortable, but could we get a hot tub anyway?"
1124,5479,4,19,144,167,1.1616766467065869,0.03324258230812478,660,You just confirmed that age-old question: If a tree farts in a forest...
1644,5479,2,23,142,167,1.1616766467065869,0.03099644406584422,660,You can just think of me now as one of your major diversified assets.
5576,5479,4,19,144,167,1.1616766467065869,0.03324258230812478,660,"The stork, not the Easter bunny."""
5493,5482,4,18,139,161,1.1614906832298137,0.03401294638200013,660,By asking that question you have just concluded the most boring cartoon caption set-up ever!
592,5483,3,25,164,192,1.1614583333333333,0.029537405509687996,660,What you're seeing is my angst over an empty next.
3044,5484,3,24,159,186,1.1612903225806452,0.03009299271390184,660,This nesting thing is good
585,5484,1,23,131,155,1.1612903225806452,0.03101936766469806,660,Bear Grylls- Urban edition
2049,5486,3,23,154,180,1.1611111111111112,0.030680153386987707,660,I call it my Buttinest!
5191,5486,5,19,156,180,1.1611111111111112,0.032640746080790956,660,It brings a whole new meaning to liquid lunch
4720,5488,4,25,176,205,1.1609756097560975,0.029212444724511004,660,"I'm doubling down after you said I was ""getting out of hand,"" Roger."
2472,5489,6,19,168,193,1.160621761658031,0.03203176947895916,660,What?  I couldn't pay the rent!
4831,5490,5,16,141,162,1.1604938271604939,0.03493240621735296,660,"Come on, Michael, it's cold outside."
1076,5491,3,24,160,187,1.160427807486631,0.02994405963392672,660,I got White woke.
5560,5491,1,28,158,187,1.160427807486631,0.027957909342884352,660,It’s actually not that bad. The birds promised me the my wouldn’t poop here
4492,5493,3,19,134,156,1.1602564102564104,0.03341197696110685,660,"No empty nest, here! Whoops, sorry, you aren't my father."
3634,5493,2,21,133,156,1.1602564102564104,0.032150384422441086,660,"Just hanging 'til my friends fly in."""
3768,5495,2,25,154,181,1.160220994475138,0.029500440196183513,660,I kept hearing from more of my Facebook friends being afflicted with this 'empty nest syndrome' and could no longer bear to remain a bystander with this level of suffering in the world.
4034,5495,1,27,153,181,1.160220994475138,0.028440967240295576,660,This red robin is ready to go bob-bobbing along.
2595,5495,4,21,156,181,1.160220994475138,0.03151270664634613,660,"It’s time, son, we’ve delayed adulthood post launch long enough. So spread those flabby arms and embrace all the disappointments we mortals must face, for with you the burden will lighten and  hurry, because uncle Frank wants to sublet your room."
2976,5495,4,21,156,181,1.160220994475138,0.03151270664634613,660,Those other birds may be in the sun now but they will be jealous in a few weeks.
1195,5499,3,22,150,175,1.16,0.03113612256012007,660,I am trying to get us a nest egg so we can marry!
3279,5500,1,29,164,194,1.1597938144329898,0.02736900308388113,660,Ha! Early boy catches a nest!
1440,5501,3,21,145,169,1.1597633136094674,0.03178629869309073,660,"ZE CREPE MYRTLE SEASON BE WIZ YOU, AMBROISE !"
1677,5501,3,21,145,169,1.1597633136094674,0.03178629869309073,660,when your so tired that you don't even care where you sleep.
1834,5501,0,27,142,169,1.1597633136094674,0.02826732477972268,660,"I'm just hanging out here until they schedule my flying lesson.

submitted by:
Tom Seessel
109 Featherbed Ln
Hopewell, NJ 08525
(609) 466 2267
tseessel@verizon.net"
5305,5504,4,22,162,188,1.1595744680851063,0.03073638550920031,660,"Fine, as long as you don’t complain of hatchdaches later."
1761,5505,5,16,142,163,1.1595092024539877,0.03473139523614724,660,This ISN'T what the Swedes meant?
1958,5506,1,27,154,182,1.1593406593406594,0.028297963205949506,660,I'm babysitting the eggs in my down coat.
639,5507,2,21,134,157,1.1592356687898089,0.031961252340322946,660,"We're not much different than the birds in the cirrrcle of liiiife."""
1986,5508,2,24,150,176,1.1590909090909092,0.029905399843297275,660,I'm really so over Florida this winter!
2731,5509,2,23,145,170,1.1588235294117648,0.030491829120056917,660,I got really excited when you told me about... what was it... Clucking season?
960,5510,1,27,155,183,1.1584699453551912,0.028156371004589082,660,It's a gender thing.
2410,5510,2,25,156,183,1.1584699453551912,0.029203261265228136,660,"... although, the only eggs I get to eat are cuckoo eggs ..."
566,5512,2,21,135,158,1.1582278481012658,0.03177430880270852,660,It's like a bird version of Cleopatra--you're supposed to feed me worms now.
2808,5513,3,22,152,177,1.1581920903954803,0.03080968505641956,660,Birds of a feather ...
794,5514,2,23,146,171,1.1578947368421053,0.03032721567340082,660,Have you seen my gravity blanket?
4726,5514,2,20,130,152,1.1578947368421053,0.03247819221404412,660,"Rodan, hm? What type of bird is that?"
2018,5516,3,23,158,184,1.1576086956521738,0.030061584363131708,660,Is it plagiarism to say “This is the best nest!”?
4880,5516,6,17,161,184,1.1576086956521738,0.03289207272504138,660,"Said “There’s plenty of trees for you to climb on right here at the dog park you tree hugging fucker” and you know what? She’s right! Now I just watch old cow Janice walk her sickly inbred every morning with the biggest scowl on her face, it’s great!"
3719,5518,4,20,154,178,1.1573033707865168,0.03166766342919237,660,The views of redacted information on peripheral people are so much better from up here.
206,5518,3,22,153,178,1.1573033707865168,0.03064899566047467,660,"I can't say, Piper hires new babysitters herself."
3777,5520,1,25,146,172,1.1569767441860466,0.029015316881404195,660,I keep an eagle eye on everything in the park.
364,5521,2,25,158,185,1.1567567567567567,0.028911944424019904,660,Florence Nightingale sang in Berkeley Square.
3272,5522,1,26,152,179,1.1564245810055866,0.028356589292334325,660,"The empty nest is something I'm not considering, so get over it!"
4437,5522,4,20,155,179,1.1564245810055866,0.031502511839657445,660,I'm woke!
4476,5522,5,18,156,179,1.1564245810055866,0.03248351814144572,660,"To get there you have to practice, practice, practice."
2540,5525,3,19,138,160,1.15625,0.032634428081803654,660,See! You still can smell my armpits from here!
4610,5525,2,21,137,160,1.15625,0.031406839128208325,660,IT'S THAT TIME OF THE YEAR...I'M IN MY 'NESTING' MODE!
629,5527,3,23,160,186,1.1559139784946237,0.029761472856674017,660,Rent is freezing to death!
3751,5528,3,18,133,154,1.155844155844156,0.03338405884446694,660,"Why don't you come up here and join me, you big phony?"
2777,5529,5,21,173,199,1.1557788944723617,0.030298438702877226,660,"You'll ruin the bird's nest, Marty!"
4391,5530,4,18,145,167,1.155688622754491,0.0328701229481563,660,"I'm hoping for a chaper in ""The Overstory, Book 2""!"
5175,5530,1,24,142,167,1.155688622754491,0.029394053513402154,660,Why pay for a Birdseye view from a helicopter?
4860,5532,3,22,155,180,1.1555555555555554,0.030332547744162656,660,You thought I meant the thermostat?
5544,5532,3,22,155,180,1.1555555555555554,0.030332547744162656,660,This nest is Taken!
2386,5534,3,24,166,193,1.1554404145077721,0.029080238757310424,660,I guess you end up living wherever fate gives you an apartment. D'Oh.
367,5535,4,17,140,161,1.15527950310559,0.033620791559563615,660,"uh, i'm The Median Millennial. I parrot the discourse of social struggle but embrace and perpetuate the mechanisms of late-stage capitalism that prevent real change. I'm a Neo-Reaganite but I live in this tree and post about it. Yass queen."
3800,5536,3,21,150,174,1.1551724137931034,0.03093688282844811,660,"Hi Dad, I'm the new Three Eyed Raven. I can see the past and the present. Want to reconsider raising my allowance?"
423,5537,0,28,153,181,1.1546961325966851,0.026953173298675064,660,"I'm doing an ornithological research on nesting habits of mockingbirds, but I couldn't even find a finch."
4717,5537,2,24,155,181,1.1546961325966851,0.029141864375473267,660,"Go ahead and sit on the bench if you want, I much prefer the comfort of a homey nest."
4767,5539,2,21,139,162,1.154320987654321,0.03104768706925454,660,"""tweet-tweet.....tweet-tweet"""
5669,5540,4,19,152,175,1.1542857142857144,0.03182169418026002,660,"Actually, many minimalists are moving to this."
2487,5540,5,17,153,175,1.1542857142857144,0.03283750394737371,660,"hey cool hat, dude...........SIKE!"
1150,5540,3,21,151,175,1.1542857142857144,0.030772370326482886,660,I tried gossamer but ended up with mohair!
1154,5543,6,16,160,182,1.1538461538461537,0.032916400111214716,660,Chicks like pricks
1207,5543,2,22,145,169,1.1538461538461537,0.03026137663344012,660,"Ican't see anyone but you...
I only have eyes for you..."
3258,5543,2,24,156,182,1.1538461538461537,0.02899376354841197,660,Now come up here and puke in my mouth! It'll be hot!
3702,5543,6,16,160,182,1.1538461538461537,0.032916400111214716,660,My friend Prometheus went rock climbing.  I’m waiting for him to come back.
694,5547,1,21,128,150,1.1533333333333333,0.030996379476340655,660,"All along, chimpanzees have been trying to show us the way."
2445,5548,4,20,159,183,1.1530054644808743,0.030858649678319375,660,I didn't like that estate agency branch...
3518,5548,1,26,156,183,1.1530054644808743,0.027786841109379685,660,Chirp off the old block but the lease is great.
2766,5550,1,24,145,170,1.1529411764705881,0.02891682408809133,660,How do you like my new TreeHouse? I found it myself.
3836,5551,2,20,135,157,1.1528662420382165,0.03151880402212705,660,"Is it the dangerous time of the month in your house too, kid?"
126,5552,2,21,141,164,1.1524390243902438,0.030696576829558155,660,"No, thanks. I'm not going back to my old priorities..."
3636,5553,2,19,130,151,1.1523178807947019,0.0322084057568909,660,"Some folks call it ""bird brain."""
1023,5554,1,24,146,171,1.152046783625731,0.028761132437775002,660,"Mom said she would be flying back with worms, but that was three months ago and the guano is piling up..."
4321,5554,3,20,148,171,1.152046783625731,0.031061256225594608,660,Winter's over already?
4341,5554,2,22,147,171,1.152046783625731,0.029933295653964274,660,"ROBIN ,my girlfriend ,is going to put in a good word for me ."
3761,5557,2,20,136,158,1.1518987341772151,0.031333623342595616,660,"It beats paying rent and I get a birds eye view of the city for free.


Elizabeth Shaw
San Francisco"
652,5558,3,24,171,198,1.1515151515151516,0.028397231283456205,660,Just waiting for your mom
2569,5558,6,13,146,165,1.1515151515151516,0.03503357127793814,660,I’m sorry about your wife’s murder.
618,5560,2,24,159,185,1.1513513513513514,0.028558268183043495,660,My parents didn't like me nesting. I'll show 'em.
1735,5560,2,24,159,185,1.1513513513513514,0.028558268183043495,660,"Some do birding, I do pooping."
4263,5560,3,22,160,185,1.1513513513513514,0.02956905626148944,660,Will you marry me ..
5541,5560,2,24,159,185,1.1513513513513514,0.028558268183043495,660,"Chuck, I'm enjoying  the view  of
Central Park.""  ""Do  you  care
to  join me?"
2152,5564,2,19,131,152,1.1513157894736843,0.03201149532800048,660,I'm hoping I can hatch out a new retirement plan
4473,5565,3,20,149,172,1.1511627906976745,0.030892789743038607,660,"It's really quite comfortable, but the rest control's a little dicey."
5062,5565,3,20,149,172,1.1511627906976745,0.030892789743038607,660,"I've been in this tree for years, you can only see me now because the leaves fell off. I've missed so much of my life. Who is president now? Last I remember it was Bush. What big things have happened in the world over the last 15 years?"
5668,5565,3,20,149,172,1.1511627906976745,0.030892789743038607,660,"You know, house prices aren't cheep these days."
3950,5568,2,20,137,159,1.150943396226415,0.03115058567286273,660,"Yes, I know.  Your 35th birthday is coming up."
2753,5569,3,21,155,179,1.1508379888268156,0.030131308423926233,660,"Well, I was about to blow and so were the winds of change. Seemed like the obvious option."
3075,5569,1,25,153,179,1.1508379888268156,0.027970597956819165,660,"The view is great, but the rent is outrageous."
4484,5569,2,23,154,179,1.1508379888268156,0.029071034530953527,660,I'm waiting for the log lady ...
4194,5572,2,18,126,146,1.1506849315068493,0.03273469562886555,660,"Dont try to get back to me , cuz I flyed away."
3187,5573,3,19,144,166,1.1506024096385543,0.03153313814048771,660,I’m glad you made it!
1063,5573,2,21,143,166,1.1506024096385543,0.030353244486533836,660,There is NO feeling like being safe as a bird in a nest!!
1111,5575,1,26,159,186,1.1505376344086022,0.02737415857843554,660,You kinda get used to eating the worms...it's protein after all
3157,5575,3,22,161,186,1.1505376344086022,0.029420908133722456,660,"A nest is not a home, when there's someone sitting there."
3254,5577,2,22,149,173,1.1502890173410405,0.029612184784950174,660,I feel more like I'm back home.
261,5578,2,23,155,180,1.15,0.028921220507697673,660,"Hey, Mister, looking for a good climb?"
1342,5578,1,25,154,180,1.15,0.02782739206652474,660,Forget down feathers. Twigs are the latest nesting theories.
1643,5578,1,22,137,160,1.15,0.02967327323795082,660,But Honey we haven't even turned the clocks ahead yet....
4914,5578,3,21,156,180,1.15,0.02997516041801379,660,I thought this would elevate my conversation skills
4833,5582,5,18,164,187,1.1497326203208555,0.031176629874492403,660,I’m writing a book about diverse habitats and the many splendors of nesting.
1528,5583,1,23,143,167,1.1497005988023952,0.028964704052902655,660,Stick around!
1181,5584,5,16,153,174,1.1494252873563218,0.03266298706227227,660,"The central park 5 were guilty. I saw it myself, but no-one cares about my testimony because I am a white pine"""
2730,5585,3,19,146,168,1.1488095238095237,0.031182247285799783,660,"The ""gig economy"" is for the birds!"
5300,5586,3,23,169,195,1.1487179487179486,0.028481333298773066,660,"Birdie, pretty bird, pretty bird!!"
2023,5587,4,18,153,175,1.1485714285714286,0.0314599037727481,660,How's the weather down there?
1251,5587,4,18,153,175,1.1485714285714286,0.0314599037727481,660,Simple Nature Bathing is so 2018.
3276,5589,4,15,136,155,1.1483870967741936,0.033995919303524184,660,Global warming might affect me down there
4295,5590,6,15,161,182,1.1483516483516483,0.032593045958388925,660,"Well, you can come down now"
1574,5591,5,14,143,162,1.1481481481481481,0.034165169635348186,660,"Tom, get down from there."
921,5592,2,17,123,142,1.147887323943662,0.03306834502771489,660,"Cute, but it’s called a ‘drey’."
2617,5593,3,20,153,176,1.1477272727272727,0.03023666976284107,660,"Nope, I can't complain. Even the earthworms for dinner are like a wriggling superfood!"
233,5594,0,22,127,149,1.1476510067114094,0.029160574426241266,660,I just felt restrained by being called a “snow” bird... it’s liberating
1669,5595,3,18,142,163,1.147239263803681,0.03165883713628662,660,"Hey, how you got this Nest?
""I booked it online with the owner Mr. Chim Pan Zee""."
4703,5595,2,20,141,163,1.147239263803681,0.030439145960144652,660,Wouldn't it be better to start free-range parenting after the child is born?
4144,5597,5,15,150,170,1.1470588235294117,0.03301927493060276,660,"It simple Steve, summer can’t end if the leaves don’t fall."
2756,5597,2,21,147,170,1.1470588235294117,0.029688913488369675,660,"Great view, near the bus line,  all my lived ones have abandoned me.  Yes,  this is quite a spot."
616,5597,3,19,148,170,1.1470588235294117,0.030839021197083684,660,"You said ""Leave me alone.""  I'm waiting for the leaves."
2886,5600,2,19,136,157,1.1464968152866242,0.031061684432245454,660,Relax. I'm in spring!
559,5601,3,23,172,198,1.1464646464646464,0.028078550451368832,660,I was expecting you.
5161,5602,5,14,145,164,1.146341463414634,0.03377126680620192,660,"My twin's having her seventh, and she's too tired to nest."
5535,5602,1,22,141,164,1.146341463414634,0.02900399395508712,660,You want me to play nasty. I'd rather play nesty.
3278,5604,4,17,150,171,1.1461988304093567,0.031772014889844685,660,John...Where are the birds?
1628,5605,1,24,153,178,1.146067415730337,0.027716042066715473,660,You sit there. I pee there. Yes??
154,5606,2,23,160,185,1.145945945945946,0.028194525026407718,660,"Ok, send for a Justice of the Peace."
3401,5607,3,19,150,172,1.1453488372093024,0.03050321367993436,660,"Isn't this great? Now we can truthfully say that Facebook encourages animal behavior .Finally, I got enough money to start my next egg"
3510,5607,4,17,151,172,1.1453488372093024,0.03159818825198822,660,"No, it's protecting me!"
4367,5609,1,24,154,179,1.1452513966480447,0.027572846598344476,660,"I was good with nesting in the city, but..."
7,5610,4,19,163,186,1.1451612903225807,0.03005402727905073,660,For a few hundred bucks we can make a thousand rental properties.  Let's fly the nest!
1884,5610,5,17,164,186,1.1451612903225807,0.03100592192562133,660,"I'm doing a Thanksgiving Day Parade special where I photo your family for you, prices starting at $299. Sign up early"""
372,5612,2,20,144,166,1.144578313253012,0.02992635507497198,660,I think you flew to the wrong nest.
564,5613,4,17,152,173,1.1445086705202312,0.031426241555757455,660,Feeding squirrels is not permitted.
5559,5613,4,17,152,173,1.1445086705202312,0.031426241555757455,660,Mom is coming up for a visit.  I hope she leaves the worms at home.
3204,5615,2,24,168,194,1.1443298969072164,0.0273262134267359,660,"Yeah well, those trees behind me say something else."
207,5616,0,22,131,153,1.1437908496732025,0.02845992579874618,660,"Good new, bad news.  We're pregnant, but I am gonna do my nesting up here.  Buh-bye."
5313,5616,3,16,134,153,1.1437908496732025,0.0326797385620915,660,Comfort over relationship
4725,5618,3,17,140,160,1.14375,0.03178009518056128,660,you know there's a branch directly up this tree
478,5619,0,24,143,167,1.1437125748502994,0.027227208959275048,660,"This is how my grandfather slept back in the Great War.""
""I'm not surprised. In fact, I think you're becoming him."
4188,5620,1,24,156,181,1.143646408839779,0.027290804497742474,660,Big Bird doesn't migrate. Why should I?
2685,5620,3,20,158,181,1.143646408839779,0.029454417640552125,660,"Want to nest here, build a tree house yourself..My lovely bird city life!"
3677,5620,2,22,157,181,1.143646408839779,0.028393227437877408,660,When the other birds fly south and stay to shit on the tourists.
239,5623,1,26,168,195,1.1435897435897435,0.02620578154730516,660,"Yeah, but it's that spring cold."
1427,5624,1,21,139,161,1.1428571428571428,0.02903353016775216,660,Call me matreshka!
1524,5624,2,21,152,175,1.1428571428571428,0.028897969786003234,660,Worm?  What worm?
3467,5624,4,19,166,189,1.1428571428571428,0.029605295486625705,660,"And they just sit here like this until the eggs hatch, pretty neat. Anyway, sorry about your door, bro. I can't pay you back for it but I swear I'll make things right with Jenny when she gets outta the hospital."
4977,5627,0,27,163,190,1.1421052631578947,0.02539751241211209,660,It’s part of my FIRE plan and it’s easier than a walk in the park.
464,5628,5,15,156,176,1.1420454545454546,0.03195413903050178,660,When you think your house is lame but go to your friends house.
174,5628,4,17,155,176,1.1420454545454546,0.03092138315544071,660,Jane and I are spending this summer at the Cape and they agreed to house-sit.
4060,5630,2,20,148,170,1.1411764705882352,0.029268708830400423,660,If babies come from storks ... Come shag the stork
3678,5630,3,18,149,170,1.1411764705882352,0.030434699947149757,660,This is a crow-deed place to sleep.
3229,5630,2,20,148,170,1.1411764705882352,0.029268708830400423,660,Thanks Obama ...
1497,5630,2,20,148,170,1.1411764705882352,0.029268708830400423,660,How's the weather up there?
1002,5634,0,23,140,163,1.1411042944785277,0.027351605518389742,660,"With good rain gear, it will be much better than subletting"
2700,5635,4,18,163,185,1.1405405405405404,0.029857645973668013,660,One flue over the Coco's nest.
94,5636,3,19,156,178,1.1404494382022472,0.029537992262332297,660,Ya think only cats eat canaries?
3571,5636,4,17,157,178,1.1404494382022472,0.03059367514631766,660,I'm urban chicken farming!
2910,5638,4,16,151,171,1.1403508771929824,0.031383410210523356,660,"Get out of that damn bird's nest, were already late for school, ya friggin idiot"
3098,5639,2,19,143,164,1.1402439024390243,0.029822151170401632,660,I made a left on Branch Blvd. off Trunk Street
4682,5639,0,23,141,164,1.1402439024390243,0.027197928271392564,660,Just think of me as a snowbird.
5280,5641,7,14,180,201,1.1393034825870647,0.03078552936199996,660,"Sophie, you do you and all, but this isn't a Sophie's Choice."
3135,5642,3,16,139,158,1.139240506329114,0.031705981198536855,660,I'm growing feathers.
4262,5643,3,20,164,187,1.13903743315508,0.028567180473107256,660,I only need fertilizer to add on.
2345,5644,3,19,158,180,1.1388888888888888,0.029229595735247336,660,"It's easier to watch storks from here.   They fly away when they see binoculars!"""
2585,5645,4,16,153,173,1.138728323699422,0.031040628896080887,660,Its the best way to realize full benefits of my high fiber diet.
3994,5646,4,20,178,202,1.1386138613861385,0.028125873714570582,660,It's like Bed Peace but in a tree.
2035,5647,3,17,146,166,1.1385542168674698,0.030699079461962847,660,I don’t think that flying idea is going to fly.
4027,5647,2,19,145,166,1.1385542168674698,0.029485829302974085,660,I am reading “Gone with the Schwinn.” I have a very active reading life.
3712,5649,2,23,170,195,1.1384615384615384,0.026844604493616118,660,I couldn't find a nested egg big enough to fit into.
5317,5650,4,16,154,174,1.1379310344827587,0.030872015846849645,660,I’m stumped.
2248,5651,2,19,146,167,1.1377245508982037,0.02932047629284022,660,"C'mon up. It will be fun!  Feggo, don't be a wimp."
4665,5652,2,18,140,160,1.1375,0.030051711197732974,660,How romantic I can be with a nest in a tree.
3305,5653,0,21,132,153,1.1372549019607843,0.0279115135940114,660,"''I'll be right down.'"""
1492,5653,2,17,134,153,1.1372549019607843,0.03083911826106076,660,"Well, Mom and I did said you were leaving our nest."
2426,5655,2,20,153,175,1.1371428571428572,0.028485914722116815,660,hey are you holding?
4759,5655,2,20,153,175,1.1371428571428572,0.028485914722116815,660,I just feel stifled living here in the city.
3588,5657,2,19,147,168,1.1369047619047619,0.029156954150628175,660,I'm channeling my inner gorilla.
2799,5658,1,22,153,176,1.1363636363636365,0.027164286575781668,660,"I'm fine,Dad.I know the way home.(NOT)"
5235,5659,1,22,154,177,1.1355932203389831,0.027021365070210444,660,"If you'll be my bee, I'll be your bird"
5032,5660,1,24,167,192,1.1354166666666667,0.025836341518262286,660,I want our hatchlings to take wing.
1343,5661,2,19,149,170,1.1352941176470588,0.02883528319702229,660,"‘’’I felt it was time to branch out, but I’ll be one for dinner.’’  






‘"
5189,5661,3,17,150,170,1.1352941176470588,0.03001811455316196,660,"Man, can't believe they finally put up the new benches!"
3543,5663,2,18,143,163,1.1349693251533743,0.02953262307080364,660,Want to help out on this nest?
4525,5664,1,22,156,179,1.1340782122905029,0.026739949244553148,660,Hey Dad...  It's like I'm a bird up here!...  Caw! Caw!
3766,5665,2,19,152,173,1.1329479768786128,0.028365779375300423,660,All nestled in for a long winter's nap
5674,5665,2,19,152,173,1.1329479768786128,0.028365779375300423,660,It's far more comfortable and the view is better.
3406,5667,4,16,161,181,1.132596685082873,0.029740890222005666,660,It's a living!
4579,5667,2,20,159,181,1.132596685082873,0.02759974352756425,660,"Look, I’m Buddha."
3101,5669,4,14,148,166,1.1325301204819278,0.03144583209182639,660,I’m subletting from Pale Male.
3676,5669,2,18,146,166,1.1325301204819278,0.029031046410554526,660,"It's urbanest living."" 

Mary Grundhoefer, Center City, M"
906,5671,4,13,142,159,1.1320754716981132,0.032310401868089825,660,No more soccer mom! I'm an empty nester and you better work twelve more years for our trip to Dubai!
4313,5671,3,15,141,159,1.1320754716981132,0.031053994476998522,660,A-well-a don't you know about the bird?
2412,5673,3,16,148,167,1.1317365269461077,0.03009124258455089,660,"Keep on looking, but you can not get in, Buster!"
5183,5673,3,16,148,167,1.1317365269461077,0.03009124258455089,660,They told me to be the bird.
3137,5675,3,17,155,175,1.1314285714285715,0.029208014992594882,660,"Till that damn bird rememberers which tree she used to lay her eggs, I’ll catch up with you dear."
3718,5675,2,19,154,175,1.1314285714285715,0.02806112426143788,660,"A cat scratched me, so now I'm instinctually nesting every chance I get!"
1871,5677,3,13,129,145,1.1310344827586207,0.032834153694449884,660,lll
801,5678,3,16,149,168,1.130952380952381,0.029921868376208874,660,Sometimes it just gets too CROWded down there.
1926,5678,3,16,149,168,1.130952380952381,0.029921868376208874,660,Leaving the next has taken on a whole new meaning.
1712,5680,3,19,169,191,1.130890052356021,0.02764164089078802,660,"So, you're protesting the new bestiality law in Kentucky?"
5375,5681,0,21,140,161,1.1304347826086956,0.026624888508512815,660,"I thought I'd take the Quattro Stagioni today, now that it's been twelve months."
577,5682,2,21,170,193,1.1295336787564767,0.026366812851074305,660,"It looks even bigger from up here, Flash"
4499,5683,3,18,165,186,1.1290322580645162,0.027961459862075724,660,I told you not to shop at Design Without Reach!
2471,5684,2,17,144,163,1.1288343558282208,0.029056770941986526,660,You have to come down sometime...you can’t do everything up there.
1708,5685,1,20,150,171,1.128654970760234,0.026985701627045326,660,The blossoms are making for a softer sleep.
3802,5685,1,20,150,171,1.128654970760234,0.026985701627045326,660,"Atta boy, son. We're going to find every last egg in this year's contest, even if it means ousting a few birds."
677,5687,1,22,164,187,1.1283422459893049,0.025670126255758152,660,I hope you’ll never be an empty nester.
5555,5688,2,17,145,164,1.1280487804878048,0.028889734755945664,660,We’re called Gen 5G
1322,5689,2,19,159,180,1.1277777777777778,0.02732719597213167,660,"Stuart, have you checked your pulse tonight?"
3932,5690,2,20,166,188,1.127659574468085,0.02663269705060434,660,"What use are birds, anyway?"
2669,5691,3,14,140,157,1.127388535031847,0.030944248531901856,660,"You reader, reading."
226,5692,1,19,145,165,1.1272727272727272,0.02740789367852445,660,"Hubert, your sperm just don't cut it."
2653,5693,0,21,145,166,1.1265060240963856,0.025878767471436286,660,"You won’t believe it, but it’s a great way to find checks."
3092,5694,3,16,155,174,1.1264367816091954,0.02894416395558567,660,"I'm just here to make fun of the birds, not to scare them."
4055,5695,2,19,161,182,1.1263736263736264,0.027044199029620807,660,Hamosi search is a breeze and I already have my spot for Sukkat.
299,5696,3,17,164,184,1.125,0.027854392640230763,660,"This was the only Airbnb listing my conscious could allow. They should be paying the hotel tax, instead of willingly allowing landlords to exploit their platform. CAW."
5323,5696,1,18,141,160,1.125,0.027685906775149413,660,"I hate to say it, but I told you so regarding the job thing."
1119,5698,3,16,159,178,1.1235955056179776,0.028326937308405103,660,I told you that you that this is a shakedown!
1493,5699,2,17,151,170,1.1235294117647059,0.027926288007618955,660,"Honey, a few more winters to go before you retire. When you do, you need to build one still higher."
902,5700,1,18,143,162,1.123456790123457,0.027364674388686814,660,Hi! I'm Nellie!
5217,5701,1,17,136,154,1.1233766233766234,0.028138528138528147,660,I was exiled from the hive with the rest of the drones.
3423,5702,2,14,130,146,1.1232876712328768,0.030567627865148956,660,It's a bit like ordering the Soup of the Day
643,5703,4,14,161,179,1.1229050279329609,0.02926939186939288,660,I climbed a tree.
1438,5704,1,19,151,171,1.1228070175438596,0.026504312681101365,660,It's the latest trend - Chimp Minimalism!
2318,5705,2,14,131,147,1.1224489795918366,0.030370555240784372,660,This isn@
4758,5705,1,16,130,147,1.1224489795918366,0.02879553204089103,660,"Hey Edith - I thought that you were an empty-nester. 
No - I babysitting for Horton."
4897,5707,3,16,161,180,1.1222222222222222,0.028028047001504262,660,There's No Place Like Home
419,5708,4,13,155,172,1.122093023255814,0.029980300046000566,660,"Well, good morning Charlie Bird!"
471,5709,2,16,146,164,1.1219512195121952,0.028400009016040492,660,When you think you got the dub but your language arts teacher joins.
2915,5710,2,17,154,173,1.1213872832369942,0.027468142010608557,660,Well I mean if he's gonna save cats in trees why not boys in nests?
4834,5710,1,19,153,173,1.1213872832369942,0.02621613034735046,660,"Barbara Corcoran said it was a Jr. Tree!""~ Helen Rosenbau"
522,5712,3,18,178,199,1.120603015075377,0.026228279286642668,660,I can see Notre Dame burning from here.
2009,5713,2,16,148,166,1.1204819277108433,0.02807591638571255,660,It’s a family thing
5234,5713,1,18,147,166,1.1204819277108433,0.026743928858149073,660,Can I be your nesty girl?
1453,5715,3,16,164,183,1.1202185792349726,0.027591302747324197,660,"Just sittin’ on the dock of the bay..,ok?"
4942,5716,2,17,156,175,1.12,0.027170930085437216,660,"...but to answer your question, no, it hasn't been snowing."
365,5717,5,10,152,167,1.1197604790419162,0.03155585468967579,660,"I told my friend last night that I wanted to eat his pussy, but then he slapped me and picked up his birdo fursuit yelling “You ain’t eating my birdo fursuit!"
3615,5718,1,17,141,159,1.119496855345912,0.027304654082417012,660,"Are they going to cut it down?”
-“Nope."
3905,5719,2,16,150,168,1.119047619047619,0.027759101356513195,660,"Kuku, kuku rakaku! I'm Paloma!"
4028,5720,1,17,142,160,1.11875,0.02714374008470763,660,"Well, Vardaman, MY mother is a bird."
407,5720,1,17,142,160,1.11875,0.02714374008470763,660,"You did say 'If you're a bird, I'm a bird', so.."
55,5722,0,21,156,177,1.11864406779661,0.024374872141073003,660,"It's not a myth. Yes, storks deliver babies but sometimes they just ignore"
3435,5722,5,11,161,177,1.11864406779661,0.030251298630513984,660,These youths are always high.
931,5724,3,13,145,161,1.1180124223602483,0.029722946867094164,660,"What you say is true, but at least now the nest is not empty!"
4416,5725,0,21,157,178,1.1179775280898876,0.024246711112017778,660,I took out a debenture.
3066,5726,0,20,150,170,1.1176470588235294,0.024783826131455487,660,Up in the air Junior Bird Girl
1320,5727,0,19,143,162,1.117283950617284,0.025358109137641974,660,"Well.. I needed to downsize in Autumn, and HoneyLocust had just fallen for me."
3150,5727,2,15,145,162,1.117283950617284,0.028220492044604986,660,"You should try it! Once you have feathered your nest egg, it's quite comfortable."
2891,5729,2,13,130,145,1.1172413793103448,0.030171045398636062,660,Holden Caulfield went off the deep end
2924,5730,1,19,160,180,1.1166666666666667,0.02525475414800846,660,"In South Carolina, we call this the Eagle Eye . . ."
5292,5731,2,16,154,172,1.1162790697674418,0.02714635034702532,660,"You see, I’m happy to serve my nested sentence."
359,5732,1,18,154,173,1.115606936416185,0.025722430071449812,660,I can’t imagine why you’d say
4374,5732,2,16,155,173,1.115606936416185,0.026997346979033228,660,"It's an import from the flyover. They call it ""leisure."""
467,5734,2,18,171,191,1.1151832460732984,0.025428793695572726,660,She chooses the one tree not in that field filled with them
5150,5735,5,10,159,174,1.1149425287356323,0.030335504312852084,660,mm burp fart
4783,5736,3,17,181,201,1.1144278606965174,0.025611020251211442,660,"So far, so good. The number one f eligible men stopping beats Asparagus Beach."
845,5737,1,18,156,175,1.1142857142857143,0.02544467304462061,660,"Harold, you really think I will pass for Pale Female?"
5299,5737,2,16,157,175,1.1142857142857143,0.026704172545492448,660,This is getting old Miss Minoes
3705,5739,4,14,175,193,1.1139896373056994,0.0272380303503789,660,"Yeah, a CRISPR procedure. A bit side-tracked, wings cut short. Not that I complain, thank you."
4693,5740,6,9,170,185,1.1135135135135135,0.029990311898377014,660,"When you are done as a human and wants to be a bird,wants to fly and live freely.But then again, you wonder,and can't find real reasons to set yourself free,you're too occupied with your concrete life. So, you go to a park and pretend to be a bird..."
2638,5741,0,20,157,177,1.112994350282486,0.023863559501542588,660,It's not postpartum depression...i'm nesting unit spring.
5194,5742,2,14,144,160,1.1125,0.028021078095070907,660,"Get down from here? Yes,sir--it's how I've been able to stay up here all night. Wonderful stuff!"
4040,5743,2,13,137,152,1.111842105263158,0.028846389036492618,660,Why are you up there? I'm supposed to Nest my egg right? Ohh NEW YORKERS...
3335,5744,1,15,137,153,1.1111111111111112,0.027125115513166854,660,Alcatraz? Nice place to visit but I wouldn't want to live there.
4886,5745,1,18,162,181,1.1104972375690607,0.024646086213475648,660,"Nadir"", was today's word of the day in my calendar. Apperently it means to be at your lowest point. Interesting stuff.. Anyways, if you see my family don't tell them I'm up here. I only get one day off Harold, and I'm not about to waste it on them"
5091,5746,0,19,155,174,1.1091954022988506,0.023712118120386465,660,It's my way of staying sharp for the deer-hunting season.
3697,5747,2,17,174,193,1.1088082901554404,0.02475867217069335,660,"Leeping eggs warm is warm, but kind of wet."
120,5748,1,15,142,158,1.1075949367088607,0.026309826474500607,660,It's a  Nelson Byrd Woltz.
4007,5749,2,16,169,187,1.106951871657754,0.025070174965206478,660,What? Rent is cheap in the part of town.
2299,5750,4,9,148,161,1.1055900621118013,0.030013563797141797,660,I knew it wasn’t actually a bird!
4905,5751,2,12,138,152,1.105263157894737,0.02824896586731112,660,Guess you'd be the gent with the penchant for lidded ladies ??
2007,5752,0,18,156,174,1.103448275862069,0.02315401188513724,660,Here is my new year plant!
4413,5753,1,16,158,175,1.1028571428571428,0.0244133610546078,660,"Look, I'm the Bowery Bird!"
4165,5754,3,10,143,156,1.1025641025641026,0.029016818914916236,660,"Sorry, I don’t have a casserole."
294,5755,3,9,136,148,1.1013513513513513,0.02992277992277993,660,"""Mock me if you must, but I get a limb-it-less high sitting closer to the sky."""
1878,5756,0,15,134,149,1.1006711409395973,0.024733233786218965,660,‘Log-in process completed...‘
4168,5757,0,16,145,161,1.0993788819875776,0.023651469272869277,660,Spring who?
1555,5758,1,16,166,183,1.098360655737705,0.023395171720478995,660,I have always wanted to sing on CPW.
4491,5759,0,17,164,181,1.0939226519337018,0.021743605367433423,660,"Hi,  I'm up here in the tree waiting for spring to come."
501,5760,2,11,148,161,1.093167701863354,0.02614050995219748,660,Why don't you make like a tree...and climb to the top like me and make it into a sleeping pad.
3290,5761,1,14,157,172,1.0930232558139534,0.02369368814073376,660,You’re really out of you’re tree!
4347,5762,1,13,152,166,1.0903614457831325,0.023899340382706764,660,Id like to stay up here for the forth of july celebratio
3930,5763,2,10,146,158,1.0886075949367089,0.025992740872040447,660,Let down your hair RappNPunZIL.
1702,5764,1,11,137,149,1.087248322147651,0.02507540940653852,660,"Self flagellation is seriously underrated, so no, you may not masterbate with me in this goddam tree."""
876,5765,1,13,164,178,1.0842696629213484,0.02234857923272055,660,Hypocrisy unmasked !
3314,5766,1,12,158,171,1.0818713450292399,0.0226045719380071,660,"Now I get it! Ticking, ticking, ticking!"
2987,5767,0,14,160,174,1.0804597701149425,0.020680055945742404,660,Just sitting pretree up here
4853,5768,2,8,140,150,1.08,0.025940906860971044,660,Sliiiiiiiide!
2706,5769,2,9,154,165,1.0787878787878789,0.024297793384004344,660,Confession: my mom is a little different she think the government is watching us through our technology like the amazon tv and the microwave so at night she wrap my face in tinfoil and unplug everything she unscrewed the lightbulbs I’m so scared
2499,5770,1,10,168,179,1.0670391061452513,0.020350585772708207,660,"I’ve been a red head magnet my entire life. Heed ILA’s warning. It’s not just the Irish one’s that are crazy. They will f~~~ you like a jack hammer though.

No f~~~ing wonder I went MGHOW."
2728,5771,1,8,156,165,1.0606060606060606,0.020519796827948574,660,I got evicted from my house and I am desperate and afraid.
