target_id,rank,funny,somewhat_funny,unfunny,count,score,precision,contest,caption
82,1,13921,6994,1994,22909,2.5206250818455627,0.004300435196465432,666,Lunch is on me.
94,2,7808,6679,3301,17788,2.253373060490218,0.005612655076022485,666,Dinner's on ME.
4075,3,4924,5044,2814,12782,2.165075887967454,0.006725603839310237,666,Dinner’s on me tonight.
166,4,7137,6483,4257,17877,2.1611008558482965,0.005848280234037723,666,He’s telling his friends it’s not deep. So be patient.
5452,5,5487,4956,4174,14617,2.0898269138674146,0.00668344493482494,666,"I didn't know what you were serving, so I brought white."
4524,6,4381,4590,3638,12609,2.0589261638512175,0.007082846916177128,666,"Fresh? Sir, I assure you these were walking on land this morning."
2011,7,5307,6034,4709,16050,2.0372585669781933,0.006228766752915674,666,A back massage and then dinner. What's not to like?
4780,8,4390,5207,4200,13797,2.0137711096615205,0.006716785879144942,666,It’s like a good wine. You let it breathe before consuming it.
3081,9,4358,6161,4224,14743,2.0090890592145425,0.00628336516205542,666,I brought dinner.
3153,10,3566,4814,3715,12095,1.987680859859446,0.007054282488210864,666,It's carryout.
4082,11,3210,4320,3466,10996,1.9767188068388506,0.007427612479404843,666,Off Coney Island. There's thousands of them.
1095,12,3871,5192,4213,13276,1.9742392286833383,0.006769015103101925,666,"I’m letting him sunburn a bit more, I prefer extra crispy."
5253,13,3311,4596,3946,11853,1.94642706487809,0.007170480815915774,666,Once I gave him a name I didn’t have the heart to eat him.
4057,14,3658,4471,4353,12482,1.94431982054158,0.007153607333481001,666,Eat a guy and you'll be full. Use him as bait and we'll all be full.
4399,15,1880,1768,2240,5888,1.9388586956521738,0.010873127545844376,666,I got us a politician. There is no backbone !
22,16,2538,3297,3191,9026,1.9276534456015955,0.00835160767468816,666,"I swear, it is like the universe does not want me to stay vegan."
1287,17,2967,2577,3639,9183,1.9268213002286834,0.008818319379971773,666,"I used to feel sorry for them, but this one is wearing a MAGA hat."
3155,18,3079,4035,3981,11095,1.9187021180712032,0.007534030255176267,666,Lucky for him this is the last thing on his bucket list.
3637,19,2384,3626,3359,9369,1.8959333973743195,0.008017308316758958,666,You want the other half?
91,20,1741,2632,2486,6859,1.8913835836127715,0.009388360063216833,666,"When I get hungry, or he realizes I'm not a dolphin, whichever comes first!"
4149,21,2729,3046,3770,9545,1.8909376636982713,0.0083722679715689,666,"He has a name, Dad. It's Greg. And I love him."
1385,22,1306,1844,1883,5033,1.8853566461355056,0.011104316590568115,666,It's part of this whole shore-to-table thing.
1283,23,2062,3618,3356,9036,1.8567950420540063,0.008005904943342478,666,And I suppose you've never played with your food.
160,24,1847,2643,2945,7435,1.852320107599193,0.009152328029071469,666,He’s paying an arm and a leg for the ride.
5968,25,2377,3121,3747,9245,1.8518117901568416,0.008323643090948877,666,He' s my emotional support animal.
4474,26,2329,3430,3787,9546,1.8472658705216844,0.008042315305035526,666,"If you liked our food delivery service, please give me 5 stars."
335,27,392,665,675,1732,1.8366050808314087,0.018451818825492274,666,My treat.
2878,28,2024,4083,3696,9803,1.8294399673569315,0.00752065864440609,666,I was told we had to bring our own lunch.
6173,29,1486,1995,2579,6060,1.8196369636963696,0.010263577462929614,666,So we each grab a leg and make a wish.
1341,30,2124,2781,3839,8744,1.8038655077767611,0.008579042905214827,666,Professional courtesy....he’s a lawyer.
3910,31,1814,3111,3516,8441,1.7983651226158037,0.008366495105267184,666,I'm letting him take one last selfie.
3817,32,1417,1718,2602,5737,1.7934460519435245,0.010709455495115637,666,"Jump up and yell, 'I'm that goldfish you flushed!' 
And then we'll eat him."""
4636,33,623,892,1219,2734,1.7820043891733723,0.015137085819652233,666,How did these things ever make it to the top of the food chain?
289,34,1915,2912,3839,8666,1.7779829217632126,0.008422502823837219,666,"Last time I ate one this stupid, I was sick for a week."
1772,35,1303,2097,2650,6050,1.7773553719008264,0.009991050709765848,666,"Yes, I KNOW I'm holding up dinner."
5494,36,1180,2090,2528,5798,1.7675060365643325,0.010049707660466672,666,He's never seen the movie
962,37,1107,1742,2371,5220,1.757854406130268,0.010790281089230804,666,"Well, that's embarrassing. How long has it been there?"
4357,38,807,1586,1842,4235,1.755608028335301,0.011559690186541472,666,"Seems only fair ,
I ate his surfboard."
4405,39,984,1647,2217,4848,1.745668316831683,0.01108501640257918,666,This is why they think most shark attacks occur in only three feet of water.
3991,40,867,1746,2073,4686,1.7426376440460947,0.010944366795949826,666,"You go ahead, Frank. SPF 30 gives me heartburn."
5988,41,1215,2112,2815,6142,1.7394985346792575,0.009787491663017341,666,‘Hold off a bit. He’s bragging about being “king of the sandbar” to four guys in backwards ball caps.’
5089,42,1492,2462,3597,7551,1.7212289762945305,0.00888660862076326,666,"Soon, he won't have a leg to stand on."
794,43,913,1300,2128,4341,1.7201105736005529,0.011973393514956509,666,Another Darwin Award winner.
2118,44,861,1226,2048,4135,1.7129383313180169,0.012257342308736785,666,Found him in the shallow end of gene pool.
5075,45,481,775,1192,2448,1.7095588235294117,0.01564652137884753,666,"He’s locally sourced, and most importantly, cage free!"
5340,46,730,1423,1935,4088,1.7052348336594911,0.011757911196397844,666,I just can’t do it without the theme music.”
3718,47,853,1927,2420,5200,1.698653846153846,0.010178381803733207,666,Just be patient. He’s calling his friends.
1866,48,503,928,1346,2777,1.696435001800504,0.014375505545162932,666,Remember when Mom read us that story about how the fox tricked the Gingerbread Man and you said nobody could be that stupid?
5714,49,351,658,968,1977,1.687910976226606,0.01698077212210668,666,"When I go low, you go high."
2699,50,1008,2352,3015,6375,1.6851764705882353,0.00913539485219161,666,"Oh, did you want me to pick up something for you, too?"
4030,51,717,1382,2108,4207,1.669360589493701,0.011561177815015302,666,"I love a well-balanced meal, don't you?"
2273,52,672,1548,2109,4329,1.668052668052668,0.011089271963746159,666,"First, I gain their trust."
187,53,632,1553,2045,4230,1.6659574468085105,0.011102353753496939,666,Trust me.  This makes it easier to get all the others into the water.
5269,54,608,1225,1841,3674,1.6643984757757213,0.012280720892007147,666,Luckily the dumb ones taste just as good.
19,55,172,431,567,1170,1.6623931623931625,0.021043064622640183,666,"Your order is ready, sir..."
5905,56,284,706,951,1941,1.6563626996393612,0.016343342062176983,666,"On one hand, we have a reputation to uphold.  On the other hand, this shiatsu foot massage really feels good."
184,57,854,1421,2496,4771,1.6558373506602388,0.011062154753358895,666,"Hey, Sam, I’d like you to meet my chum."
566,58,178,350,551,1079,1.654309545875811,0.022713094985686175,666,He still thinks I'm Flipper.
756,59,341,599,1057,1997,1.641462193289935,0.01692108164818051,666,"To be honest, I'm thinking of giving up this Uber thing."
1115,60,122,234,391,747,1.6398929049531459,0.027326588708937994,666,Do you want to see what a big surprise looks like?
2763,61,412,733,1301,2446,1.6365494685200328,0.015244842579069422,666,The guy at the bait shop said this could get us a couple lifeguards.
760,62,247,515,845,1607,1.627878033602987,0.01835468171123688,666,I ordered him sunny side up.
2474,63,284,453,893,1630,1.6263803680981594,0.018909728045379336,666,"He ain’t heavy, he’s my breakfast."
2955,64,535,1242,1919,3696,1.6255411255411256,0.011905600623134173,666,How about some help carrying the groceries?
6150,65,367,786,1285,2438,1.623461853978671,0.014828019956799948,666,"Fine, but walking him is your responsibility."
1480,66,499,1061,1786,3346,1.6153616258218768,0.012646253895742811,666,Watch this. I'm going to flip it up and catch it in my mouth.
173,67,607,1094,2087,3788,1.6092925026399154,0.012144505477306333,666,"He thinks I'm Flipper, who's Flipper?"
1282,68,337,575,1157,2069,1.6036732721121314,0.016529281941163147,666,"When he says ""Marco,"" they all say ""Polo,' and then we eat."
2434,69,82,165,303,550,1.5981818181818181,0.03132013873912638,666,I found this mannequin in some ocean trash. It allows me to get closer to shore without alarming my lunch.
1448,70,271,683,1095,2049,1.5978526110297706,0.01570206221856139,666,I still don't see why the dolphins get such a kick out of this.
5220,71,428,926,1665,3019,1.5902616760516728,0.013194151277036449,666,Let’s split the Bill
5183,72,403,674,1440,2517,1.5880015891934842,0.0149519395324448,666,Isn't it time we told him he's adopted?
1289,73,345,641,1285,2271,1.5860854249229415,0.015514952445529303,666,Excuse me. Do you have any Grey Poupon?
1745,74,381,782,1482,2645,1.5837429111531192,0.014172562266828793,666,So much for them having a bigger brain.
1511,75,134,281,527,942,1.5828025477707006,0.02367969037134321,666,I’m a certified support animal.
2386,76,346,1003,1577,2926,1.579289131920711,0.012813101939301288,666,Are you the one who ordered takeout?
1250,77,383,802,1524,2709,1.578811369509044,0.013944259346735745,666,"OK, you call it - Heads or Tails?"
1030,78,310,725,1295,2330,1.5772532188841202,0.014799741807434484,666,Shhh! He's looking out for sharks.
5215,79,363,729,1442,2534,1.5741910023677979,0.014478692934714208,666,"I would have eaten him, but I'm finally getting WiFi."
1841,80,299,703,1264,2266,1.5741394527802295,0.014982027333404192,666,"Can we keep him, Mom? Please?"
13,81,333,730,1369,2432,1.574013157894737,0.014602518289053332,666,I raise my own. It’s the only way to know they’re organic.
5820,82,217,480,896,1593,1.573760200878845,0.018020810245387087,666,This one's a decoy.  We get the real ones when they come out to rescue it.
315,83,362,983,1633,2978,1.5732034922766958,0.012800075501511944,666,Shhh...he thinks I'm a dolphin.
4984,84,72,143,286,501,1.5728542914171657,0.032622611848921644,666,Guess who's coming to dinner?
1201,85,303,554,1169,2026,1.5725567620927936,0.016387997205521036,666,You're more likely to be struck by lightning than be stepped on by a human.
3802,86,176,388,730,1294,1.571870170015456,0.019993413613531432,666,Ability to delay gratification correlates with higher SAT scores and greater success later in life.
2570,87,161,411,712,1284,1.570872274143302,0.019657153712946702,666,One on the fin is worth two on the beach.
2138,88,294,749,1304,2347,1.5696634000852152,0.014535719086617794,666,It's Hilarious. He thinks I'm a dolphin.
5177,89,320,771,1387,2478,1.569410815173527,0.014256643825606971,666,"I thought he was a seal, he thought I was a surf board."
4764,90,212,499,910,1621,1.5694016039481802,0.017686403220120283,666,It's from that new take-out place under the pier.
1527,91,294,815,1358,2467,1.5687069314957438,0.014004192498783546,666,Shall we just split an order?
5786,92,108,220,439,767,1.5684485006518905,0.026227850064409006,666,Professional courtesy. Personal injury lawyer.
3703,93,243,528,1016,1787,1.5674314493564634,0.01702078936695028,666,It seems rude to interrupt while he’s on the phone.
4893,94,303,634,1267,2204,1.5626134301270418,0.015378920826005369,666,I just think it's a bad idea to eat something this stupid.
659,95,203,418,872,1493,1.551908908238446,0.018655210176828106,666,"If he's gonna have kids as smart as he is, it makes more sense to release him."
5892,96,200,458,899,1557,1.5510597302504816,0.018002734851754097,666,Definitely a keeper!  I'd guess about a 180 pounder.
1104,97,127,377,643,1147,1.5501307759372276,0.020228497493099074,666,I can't go anywhere without a snack
2707,98,153,218,582,953,1.5498426023084995,0.024439236208310084,666,It's Donald. We don't eat our own.
3160,99,209,459,932,1600,1.548125,0.017840478326019968,666,I ordered wings but they gave me legs instead.
1889,100,210,504,1005,1719,1.537521815008726,0.016938569607699572,666,I'm going to be on the evening news.
3536,101,243,324,942,1509,1.536779324055666,0.019454000627669315,666,Heard it’s Trump ... we could become hero’s!
5865,102,189,390,864,1443,1.5322245322245323,0.018823139208937426,666,He had a standing reservation for dinner.
907,103,189,417,888,1494,1.5321285140562249,0.01833636391561554,666,I'm seventy years old and I'll play with my food if I want to.
1502,104,193,485,959,1637,1.5320708613317044,0.017213754838643913,666,wait till he finds out I'm not his surf board.
3840,105,56,124,266,446,1.5291479820627802,0.03352917466403479,666,I brought you a snack.
144,106,167,494,906,1567,1.528398213146139,0.01718243483329445,666,I decided to go with carry out.
5668,107,109,312,585,1006,1.5268389662027833,0.02153279278820354,666,No thanks. I brought my lunch.
4317,108,179,313,782,1274,1.5266875981161696,0.02041002483229966,666,The weirdest part is that the water above me keeps randomly getting warm
2647,109,151,423,804,1378,1.5261248185776488,0.01844491089544369,666,I’m trying to eat a more balanced diet.
1010,110,171,355,814,1340,1.5201492537313432,0.019416774162386057,666,Millennials act so entitled.
4331,111,154,319,745,1218,1.5147783251231528,0.020323092101743805,666,"It's a new ridesharing company I started. I call it Scuber."""
3977,112,100,265,541,906,1.5132450331125828,0.02280290572194223,666,We have a deal.  He tells everyone else it’s safe and I don’t eat him.
1813,113,127,358,708,1193,1.5129924559932941,0.019702907277551023,666,"Of course I’ll eat him, but in the meantime  I just love the foot massage."
5529,114,125,338,684,1147,1.5126416739319966,0.020204022275470794,666,"Of all my anger management exercises, this one is the most difficult"
3801,115,144,325,728,1197,1.5121136173767753,0.020250413184468075,666,Sometimes it's just too easy.
1787,116,140,306,699,1145,1.5117903930131005,0.02078869867109824,666,He's my therapy human.
6055,117,127,354,713,1194,1.5092127303182579,0.019692639151795168,666,"Honey, I brought dinner!"
1098,118,104,300,594,998,1.5090180360721444,0.02144095736320299,666,I read that its best to let meat rest before consuming it.
364,119,113,324,648,1085,1.5069124423963134,0.02056057446520405,666,He’s a rescue.
515,120,107,338,646,1091,1.5059578368469295,0.020230661283089715,666,Don’t bite.My back has never felt so good.
5424,121,121,314,664,1099,1.5059144676979073,0.020693029216530084,666,Did you already eat yours?
6238,122,79,257,490,826,1.5024213075060533,0.023127510320701285,666,I liked it better when they were afraid of us.
3170,123,119,288,640,1047,1.5023877745940784,0.021361641608434786,666,I work for UberEats now.
516,124,112,289,624,1025,1.5004878048780488,0.02139053591590869,666,This one’s on me.
3320,125,116,262,612,990,1.498989898989899,0.02212983140143181,666,"He's a loan shark-it's a professional courtesy."""
4514,126,75,179,412,666,1.493993993993994,0.026731445061262207,666,"It's professional courtesy, he's a lawyer."
1140,127,105,254,581,940,1.4936170212765958,0.02245249423188829,666,He’s only just temporarily on top of the food chain.
1238,128,90,280,563,933,1.4930332261521972,0.021798863740671613,666,Another 20 minutes and he’ll be medium rare.
6164,129,110,184,529,823,1.4908869987849331,0.025084568775521537,666,I am the fin beneath his things.
313,130,75,197,437,709,1.4894217207334273,0.02552980105689301,666,I thought we'd get take out and watch a movie.
1849,131,80,288,549,917,1.4885496183206106,0.021523595646271165,666,"Don't say anything, he just told all his friends that he's tall enough to reach the bottom."
2559,132,79,258,517,854,1.4871194379391102,0.022578398019333087,666,"Yes, I could dive, but I think surfacing would be more interesting."
5022,133,56,177,362,595,1.4857142857142858,0.02715559396597266,666,I'm going to let him marinate for another 20 minutes.
2805,134,93,180,482,755,1.4847682119205299,0.025651345447051208,666,It  is the final exam for self control and anger management class
424,135,86,228,513,827,1.4836759371221282,0.023540037963624947,666,The doc said I needed a balanced diet.
395,136,87,208,496,791,1.4829329962073325,0.02438310872412506,666,I love the look in their eyes when they realize they're not standing on the bottom.
454,137,65,165,381,611,1.4828150572831424,0.027534498039363562,666,Yeah it's a Great White
5701,138,75,211,462,748,1.482620320855615,0.02455038002664412,666,"First, we were overfished and now we're support animals?  I don't get it."
4739,139,90,213,512,815,1.4822085889570553,0.024042917232317645,666,Shhh.  This guy thinks I'm a service animal.
2626,140,80,230,499,809,1.4820766378244747,0.023532518684408216,666,He's just a decoy.
5043,141,99,195,522,816,1.4816176470588236,0.024577638295838644,666,I’m making a fortune carrying them into U.S. waters.
2798,142,87,205,495,787,1.4815756035578145,0.024472898728294386,666,One lousy surfer and I get sixteen weeks of community service.
1443,143,68,253,487,808,1.4814356435643565,0.022758148624492647,666,Should we do lunch now or save it for dinner?
5467,144,78,216,480,774,1.4806201550387597,0.024159206987913222,666,I know. But he removed a thorn from my fin”.
1877,145,52,106,279,437,1.4805491990846682,0.03344199196413067,666,I told him I’d give him a lift if he debunked shark attacks as Fake News.
4692,146,89,204,502,795,1.480503144654088,0.024420725694620397,666,He's trying to get a signal.
397,147,71,178,417,666,1.4804804804804805,0.026381589660955006,666,Are you a leg or a breast man?
719,148,82,245,525,852,1.4800469483568075,0.022792430213092896,666,I'm trying to eat a balanced diet
737,149,90,201,503,794,1.4798488664987406,0.024507614785642475,666,I call it “ Surf and Turf”
647,150,83,191,471,745,1.4791946308724833,0.025197764252721334,666,I wish I had a blowhole.
3595,151,81,215,491,787,1.4790343074968233,0.024070650375803627,666,Millennials...am I right?
5883,152,77,213,477,767,1.4784876140808345,0.02424632851081779,666,Feels so good I hate to eat him.
1199,153,79,205,479,763,1.4757536041939712,0.024475855547227858,666,I'm headed to the potluck
4439,154,80,198,475,753,1.4754316069057105,0.024783096123184665,666,You smell fear? All I can smell is feet.
4347,155,79,141,409,629,1.4753577106518283,0.028233137868636005,666,Why does the President always have to rely on us to keep him afloat?
6217,156,46,165,331,542,1.4741697416974169,0.02783216450612692,666,We'll eat him right after my back massage.
4886,157,73,203,461,737,1.4735413839891451,0.02465524099562206,666,Just wait till he does another hand stand.
1398,158,90,160,468,718,1.4735376044568245,0.0264072842020748,666,I can't do that.  He's a lawyer.  He's one of our own.
3250,159,66,198,433,697,1.473457675753228,0.02510548365148168,666,I can’t do anything without the soundtrack.
5527,160,74,193,454,721,1.4729542302357836,0.02512576654539627,666,He was drowning. I'm just keeping him fresh until I get hungry.
287,161,91,158,470,719,1.4728789986091795,0.02645208517347751,666,Probably not a stable genius.
4850,162,72,199,455,726,1.4724517906336088,0.02484679133100516,666,This guy thinks he walks on water.
360,163,80,143,420,643,1.4712286158631416,0.02785157031177109,666,I accidentally looked up his trunks... totally lost my appetite.
5299,164,70,177,429,676,1.4689349112426036,0.025995314448924754,666,Don’t worry he’s armless
25,165,29,88,195,312,1.4679487179487178,0.037393800370673115,666,Let him get his damn selfie first.
6139,166,58,181,401,640,1.4640625,0.025939573940879423,666,"You know, it wouldn't kill you to help me carry the groceries."
3360,167,66,172,419,657,1.4627092846270928,0.02617724075938022,666,My ex got the top half.
3846,168,75,141,413,629,1.4626391096979332,0.02784962840268764,666,It’s a professional courtesy. He’s a corporate lawyer.
599,169,73,155,423,651,1.4623655913978495,0.02697160913575543,666,I'll split him with you.
1050,169,65,171,415,651,1.4623655913978495,0.02626130325511453,666,Takeout is on me tonight.
2604,171,44,182,358,584,1.4623287671232876,0.026169581864405107,666,"I think he said ""Hey guys, I found the sand bar!"""
1904,172,76,146,423,645,1.462015503875969,0.0274205824670186,666,I REALLY hate Lent!
2704,173,85,128,433,646,1.4613003095975232,0.028165078952533975,666,"You were right about President Trump, he really is the dumbest thing on land or water."
5473,174,72,151,417,640,1.4609375,0.02722060002781741,666,Shall we each grab a leg and make a wish?
3332,175,52,186,392,630,1.4603174603174602,0.025639814686849977,666,I just get more done if I bring my lunch to work.
4084,176,64,160,403,627,1.4593301435406698,0.02688553102201292,666,It's a decoy.
3484,177,57,162,383,602,1.458471760797342,0.02698505706275747,666,"I know we said we weren't exchanging gifts this year, but I couldn't resist."
650,178,63,160,401,624,1.4583333333333333,0.026881434152698853,666,"You ordered a 160 pounder, no fins, no wet suit?"
1680,179,66,148,399,613,1.4567699836867862,0.027519024511825852,666,He thinks he's standing on a sand bar. I'm waiting for his wife.
295,180,55,169,387,611,1.4566284779050735,0.02649316782621239,666,"Ok, let's go over this again... I hit the brakes, then you open your mouth."
778,181,65,151,400,616,1.4561688311688312,0.02732275592516438,666,"White meat is dry and flavorless, but there's no alternative on Nantucket."
5770,182,64,149,395,608,1.455592105263158,0.027485333955763157,666,Beginning to have second thoughts on the Uber gig.
2961,183,56,164,386,606,1.4554455445544554,0.02674746863277685,666,You said you wanted fresh.  I'm bringing you fresh.
4442,184,46,183,375,604,1.455298013245033,0.025765868033386048,666,The invitation said to bring your own lunch
5084,185,63,147,390,600,1.455,0.027650785580860652,666,New gig with Uber Eats.
5063,186,66,135,386,587,1.454855195911414,0.02840570828894244,666,"I'm transitioning to porpoise, if you must know."
3930,187,59,159,391,609,1.4548440065681445,0.026953944607537278,666,Too bad today is Catch and Release
5330,188,61,150,388,599,1.4540901502504173,0.027479547690311593,666,It’s a comfort human.
582,188,56,160,383,599,1.4540901502504173,0.02696680056177051,666,"I can’t, he’s a client."
2312,188,63,146,390,599,1.4540901502504173,0.02768198737002873,666,I identify as a Dolphin.
6165,191,62,143,383,588,1.4540816326530612,0.02795639880009579,666,He’s all yours. I can’t stomach another old white male.
5406,192,56,137,356,549,1.453551912568306,0.028714866223642287,666,"Something is in the water. Oh my god, it just touched me!"
5561,193,58,158,389,605,1.4528925619834712,0.026975474097239948,666,"It's win win. He gets a free ride, I get a free lunch."
3569,194,48,170,370,588,1.4523809523809523,0.026460659378853744,666,"I dunno--I heard the guy say, ""Less crowded than Everest and twice as safe."""
3891,195,52,158,370,580,1.4517241379310344,0.027155910941875014,666,Sometimes being a vegetarian is difficult
4712,196,52,151,362,565,1.4513274336283186,0.02766638183683292,666,"I know it’s a false sense of security, but the meat is more tender when they’re relaxed."
5150,197,52,158,371,581,1.450946643717728,0.027120277736341056,666,Here's your order.
691,198,62,137,380,579,1.450777202072539,0.02826406209224478,666,He's a lawyer. Professional courtesy.
4868,198,51,159,369,579,1.450777202072539,0.027076174720527656,666,Here's your take-out. That'll be 20 clams.
3283,198,54,153,372,579,1.450777202072539,0.027405250853598264,666,My wife said to bring someone home for dinner.
2364,201,48,161,362,571,1.4500875656742558,0.027003406005786466,666,They're all over the place. Go get your own.
1854,202,50,138,341,529,1.449905482041588,0.028753341574407114,666,He said he'd introduce me to his fat uncle.
5387,203,54,134,350,538,1.449814126394052,0.02889088418583755,666,They call him the shark whisperer.
4152,204,61,131,372,564,1.448581560283688,0.028697856437570713,666,It's called Great White Privilege.
1863,205,56,134,361,551,1.4464609800362977,0.028616599156310676,666,I’ll wait until he finishes waving at his wife.
4403,205,53,140,358,551,1.4464609800362977,0.02826855203559799,666,So who's on top of the food chain?
2184,207,44,157,348,549,1.4462659380692167,0.02726606168206792,666,"No, go ahead, you tell him"
3884,208,57,128,358,543,1.445672191528545,0.029037234037201085,666,"The most embarrassing part is he keeps calling me ""Flipper""."
4377,209,30,79,203,312,1.4455128205128205,0.03758543706055412,666,Why?  What do you use as bait?
1483,210,44,153,344,541,1.44547134935305,0.027544185505317613,666,"Go away, you already had your half ..."
1038,211,56,133,361,550,1.4454545454545455,0.028650941074477382,666,It’s times like these that I regret going vegan.
4864,212,51,142,355,548,1.4452554744525548,0.028139584945787745,666,I’m seconds away from nipping this wildlife tourism trend in the bud.
256,213,46,143,340,529,1.444234404536862,0.028230760471866338,666,They're like muffins. The top half is delicious.
4083,214,49,139,346,534,1.4438202247191012,0.02841545281906357,666,"It started as a joke, but now I'm sorta invested."
1121,215,59,122,360,541,1.4436229205175601,0.029342682458886077,666,I brought take out.
5832,216,50,139,350,539,1.443413729128015,0.028347509968017652,666,"Man, this Swim With The Dolphins racket is great -- look what I got!"
2744,217,39,159,337,535,1.4429906542056075,0.027112759652680275,666,"I'm not hungry right now, but it's like packing a lunch for later."
5314,217,44,149,342,535,1.4429906542056075,0.027750760552404757,666,When eating out got so expensive I started packing my lunch.
4424,219,49,165,380,594,1.4427609427609427,0.02634915562609826,666,I like to play with them a little beforehand. Don't tell Mom.
2873,220,49,137,345,531,1.4425612052730696,0.02852533543384357,666,Say hello to my little chum.
5589,221,52,130,347,529,1.44234404536862,0.028974686718595183,666,He's keeping an eye out for sharks
44,222,51,131,345,527,1.4421252371916509,0.028928878927159056,666,Suppers on me!
2577,223,51,125,338,514,1.4416342412451362,0.029453667913363422,666,Don't say a word. I'm trying not to laugh.
3477,224,29,74,196,299,1.4414715719063544,0.03844958156950454,666,Heads he's yours.  Tails he's mine.
4109,225,44,140,334,518,1.4401544401544402,0.028376532886651214,666,He's my chiropractor.
3043,226,48,130,336,514,1.4396887159533074,0.029057078232066134,666,Do you have any grey poupon?
3302,227,48,131,338,517,1.4390715667311411,0.028933711320155014,666,All I know is the sciatica in my caudal fin is gone completely.
5154,227,45,137,335,517,1.4390715667311411,0.02854239889618408,666,Don't show your fin! He thinks he's riding a dolphin!
3171,229,42,135,322,499,1.4388777555110221,0.02885362395979226,666,Since when don't you like Italian?
1593,230,48,137,346,531,1.43879472693032,0.028385648612822785,666,I like the top a little crispy.
3057,231,57,108,341,506,1.4387351778656126,0.030557300962163778,666,Of course this happens the week I go vegan
1365,232,48,126,333,507,1.4378698224852071,0.02933683871292228,666,The water taxi costs an arm and a leg. I said I'd charge just an arm.
2036,232,41,140,326,507,1.4378698224852071,0.02839151536536117,666,"First, you have to give them a false sense of security."
881,234,47,127,331,505,1.4376237623762376,0.029285398429815424,666,Let's wait until he's finished waving to his kids.
5628,235,43,134,326,503,1.437375745526839,0.028823282069975732,666,"People keep coming to try and rescue him. I swear, I've never eaten so good in my life."
398,236,52,114,333,499,1.43687374749499,0.030207844599132158,666,Let him finish taking his selfie.
1532,236,46,126,327,499,1.43687374749499,0.02939769592232379,666,Let's humor him until his wife and kids arrive.
1642,236,41,136,322,499,1.43687374749499,0.02870511105572476,666,"Turns out, you can play with your food and eat it too."
2472,236,43,132,324,499,1.43687374749499,0.028984131014219837,666,"You try it ,the last one I ate tasted  just like chicken."
3367,240,35,147,315,497,1.4366197183098592,0.027926603482835627,666,I thought you said I was supposed to bring lunch.
3610,241,50,118,332,500,1.436,0.029893062579480906,666,Wait 'til he finds out I'm not a dolphin.
3052,242,47,122,327,496,1.435483870967742,0.02965640946707286,666,"Like I told you, Karen, men will walk all over you if you let them."
4649,242,54,108,334,496,1.435483870967742,0.03060268703388754,666,"Hey, Frank, dinner’s on me, today."
2251,244,46,120,323,489,1.4335378323108385,0.02981231727684875,666,I'm sick of white meat.  YOU eat it!
4955,245,49,117,330,496,1.4334677419354838,0.029920909340355815,666,My mom finally said I could have a pet - he's a rescue.
4252,246,46,122,326,494,1.4331983805668016,0.02959401978454168,666,I'm gonna give this Uber thing another week.
5218,247,50,110,325,485,1.4329896907216495,0.030549214644810915,666,"He's my comfort human, Larry"
3630,248,40,128,313,481,1.4324324324324325,0.029288606649072624,666,"And just like that, goodbye sciatica."
6157,249,45,116,316,477,1.4318658280922432,0.030196728212688418,666,"Oh, like you could say no to Sir David Attenborough."
431,250,40,124,309,473,1.4312896405919662,0.029630924598849098,666,"What is it you're not supposed to do, 30 minutes after eating a swimmer?"
3308,250,46,112,315,473,1.4312896405919662,0.030524443447687157,666,...and we'll have these waters to ourselves for the rest of the summer.
3660,252,43,115,310,468,1.4294871794871795,0.030301434440148926,666,You take the left leg and we’ll make a wish.
4194,252,37,127,304,468,1.4294871794871795,0.029381475331239314,666,Thigh or drumstick?
254,254,41,114,303,458,1.4279475982532752,0.030454175236006797,666,Now I have athlete's fin
2056,254,38,120,300,458,1.4279475982532752,0.02997983698903594,666,"Tell the kids, dinner's ready"
5480,256,31,133,292,456,1.4276315789473684,0.028926877266388897,666,Met him at Montauk.  Twenty bucks to take him to Sag Harbor ain't bad.
4416,257,33,123,286,442,1.4276018099547512,0.029893225293915412,666,Let one swimmer go and they walk all over you!
1157,258,43,109,305,457,1.4266958424507659,0.03080820364964551,666,It's my emotional support human.
3942,259,49,96,310,455,1.4263736263736264,0.03182979834614172,666,I’m never sure of what to bring to potlucks.
3337,259,45,104,306,455,1.4263736263736264,0.031215513302271507,666,"Oh, it's Human Week."
2861,259,47,100,308,455,1.4263736263736264,0.031524152117704415,666,"I don’t know, I think he said his name was Spielberg and I owe him big time...."
4346,259,38,118,299,455,1.4263736263736264,0.030110374203398984,666,"Ooh gross, get it off!! Where is it?"
1570,259,41,112,302,455,1.4263736263736264,0.030588894695502362,666,Tastes like chicken.
1497,264,34,125,294,453,1.4260485651214128,0.029548279098600597,666,They are all so confident when their head is above water.
1152,265,40,112,299,451,1.4257206208425721,0.03061830120295614,666,What is it? Get if off me! Get it off!
3659,265,36,120,295,451,1.4257206208425721,0.029967679131874786,666,"You know what they say...""eat a man and you have lunch,  use one as bait and you'll feast forever"""
6062,265,42,108,301,451,1.4257206208425721,0.030938481807563156,666,I met him online.
67,268,39,113,297,449,1.4253897550111359,0.030551211680096453,666,I was going to let him finish his text.
2977,269,45,100,302,447,1.425055928411633,0.031613049613389684,666,We're pool sharks..live with it.
1178,270,32,113,272,417,1.4244604316546763,0.030922164685630346,666,I’m letting him marinate
1324,271,43,107,305,455,1.4241758241758242,0.030892084560347203,666,"He ain't heavy, he's my lunch."
5803,272,32,123,286,441,1.4240362811791383,0.029747201166136963,666,I told you I was bringing the entree!
4576,273,22,62,166,250,1.424,0.04108097596632024,666,I feel like a metaphor for the Mueller report.
5574,274,36,115,291,442,1.4230769230769231,0.030378517884191252,666,"Bait. I’m trolling for one of the really fat, juicy ones."
2964,275,46,94,300,440,1.4227272727272726,0.032127303537622096,666,Why don't YOU ever bring dinner?
2059,276,29,65,197,291,1.422680412371134,0.039099095859796644,666,It started off as a wart
6102,277,33,119,286,438,1.4223744292237444,0.03005179366816456,666,I told him I'm a dolphin.
6015,278,33,118,285,436,1.4220183486238531,0.030145051969559588,666,"Well, if I had known your sister was joining us, I would have brought home more than just the drumsticks."
1510,279,45,93,296,434,1.4216589861751152,0.03228181183198063,666,"Gives a whole new meaning to ""stupid"" doesn't it?"
5258,280,32,117,281,430,1.4209302325581394,0.030250900357596925,666,Wanna grab a bite?
1290,281,32,116,280,428,1.4205607476635513,0.030346249916610862,666,"I'd eat him, but he's doing wonders for my back."
3472,282,39,107,294,440,1.4204545454545454,0.03096567457891559,666,"Jump the shark? No, but he did stick the landing."
528,283,38,103,285,426,1.42018779342723,0.03151222984066121,666,Let's let him wave frantically to shore for another minute or two.
2446,284,50,70,285,405,1.4197530864197532,0.03484314260942017,666,"That's Donald Trump - much, much scarier than showing my dorsal fin above the water."
2233,285,43,91,288,422,1.419431279620853,0.03259556206370559,666,Uber Eats delivery for you
5621,285,39,99,284,422,1.419431279620853,0.03189735633090539,666,I tried goat yoga. This is better.
1212,287,43,92,290,425,1.4188235294117648,0.032424197586822585,666,"No, when you're a shark, you're not necessarily a shark all the way."
2762,288,33,111,279,423,1.4184397163120568,0.03076344113123172,666,"Hurry, go get the camera."
2874,288,35,107,281,423,1.4184397163120568,0.03112551237494796,666,"I thought he'd realize his mistake and jump off, but it's been three hours and now it seems too awkward to say anything."
4067,288,41,95,287,423,1.4184397163120568,0.03218729798706122,666,This is NOT how He walked on water.
2189,288,39,99,285,423,1.4184397163120568,0.031837304241087945,666,"No, maybe YOU misunderstood when he said ""Help, shark!"""
2183,288,33,111,279,423,1.4184397163120568,0.03076344113123172,666,The trick is to brine just the bottom half
6044,288,35,107,281,423,1.4184397163120568,0.03112551237494796,666,Sorry I'm late. But I brought lunch.
12,294,33,110,278,421,1.4180522565320666,0.030862759325610674,666,I'm saving him for later.
559,294,33,110,278,421,1.4180522565320666,0.030862759325610674,666,"Ok, I am going to flip him"".   Heads or Tails"
3451,294,37,102,282,421,1.4180522565320666,0.03158723894070994,666,We Canadian sharks are just too polite.
4555,297,46,83,290,419,1.4176610978520285,0.03327393590809129,666,Great white privilege...
6181,297,31,113,275,419,1.4176610978520285,0.030591914432544987,666,Have at him. I gave up men for lent.
1001,297,40,95,284,419,1.4176610978520285,0.032227922333726726,666,He thinks they're swimming with dolphins.
3392,297,35,105,279,419,1.4176610978520285,0.031329577886711424,666,Revenge is a dish best served live.
5005,301,32,108,273,413,1.4164648910411621,0.03108028930680613,666,The missus asked me to get some takeout.
1425,302,34,103,274,411,1.416058394160584,0.031561165101975396,666,Chick bait.
4670,303,34,100,271,405,1.4148148148148147,0.03188177102584987,666,I got a lunch order here for a Miss Wanda Piranha. Is that you?
3292,304,41,123,331,495,1.4141414141414141,0.028748697167837626,666,On three?
5032,305,29,110,267,406,1.4137931034482758,0.030849115634284233,666,He’s just taking a selfie.  Then we can eat him.
3570,306,36,110,294,440,1.4136363636363636,0.030417657844924107,666,You know that trick where the dog flips a treat up off his nose and then eats it?
1093,307,26,115,263,404,1.4133663366336633,0.03034980018652393,666,I give up.  What has two legs and looks tasty for lunch?
581,307,30,107,267,404,1.4133663366336633,0.031148784866384435,666,"I couldn’t finish the whole thing, so I got it to go."
28,307,28,111,265,404,1.4133663366336633,0.030751887503161723,666,He's my chum.
4580,307,31,105,268,404,1.4133663366336633,0.03134534902461437,666,Does the tag say “sell by” or “use by”
763,307,34,99,271,404,1.4133663366336633,0.031927781412786446,666,Why does this always happen when I'm fasting?
3883,307,35,97,272,404,1.4133663366336633,0.03211957865173926,666,Watch this!  He thinks he’s on a sand bar.
5509,313,28,89,234,351,1.413105413105413,0.03389030583315103,666,Go ahead they taste like chicken.
800,314,41,84,277,402,1.4129353233830846,0.03336490015815706,666,He's half the man he used to be.
1722,315,36,101,282,419,1.4128878281622912,0.03148057722564768,666,Why don’t you bring a sea weed salad or bottle of red wine.
3285,316,34,97,269,400,1.4125,0.03214720800405753,666,Do you prefer the thigh or leg?
5608,316,32,101,267,400,1.4125,0.03175500473649053,666,I stopped for take-out on my way home.
5952,316,29,107,264,400,1.4125,0.031157444388975972,666,I promise. This is his last selfie.
4503,316,38,89,273,400,1.4125,0.03291759857187867,666,"This has been a bad week, one Fitbit, two tires and now a stand up comedian."
290,320,28,108,262,398,1.4120603015075377,0.0310589804978241,666,"40 more hours of community service, and I can go back to biting ‘em."
4158,321,35,93,268,396,1.4116161616161615,0.03256759179214497,666,I grabbed us take-out.
234,322,28,62,197,287,1.411149825783972,0.03909946066559215,666,Do I have food on my face?
3378,323,32,101,269,402,1.4104477611940298,0.03163004571733419,666,I believe you ordered take-out.
6082,324,37,86,267,390,1.4102564102564104,0.03331279187377593,666,He does things for me you can't begin to understand.
1628,325,43,127,350,520,1.4096153846153847,0.028010981767664284,666,The kids wanted takeout again.
2500,326,36,84,261,381,1.4094488188976377,0.03366932312771106,666,Are you gonna tell him? Or should I?
1607,327,34,90,262,386,1.4093264248704662,0.03294797575249669,666,I got takeout tonight
1182,328,35,87,262,384,1.4088541666666667,0.03327173130061872,666,"It attracts the lifeguards, and they don't come any meatier than that!"
172,329,25,105,250,380,1.4078947368421053,0.031375484432847774,666,He's my perfect disguise ... keeps all the tastier swimmers from panicking  when they see my dorsal fin.
4340,330,30,97,258,385,1.4077922077922078,0.032167444354547624,666,"The wife is working late, so she asked me to bring home dinner."
5512,330,31,95,259,385,1.4077922077922078,0.03237703838881895,666,"It's low-pay, seasonal work. But it includes meals."
231,332,34,86,258,378,1.4074074074074074,0.03342995336033495,666,I ate his wife.  It's the least I could do.
5239,332,27,100,251,378,1.4074074074074074,0.03192679602030788,666,I thought I'd get a massage in before lunch.
4274,332,34,86,258,378,1.4074074074074074,0.03342995336033495,666,"Your Uber Eats order, sir."
3200,332,33,88,257,378,1.4074074074074074,0.033219381163427056,666,"Yeah, I've got your Uber Eats order."
3183,332,32,57,208,297,1.4074074074074074,0.0392890719317828,666,"Because he's a card shark, and I owe him a fin."""
3083,337,37,82,264,383,1.4073107049608355,0.03373053764361329,666,"At the count of three, we each grab a leg and make a wish."
2706,337,31,94,258,383,1.4073107049608355,0.03249198814442148,666,"Grab a leg, and make a wish...."
1796,337,35,86,262,383,1.4073107049608355,0.03332280316855937,666,"He’s my chum, not yours."
882,337,32,92,259,383,1.4073107049608355,0.03270167079730877,666,he thinks he found a sandbar
657,337,34,88,261,383,1.4073107049608355,0.03311705348687017,666,Are you the guy who ordered dinner?
500,337,35,86,262,383,1.4073107049608355,0.03332280316855937,666,"I was running late, so I got my meal to go."
586,343,33,85,253,371,1.4070080862533694,0.03366167433735079,666,"The worst part is, I just ate."
6266,344,38,79,264,381,1.4068241469816274,0.03405851489604234,666,You the guy who ordered the sushi?
5676,344,38,79,264,381,1.4068241469816274,0.03405851489604234,666,Do stupid people taste good?
2260,344,32,91,258,381,1.4068241469816274,0.03281917215026713,666,"I don’t care how much good publicity we need, this is humiliating."
1493,344,30,95,256,381,1.4068241469816274,0.032395523382053586,666,"I know, you hate it when I play with my food..."
109,344,33,89,259,381,1.4068241469816274,0.033028958859532866,666,I think it’s a great white.
532,349,28,116,279,423,1.4066193853427895,0.02975682516245466,666,Imagine how he'll spin this for his college essay.
1171,350,30,94,255,379,1.4063324538258575,0.032511200204399765,666,Uber Eats
1484,350,18,118,243,379,1.4063324538258575,0.029823697041820103,666,My wife sent me for takeout.
2400,350,32,90,257,379,1.4063324538258575,0.03293780519370731,666,I have to wait for that music to start.
3957,350,32,90,257,379,1.4063324538258575,0.03293780519370731,666,When should I tell him I am not a dolphin?
4534,354,30,93,254,377,1.4058355437665782,0.03262799056221873,666,It works like a charm to catch lifeguards
1735,355,28,86,236,350,1.4057142857142857,0.03390151774888598,666,Remember this is an aquarium - eat him and there is no more
4092,356,24,66,191,281,1.405693950177936,0.038355707076980494,666,"Trust me, it'll be funnier AFTER he realizes..."
3091,357,34,83,256,373,1.4048257372654156,0.03373072885653146,666,Surf and Turf
4666,357,38,75,260,373,1.4048257372654156,0.034574806342974655,666,He's all yours.  I can't eat anything this stupid.
2124,357,25,101,247,373,1.4048257372654156,0.03174961337016235,666,It's the only way to get that knot out of my back.
5411,360,24,120,271,415,1.4048192771084338,0.029348945145280726,666,I'm on my way to a potluck.
3407,361,26,98,247,371,1.4043126684636118,0.03208964047918465,666,I'm just gonna ride this one out.
5740,362,26,91,237,354,1.4039548022598871,0.033139245041514054,666,I enjoy giving them a false sense of security.
547,363,32,85,252,369,1.4037940379403795,0.03354855935810284,666,I'm seriously thinking I should say something.
5994,363,32,85,252,369,1.4037940379403795,0.03354855935810284,666,Take a bite and tell me if it tastes like chicken.
2968,363,32,85,252,369,1.4037940379403795,0.03354855935810284,666,His name is Jesus and he likes it when people think he can walk on water.
5957,363,26,97,246,369,1.4037940379403795,0.0322045864137745,666,Do I LOOK like a dolphin?
953,367,29,88,245,362,1.4033149171270718,0.033323437603255186,666,I just don't feel like I command the respect I used to.
2909,368,29,90,248,367,1.4032697547683923,0.033004446082192364,666,"Like Donald Trump, he thinks he is on solid ground."
3006,369,33,81,251,365,1.4027397260273973,0.03402335804449067,666,Can I keep him?
252,369,30,87,248,365,1.4027397260273973,0.03335308941448583,666,He's a lawyer. It's a professional courtesy.
5686,371,25,105,255,385,1.4025974025974026,0.031057023489787325,666,I am so sick of tourist season - you can have this one.
1583,371,29,97,259,385,1.4025974025974026,0.03191631655059455,666,'I won't eat him right away. My back feels great.'
2176,373,33,80,250,363,1.4022038567493114,0.034153298223046566,666,It’s harder than goat yoga and it comes with a snack.
4107,374,22,99,235,356,1.401685393258427,0.03201802941562449,666,I don't mind. He's waving a 'Save the Sharks' poster.
501,375,23,96,235,354,1.4011299435028248,0.032382636848660884,666,"My dermatologist isn't worried about it, but I want a second opinion."
486,375,27,88,239,354,1.4011299435028248,0.03335647809929388,666,I find it makes the other swimmers more relaxed.
2162,377,26,91,240,357,1.4005602240896358,0.03291843828945026,666,He's picking up plastic.
5500,377,26,91,240,357,1.4005602240896358,0.03291843828945026,666,"It's not how I imagined global warming either, but here we are."
346,379,32,80,248,360,1.4,0.03411343431106288,666,"I'm trying to quit, but they make it too damn easy."""
1740,379,33,72,240,345,1.4,0.0354089213164813,666,"God, I hate being a Nurse Shark.  This guy says he has bunions."
4359,379,39,76,270,385,1.4,0.033949924927713794,666,Best spa ever. Back massage followed by dinner for two.
3023,379,25,92,238,355,1.4,0.032799901406361714,666,It feels so good I just couldn't eat him.
2168,379,12,32,96,140,1.4,0.054405126413433376,666,"'It takes a lot of self control, but I am getting a great massage.'"
3816,384,32,81,250,363,1.399449035812672,0.033907496993095004,666,It's a matter of perception vs. reality.  He thinks I am a log and I know he is my lunch.
113,385,31,81,246,358,1.399441340782123,0.03401566263056836,666,I'm a comfort shark...
3481,385,29,85,244,358,1.399441340782123,0.03355246442545551,666,"You go high, I'll go low."
4180,385,30,83,245,358,1.399441340782123,0.033784857356647977,666,He's not heavy. He's my lunch.
4945,385,27,89,242,358,1.399441340782123,0.03308278153127802,666,"Well, then, you should have asked for fries when you placed your order."
4608,389,32,88,261,381,1.398950131233596,0.03275780046303815,666,Pretty soon this guy won't have a leg to stand on.
3813,390,35,72,249,356,1.398876404494382,0.0350614443318335,666,The top half was delicious.
5505,390,22,98,236,356,1.398876404494382,0.03199337625328857,666,It's take your dinner to work day.
3176,390,25,92,239,356,1.398876404494382,0.032726930661445344,666,Do you think he knows that he's taking the last selfie of his life?
2253,390,27,88,241,356,1.398876404494382,0.03320696565695356,666,"Be my guest, I can't reach him."
352,390,27,88,241,356,1.398876404494382,0.03320696565695356,666,"It’s all about branding.  If we save one once in a while, we’ll be right up there with the dolphins"
931,390,25,92,239,356,1.398876404494382,0.032726930661445344,666,It's a shame we have to throw them back if they are under three feet.
3333,396,31,79,244,354,1.3983050847457628,0.034279280701449144,666,"She can't complain it's not ""fresh"" this time!"
3643,396,31,79,244,354,1.3983050847457628,0.034279280701449144,666,Tee hee.  He thinks I’m inflated.
5151,396,26,89,239,354,1.3983050847457628,0.033091460499851254,666,"They’re delicious, but they need air."
5815,396,32,77,245,354,1.3983050847457628,0.03451193925133517,666,The wife likes her takeout fresh
4350,400,30,100,272,402,1.3980099502487562,0.031140088951186962,666,I got some takeout from that new sand bar.
331,401,29,74,229,332,1.3975903614457832,0.035375032634230356,666,Don't ask.
3226,402,28,83,239,350,1.3971428571428572,0.03383003227255872,666,"What, do I have something in my teeth?"
5210,403,30,77,238,345,1.3971014492753624,0.03466303455198104,666,It's my spirit animal.
5938,404,34,70,244,348,1.396551724137931,0.03539406620320622,666,Its Spielberg
4935,405,25,76,217,318,1.3962264150943395,0.035364873564966516,666,The odds of this occurring are roughly the same as getting struck by lightning.
4494,406,33,71,242,346,1.3959537572254335,0.03530101712420595,666,I didn't know they delivered.
2095,406,30,77,239,346,1.3959537572254335,0.034581757106965226,666,"My new workout?  Strength training until failure, then a high protein snack."
4936,406,24,89,233,346,1.3959537572254335,0.03309637674743955,666,I like to eat a balanced diet.
739,406,32,73,241,346,1.3959537572254335,0.03506290321033567,666,"It's bring Your Victim to Work Week."""
993,410,26,84,234,344,1.3953488372093024,0.03372893683835241,666,"I owe him, He pulled a hook out of my tail years ago"
87,411,35,90,280,405,1.3950617283950617,0.03192765124734046,666,I feel like a Golden Retriever with a Cheerio on its nose.
4931,412,45,83,310,438,1.3949771689497716,0.03189117856167451,666,"What can I say, he’s a lawyer. He’s one of us."
5732,413,30,75,237,342,1.394736842105263,0.0348586699995651,666,Call me Fishmael.
5417,414,28,95,260,383,1.3942558746736293,0.03174803779135385,666,It's even better than goat yoga.
3940,414,29,93,261,383,1.3942558746736293,0.031962601317157585,666,"I know, but my doctor told me to just leave it alone and eventually it'll fall off."
2370,416,25,84,231,340,1.3941176470588235,0.0337371302181163,666,"Actually, I do like working for Uber."
2789,417,30,83,250,363,1.393939393939394,0.03340858741130483,666,Tourists ...its too easy
5295,418,37,67,254,358,1.393854748603352,0.03532312215250443,666,He's not heavy. He's my dinner.
4313,419,24,85,229,338,1.393491124260355,0.03360919109614365,666,"It's called ""take out""."
4440,419,23,87,228,338,1.393491124260355,0.0333469547119449,666,It's like he knows I'm fasting.
4510,419,34,65,239,338,1.393491124260355,0.03612701346503866,666,He's out of his depth and clueless. Sad.
4801,419,28,77,233,338,1.393491124260355,0.03463828916738664,666,"I don't know, it's some kind of parasite."
6014,419,23,87,228,338,1.393491124260355,0.0333469547119449,666,Are you the one who ordered from Grubhub?
6210,424,31,67,230,328,1.3932926829268293,0.03616298218497121,666,What kills me is he thinks he’s the great white.
2606,425,31,72,238,341,1.3929618768328447,0.03516185357855177,666,"No, papa, I love him!"
4875,426,35,62,239,336,1.3928571428571428,0.0365224830161024,666,Best. Disguise. Ever.
3812,426,26,80,230,336,1.3928571428571428,0.03426334854488058,666,Just my luck. Every time I go on a diet...
3889,426,26,80,230,336,1.3928571428571428,0.03426334854488058,666,Does this thing make my dorsal fin look weird?
1907,426,18,63,171,252,1.3928571428571428,0.03897989833471725,666,Don't let this get around.
3112,430,31,73,240,344,1.3924418604651163,0.034937003062252,666,I'm looking for some fava beans and a nice chianti.
436,431,25,81,228,334,1.3922155688622755,0.03413817160277506,666,"I saved you the bottom half."""
5474,431,24,83,227,334,1.3922155688622755,0.03387377608815291,666,"Oh my God, where is it?  On my back?  Don't kill it, just get it off me!"
3132,433,23,84,225,332,1.391566265060241,0.03373955436404343,666,It's a balanced diet.
3752,433,26,78,228,332,1.391566265060241,0.03453920366164215,666,You wanna tell him? Or should I?
3441,433,24,82,226,332,1.391566265060241,0.034008193360565715,666,Care to join me for take-out ?
3365,433,28,74,230,332,1.391566265060241,0.0350621728292923,666,I'm taking it to the potluck.
3338,433,24,82,226,332,1.391566265060241,0.034008193360565715,666,The legs taste better after marinating for an hour.
2618,433,26,78,228,332,1.391566265060241,0.03453920366164215,666,He’s looking for us!
4237,433,25,80,227,332,1.391566265060241,0.03427472687878067,666,I'm saving the rest for later
2079,433,27,76,229,332,1.391566265060241,0.03480167059992636,666,Don’t pretend like you’ve never seen live bait before.
1714,433,25,80,227,332,1.391566265060241,0.03427472687878067,666,He says the cell signal is better out here.
663,433,22,86,224,332,1.391566265060241,0.03346875919000968,666,I'd eat him but I've never had such a good massage before.
2359,433,28,74,230,332,1.391566265060241,0.0350621728292923,666,I picked up some take-out.
5921,433,28,74,230,332,1.391566265060241,0.0350621728292923,666,"Whatever it is he's trying to prove, he's not going to have a leg to stand on."
2952,445,23,76,213,312,1.391025641025641,0.03521000326118721,666,I heard Everest just got too popular for them.”
5898,446,26,77,227,330,1.3909090909090909,0.034679379537921204,666,What?? Do I have something caught in my teeth?
3459,447,33,70,245,348,1.3908045977011494,0.03510919715504762,666,"When I show my dorsal fin above the water they all run screaming, but with this sunburned mannequin they never see me coming."
463,448,24,80,224,328,1.3902439024390243,0.03428139813800021,666,"I know, never get attached to them, but this one is different."
807,449,21,77,207,305,1.3901639344262295,0.03515197066853836,666,"No, I wouldn't say I let people ""walk all over me"""
4253,450,26,47,181,254,1.389763779527559,0.04182460956182487,666,Because a real periscope costs an arm and a leg.
269,451,26,77,228,331,1.3897280966767371,0.03459461357716717,666,"No, you _can't_ have the top.""That's the best part."
1226,452,24,79,223,326,1.3895705521472392,0.034420235588994645,666,Do I have some food stuck in my dorsal fin?
5768,452,25,77,224,326,1.3895705521472392,0.03469336315053174,666,let's do the old bait and switch.
1187,452,25,77,224,326,1.3895705521472392,0.03469336315053174,666,"I know we shouldn't play with our food, but this seems to help my back."
1183,452,26,75,225,326,1.3895705521472392,0.034964357213989404,666,Here’s your order sir!
933,452,27,73,226,326,1.3895705521472392,0.03523326700832939,666,Should you tell him or should I?
265,457,27,72,225,324,1.3888888888888888,0.035380330179856555,666,I can never resist playing with my food.
698,457,22,82,220,324,1.3888888888888888,0.03400313180456239,666,I'm taking him out for lunch.
2000,457,26,74,224,324,1.3888888888888888,0.03510921254332292,666,Want half?
2044,457,23,80,221,324,1.3888888888888888,0.03428299769188639,666,He keeps yelling “help!” Do you think there’s anything we can do for him?
4469,457,25,55,190,270,1.3888888888888888,0.039647119378234376,666,I'll let him post to Instagram first.
5706,457,21,84,219,324,1.3888888888888888,0.03372094325927133,666,What can I say - I like to play with my food.
5926,457,21,84,219,324,1.3888888888888888,0.03372094325927133,666,I brought dessert.
601,464,21,83,218,322,1.3881987577639752,0.03385580863496921,666,I got my sea legs.
4097,465,29,70,231,330,1.387878787878788,0.03543847828721219,666,"If he likes the ride, I get five stars on Kelp."
5110,466,28,70,227,325,1.3876923076923078,0.03555966445686191,666,I like mine golden brown on top.
3588,466,26,74,225,325,1.3876923076923078,0.035021465298174445,666,I think it's time to show ol' Macheath here our pearly whites.
6269,466,28,70,227,325,1.3876923076923078,0.03555966445686191,666,No you can’t have him.  I’m delivering for GrubHub.
6100,469,27,70,223,320,1.3875,0.035679422078764234,666,I don’t eat white meat.
4703,469,26,72,222,320,1.3875,0.0354037947596805,666,I prefer dark meat. He's all yours.
2801,469,17,90,213,320,1.3875,0.032819146774167154,666,How do you want him- over easy?
2507,469,23,78,219,320,1.3875,0.034563727430913696,666,Business has really picked up ever since the ferry boat broke down.
784,473,25,75,223,323,1.3869969040247678,0.03489242838677839,666,Took him 'to go'
1259,474,14,100,217,331,1.3867069486404835,0.031225321384121627,666,"Remember, I said to pack a lunch...?"
242,475,23,77,219,319,1.3855799373040751,0.03461870818851017,666,He's all yours. I'm not big on white meat
781,475,24,75,220,319,1.3855799373040751,0.034902301589620446,666,I found a really good take out place right on the beach...
3462,475,26,71,222,319,1.3855799373040751,0.035462685395722976,666,And somehow this isn't the scariest platform in America.
291,478,20,81,213,314,1.3853503184713376,0.03411332296474794,666,He said he was going to get me featured on Shark Tank.
1411,479,14,56,148,218,1.385321100917431,0.04102877022935394,666,"I'd eat him, but it's so hard to find a good shiatsu practitioner and he knows just the right pressure point on my dorsal."
5887,480,19,56,169,244,1.3852459016393444,0.04019342133523279,666,"I know we don't normally get aggressive, but this guy is pissing me off."
420,481,18,41,141,200,1.385,0.04576403318839307,666,"Sure, but when one of us mistakes a surfboard for a seal, all hell breaks loose."
150,482,25,72,220,317,1.384858044164038,0.03533165811687274,666,A lot has changed since I became a vegetarian.
45,482,21,80,216,317,1.384858044164038,0.03418279434191939,666,It’s Ramadan.
100,484,26,53,194,273,1.3846153846153846,0.03962891198952213,666,Dad said he could clear a whole beach in the mid-70s
1423,485,15,66,169,250,1.384,0.03784050230187004,666,"He’s not my friend, really more of a chum."
5734,486,12,19,81,112,1.3839285714285714,0.06372895432545032,666,"Let's wait another sec, .   .   .   he still thinks he's on his buddy's shoulders."
2256,487,22,75,213,310,1.3838709677419354,0.034996510770956314,666,These new lures are a hit.
3788,487,19,81,210,310,1.3838709677419354,0.034089862828467654,666,"So, what are you doing to improve our image?"
5161,487,21,77,212,310,1.3838709677419354,0.034696927241217694,666,The Great White suggests allowing the meat to stand just a bit prior to consumption.
1630,487,26,67,217,310,1.3838709677419354,0.03617003996097998,666,"I'm with Uber. If they don't tip, I eat them."
3086,491,20,59,179,258,1.3837209302325582,0.03903096334583673,666,I am trying to make him feel what it’s like to be endangered.”
2482,492,22,76,215,313,1.3833865814696487,0.03476000088938016,666,I try to maintain a balanced diet.
5260,492,23,74,216,313,1.3833865814696487,0.03505335524965683,666,I'm saving the legs for dessert.
3973,494,15,47,139,201,1.3830845771144278,0.04390811515168759,666,Shhh! He thinks he’s standing on a rock.
3844,495,28,63,220,311,1.382636655948553,0.036645210669544126,666,He’s a lawyer and 23andMe says we’re related.
4286,495,19,81,211,311,1.382636655948553,0.03400248286237585,666,What he doesn't know is about to hurt him.
5105,495,26,67,218,311,1.382636655948553,0.036074672458233106,666,"Quick, take a photo for my Instagram!"
5626,495,20,79,212,311,1.382636655948553,0.03430617403368376,666,"Yep, another adrenaline junkie followed me home."
5863,495,29,61,221,311,1.382636655948553,0.03692717428992509,666,I had to do something—Dolphins are killing us in the PR department!
1298,500,22,73,211,306,1.3823529411764706,0.03529501052479647,666,So what? You've got ramoras.
5573,501,24,70,215,309,1.3818770226537216,0.03564738784113651,666,I gave up eating idiots for Lent.
6260,501,27,64,218,309,1.3818770226537216,0.036520953057943985,666,It’s a long trip. Thought I’d carry a snack  for the road”
6048,501,22,74,213,309,1.3818770226537216,0.03505291844702302,666,Yoo-hoo. My eyes are down here.
5978,501,21,76,212,309,1.3818770226537216,0.03475187056162972,666,I thought it was potluck.
5808,501,26,66,217,309,1.3818770226537216,0.03623210493663275,666,Can you please get a picture of this?
4622,501,23,72,214,309,1.3818770226537216,0.03535140274126371,666,Stick around! I am using him as bait!
3823,501,22,74,213,309,1.3818770226537216,0.03505291844702302,666,I'm tired of all the hate
2560,501,30,58,221,309,1.3818770226537216,0.03737410553611536,666,"He's bait, you idiot!"
1457,501,26,66,217,309,1.3818770226537216,0.03623210493663275,666,I brought my lunch.
960,501,30,58,221,309,1.3818770226537216,0.03737410553611536,666,I can't believe I missed and ate his surfboard.  I think I need glasses.
874,501,23,72,214,309,1.3818770226537216,0.03535140274126371,666,May I borrow your Grey Poupon?
131,512,18,80,206,304,1.381578947368421,0.034199835317246165,666,"Be patient. He just asked his wife to come in - 
there'll be plenty for both of us."
377,512,28,60,216,304,1.381578947368421,0.037239169050641265,666,"When I'm through with him, he won't have a leg to stand on."
4844,514,21,69,201,291,1.3814432989690721,0.036211743453722384,666,"If we don't nip this in the bud, sharkboardng may become a 'thing'."
42,515,21,51,172,244,1.3811475409836065,0.04097601629774026,666,I feel so much better since I went vegan.
4743,516,24,69,214,307,1.3811074918566775,0.03580157566905003,666,Hey! I didn't criticize you when you brought YOUR lawyer!
3128,516,26,65,216,307,1.3811074918566775,0.036391376510256715,666,We decided to try that new carry out place.
1780,516,25,67,215,307,1.3811074918566775,0.0360976807059538,666,I bet this idiot thinks he's on top of the food chain right now?
2788,516,26,65,216,307,1.3811074918566775,0.036391376510256715,666,I just can't bear to tell him he's really in over his head.
3959,520,24,68,213,305,1.380327868852459,0.035957560428879105,666,Just stay calm - it’s more afraid of you than you are of it.
1329,520,20,76,209,305,1.380327868852459,0.0347370821318313,666,They're so tame these days. It's no fun anymore.
1638,520,24,68,213,305,1.380327868852459,0.035957560428879105,666,The Hamptons have become way too crowded.
1896,520,21,74,210,305,1.380327868852459,0.03504618658676459,666,"Sometimes, I feel like they just don't respect me anymore."
2013,520,24,68,213,305,1.380327868852459,0.035957560428879105,666,"It keeps calling me ""Dude""."
2470,520,22,72,211,305,1.380327868852459,0.03535258849808657,666,Meals on Fins!
4961,520,26,64,215,305,1.380327868852459,0.03655252098662884,666,I''m saving the bottom half until later
5613,520,25,66,214,305,1.380327868852459,0.036256261131523436,666,He promised to fix my back. I promised not to eat him.
4862,520,23,70,212,305,1.380327868852459,0.03565635753629032,666,He's my chum or at least will be soon.
3774,520,19,78,208,305,1.380327868852459,0.03442520233481378,666,When do you think we should let him know?
4956,530,22,79,223,324,1.3796296296296295,0.033905415837817136,666,I don't have the heart to tell him I'm not a dolphin
517,531,26,63,214,303,1.3795379537953796,0.03671557301458464,666,He said he was a lawyer...professional courtesy.
1525,532,26,74,232,332,1.3795180722891567,0.034418370135393755,666,Let's make a wish.
3373,533,26,69,224,319,1.3793103448275863,0.03539726970972144,666,"They call it Extreme Paddleboarding.
I call it lunch."
1123,534,19,70,196,285,1.3789473684210527,0.03603009274932772,666,"My body, my choice."
2166,535,19,76,206,301,1.3787375415282392,0.03471509101920299,666,It's 2019. We're in love. And it's beautiful.
5678,535,21,72,208,301,1.3787375415282392,0.03534733841400768,666,"The dolphin noises worked."""
2151,537,18,77,204,299,1.3779264214046822,0.03453912183188849,666,"Bite his leg off, will ya? My dorsal fin's going to sleep."
3548,537,17,79,203,299,1.3779264214046822,0.03421264023204323,666,Professional courtesy. He's a politician.
4396,537,21,71,207,299,1.3779264214046822,0.03550055623128285,666,I always like to bring a snack.
597,537,19,75,205,299,1.3779264214046822,0.03486254612315127,666,"Am I losing my edge, Alan?"
545,537,23,67,209,299,1.3779264214046822,0.03612730080246934,666,"White people, amiright?"
5460,537,24,65,210,299,1.3779264214046822,0.03643663058712915,666,What? It's Take Your Prey to Work day.
92,537,19,75,205,299,1.3779264214046822,0.03486254612315127,666,Meet my new chum!
3482,537,24,65,210,299,1.3779264214046822,0.03643663058712915,666,What was I supposed to do? Let him drown?
1902,545,23,70,214,307,1.3778501628664495,0.035466846842695056,666,I got this one to go.
3022,546,25,61,208,294,1.3775510204081634,0.03718206633152492,666,He's a lawyer- it's just professional courtesy
5823,547,14,55,151,220,1.3772727272727272,0.040668542351476634,666,"Yeah, he thinks he’s standing on a sandbar."
4492,548,19,74,204,297,1.3771043771043772,0.035011715887532185,666,He hasn't yet noticed I ate his surfboard.
3235,548,27,58,212,297,1.3771043771043772,0.03752093324251751,666,It’s Human Week.
2932,548,24,64,209,297,1.3771043771043772,0.03660014157266864,666,"You don't feel like cooking, so I got some take-out."
2800,548,22,68,207,297,1.3771043771043772,0.03597318887226071,666,I'm tired of Dolphins getting all the good press.
1035,548,24,64,209,297,1.3771043771043772,0.03660014157266864,666,I still play with my food — so what?
180,548,15,82,200,297,1.3771043771043772,0.03368709186601275,666,"No, he's just my massage therapist."
6037,554,25,65,215,305,1.3770491803278688,0.0362201565980196,666,"I prefer standing rib, don't you?"
5934,554,20,75,210,305,1.3770491803278688,0.03469939693685525,666,"Oh yeah ! The old sandbar trick, it works every time !"
4869,556,22,67,206,295,1.376271186440678,0.0361329613343468,666,Look what followed me home.
149,556,24,63,208,295,1.376271186440678,0.03676562304329744,666,I’m swimming for the new ride-sharing app  Scuber”
1729,556,22,67,206,295,1.376271186440678,0.0361329613343468,666,He thinks I'm a dolphin. What should I do?
1536,559,17,57,168,242,1.3760330578512396,0.03945311125433341,666,"Shark surfing, apparently it's a thing."
668,560,20,57,181,258,1.375968992248062,0.03893799664726696,666,"Join the aquarium they said,
It'll be fun they said"
1662,561,24,61,205,290,1.3758620689655172,0.03720824291315553,666,It's complicated.
3754,562,26,58,209,293,1.3754266211604096,0.03756072143305356,666,i come bearing gifts
3366,562,22,66,205,293,1.3754266211604096,0.03629465231697984,666,Humans endangered species? You must be joking!
1440,564,24,60,204,288,1.375,0.037381248288108786,666,Bless us O Lord and these Thy gifts which we areabout to recieve...
5202,564,22,49,177,248,1.375,0.040831159949587324,666,So you're sayin' he made up the whole symbiosis thing.
1843,564,18,54,168,240,1.375,0.04010316194923238,666,"Move to Marineland it will be fun, they said."
5724,567,17,75,199,291,1.3745704467353952,0.03479525904786605,666,Did you know shark yoga was a thing?
3939,567,24,61,206,291,1.3745704467353952,0.03710264795718481,666,Pardon me. Would you have any Grey Poupon?
1585,569,18,80,212,310,1.3741935483870968,0.03366990767462228,666,I’ve just about had it with being his companion animal.
325,569,18,80,212,310,1.3741935483870968,0.03366990767462228,666,"I know, I know. I just don’t have the heart to tell him I’m not a dolphin."
209,571,21,65,200,286,1.3741258741258742,0.03656327614446005,666,"Mom, I'm not going to be ashamed of who I love anymore."
1610,572,24,60,205,289,1.3737024221453287,0.037274269090101224,666,Pretty soon he won't have a leg to stand on!
279,572,23,62,204,289,1.3737024221453287,0.0369505333746392,666,Do these make my neck look fat?
2970,572,19,70,200,289,1.3737024221453287,0.035626184731830705,666,It's called 'delayed gratification training.'
503,575,21,79,224,324,1.373456790123457,0.03355216103017742,666,"Relax, he's just saying his goodbyes."
3923,576,20,66,198,284,1.3732394366197183,0.036390929537855284,666,"I just don't know if I really want to eat him or if it's because society wants me to"""
4155,577,19,65,192,276,1.3731884057971016,0.03675966064716292,666,Since when are you concerned about sustainability?
1445,578,25,57,205,287,1.372822299651568,0.037771944504335915,666,I WAS GOING TO EAT HIM BUT MY BACK NEVER FELT BETTER
3251,578,17,73,197,287,1.372822299651568,0.03509690538271594,666,I saved this one for you. I'm already stuffed to the gills.
4782,578,20,67,200,287,1.372822299651568,0.036123266761417895,666,He's heavy...and he ain't my brother.
5736,578,20,67,200,287,1.372822299651568,0.036123266761417895,666,I'm just not into him
3669,578,19,69,199,287,1.372822299651568,0.035784417327827826,666,"I'd eat him, but I like the back rub."
5531,578,25,57,205,287,1.372822299651568,0.037771944504335915,666,I'm still a man eater. Uber is just a side hustle.
4300,584,17,71,194,282,1.372340425531915,0.0355070244633224,666,"It's a symbiotic relationship.  He gets a free ride, and I get to swim close to shore undetected."
3496,585,19,68,198,285,1.3719298245614036,0.03594456625551901,666,Here’s one guy who’s gonna be defeeted.
5939,585,21,64,200,285,1.3719298245614036,0.03662555346001849,666,It's just until he finishes his beer.
4339,585,20,66,199,285,1.3719298245614036,0.036286657393249024,666,It's just easier to carry your lunch.
2739,585,22,62,201,285,1.3719298245614036,0.036961342342105345,666,Do you want to surprise him or should I?
2966,585,24,58,203,285,1.3719298245614036,0.03762393055869609,666,"So, should I tell him, or do you want to?"
3808,585,14,78,193,285,1.3719298245614036,0.03418279590538503,666,I don't have the heart to tell him I'm not a sandbar.
1806,591,18,68,194,280,1.3714285714285714,0.03602273357900112,666,"I broke his surfboard, it's the least I could do."
4163,591,18,68,194,280,1.3714285714285714,0.03602273357900112,666,I know. But it supposedly cures hiccups.
2149,593,22,64,205,291,1.3711340206185567,0.036416948900721696,666,What would Darwin do?
560,594,23,59,201,283,1.3710247349823321,0.037469114970654804,666,It's one of my best lures.
4983,594,20,65,198,283,1.3710247349823321,0.036452054257135276,666,It was developed by the same people who came up with goat yoga.
3520,594,27,51,205,283,1.3710247349823321,0.038783729400048234,666,I could only eat half!
2749,594,22,61,200,283,1.3710247349823321,0.03713319006375756,666,Carryout.
987,594,19,67,197,283,1.3710247349823321,0.03610666818182107,666,Word to the wise: never lose a bet to Shamu
662,594,19,67,197,283,1.3710247349823321,0.03610666818182107,666,I’m full. You want him?
5999,600,19,72,206,297,1.3703703703703705,0.034929576209129246,666,I had the top half for breakfast.
2994,600,17,76,204,297,1.3703703703703705,0.03427207680677263,666,Did you order the take-out?
18,602,16,72,193,281,1.3701067615658362,0.03520383249062342,666,I've literally got lunch on my mind
411,602,25,54,202,281,1.3701067615658362,0.03831559220425543,666,I'm a Scuber driver.
5139,602,13,78,190,281,1.3701067615658362,0.034103541762055024,666,"It's that first moment of realization I savor most, though the panicked thrashing is also quite satisfying."
3487,605,22,57,194,273,1.36996336996337,0.03807223378488415,666,He's endangered.
5848,606,20,62,194,276,1.3695652173913044,0.03707065998469343,666,I’ve found that strapping a lawyer on my back scares more swimmers than my fin alone.
715,607,24,55,200,279,1.3691756272401434,0.038165108657853296,666,The top half was pretty tasty.
776,607,20,63,196,279,1.3691756272401434,0.036789023186918,666,Fear is a tenderizer.
4855,607,20,63,196,279,1.3691756272401434,0.036789023186918,666,I'd eat him but he's such a stand up guy.
4005,610,20,61,193,274,1.3686131386861313,0.03724598432685041,666,I do one National Geographic Special and he's been following me around ever since.
4338,610,19,63,192,274,1.3686131386861313,0.0368853100225735,666,"It's realistic, isn't it? Now lets see if it works..."
6076,612,22,58,197,277,1.3682310469314078,0.03766181072088766,666,I've seen better legs on a hermit crab.
805,612,15,72,190,277,1.3682310469314078,0.03514670042982575,666,Dinner’s almost ready - just letting it rest for a few minutes
1405,612,20,62,195,277,1.3682310469314078,0.03696067608396731,666,I don’t have the heart to tell him he’s not swimming with dolphins.
4042,612,17,68,192,277,1.3682310469314078,0.03588329641066898,666,I always carry a snack with me when I’m out and about.
2132,612,16,70,191,277,1.3682310469314078,0.03551690803265286,666,"I want to tell him ""a little to the left"" but I'm afraid he'll freak out."
910,617,17,66,190,273,1.3663003663003663,0.036211517732759525,666,"It's strickly business. For luring them over to me, he keeps any jewelry and cash."
5316,617,21,58,194,273,1.3663003663003663,0.03766974141619512,666,There are days  I wish I never would have  gotten involved with Uber!
3447,617,22,56,195,273,1.3663003663003663,0.03802556072993886,666,Do I have some food on my fin?
2813,617,22,56,195,273,1.3663003663003663,0.03802556072993886,666,Watch me flip him in the air and catch him in my mouth
1934,617,21,58,194,273,1.3663003663003663,0.03766974141619512,666,I named him Finn.
535,617,16,68,189,273,1.3663003663003663,0.03583769197432635,666,It looks like it's white meat for dinner. Do you prefer the leg or the thigh?
3924,623,21,57,193,271,1.3653136531365313,0.03785161759761161,666,It's the least I could do since I ate his surfboard .
1749,624,16,71,195,282,1.3652482269503545,0.035055479007084785,666,I'm beginning to rethink this ride sharing gig.
3968,625,19,63,195,277,1.364620938628159,0.036557311827643574,666,Somehow  he thinks I'm taking him back to his surfboard.
1822,625,22,57,198,277,1.364620938628159,0.037615391309297745,666,"I was going to eat him, but this massage feels fantastic."
972,627,20,58,191,269,1.3643122676579926,0.03766940462714552,666,As my sponsor can you help me with how to react or handle this situation? The urge to eat him is so strong.
6002,627,19,60,190,269,1.3643122676579926,0.03729935275199355,666,"His surf, our turf."
4423,629,24,63,218,305,1.3639344262295081,0.03576528054068725,666,I brought a snack in case we get hungry later.
412,630,17,74,206,297,1.3636363636363635,0.034183678792614226,666,He does wonders for my spine.
6148,631,21,55,191,267,1.3632958801498127,0.03822250618361879,666,Some moron ate his surfboard
3645,631,20,57,190,267,1.3632958801498127,0.037852340622416256,666,I'm taking my lunch to work today.
830,631,22,53,192,267,1.3632958801498127,0.03858912110061758,666,I thought I’d  do carry out this evening.
1366,631,18,61,188,267,1.3632958801498127,0.0371009314421177,666,He's just some guy from Helsinki. Calls himself a dorsal Finn.
1106,635,16,61,179,256,1.36328125,0.037380291724458725,666,"Yeah, I’m embarassed, but it feels so good."
5159,636,17,51,166,234,1.3632478632478633,0.04020323895268883,666,It's Ramadan.  He has until sundown.
5305,637,14,67,181,262,1.3625954198473282,0.035985853455095064,666,I told you they'd try to domesticate us next.
2145,638,19,58,188,265,1.3622641509433961,0.03766001528326057,666,"It's a good decoy, but the glue gives me hives."
789,638,20,56,189,265,1.3622641509433961,0.03803767232063814,666,This is what white privilege looks like.
3035,640,18,58,184,260,1.3615384615384616,0.03776016270314985,666,What?  He's my emotional support human.
2530,640,21,52,187,260,1.3615384615384616,0.03892210138813728,666,I decided to get carry-out from the beach.
1531,640,20,54,186,260,1.3615384615384616,0.038538681175779854,666,"Yeah, it looks annoying, but after he does his job, it's like a big buffet."
4027,640,21,52,187,260,1.3615384615384616,0.03892210138813728,666,I just love climate change.
5906,640,18,58,184,260,1.3615384615384616,0.03776016270314985,666,Shh! He thinks I'm a sandbar. Don't spoil the surprise.
3194,640,20,54,186,260,1.3615384615384616,0.038538681175779854,666,I really don't like white meat.
726,640,16,62,182,260,1.3615384615384616,0.03696525162863482,666,"Yes, as a matter of fact, I do regret going Vegan."
197,640,20,54,186,260,1.3615384615384616,0.038538681175779854,666,I had him stuffed and mounted as a trophy.
2,640,19,56,185,260,1.3615384615384616,0.038151407799298556,666,"'""Wait 'til he says Polo."""
594,649,21,53,189,263,1.361216730038023,0.0386032382787696,666,Zero respect since Jaws.
4747,649,15,65,183,263,1.361216730038023,0.0362775373186456,666,I picked up dinner
4709,649,19,57,187,263,1.361216730038023,0.037843888652906034,666,Karma’s a bitch.
4497,649,19,57,187,263,1.361216730038023,0.037843888652906034,666,I'd eat him but I don't want to ruin my rideshare rating.
1013,649,19,57,187,263,1.361216730038023,0.037843888652906034,666,Professional courtesy - he's a lawyer.
6267,649,16,63,184,263,1.361216730038023,0.03667539723742172,666,"I have to stay still. He's already been calling for more friends to come play at the ""sandbar""."
3361,655,18,47,165,230,1.3608695652173912,0.041117812481512084,666,Now I understand why the oceans are warming.
2191,656,18,57,183,258,1.3604651162790697,0.03794655774804542,666,"I know, right? Second day as a vegan and already I'm being tempted."
2986,656,20,53,185,258,1.3604651162790697,0.03873328814551959,666,"Yea, I got approved to have an emotional support human."
2683,656,21,51,186,258,1.3604651162790697,0.03912072076768141,666,I'd eat him but I think he was farm-raised.
3328,656,18,57,183,258,1.3604651162790697,0.03794655774804542,666,Would you get this guy off my back?
4562,656,20,53,185,258,1.3604651162790697,0.03873328814551959,666,I'm just waiting for the rest of the beach crowd to think it's shallow water
5080,656,18,57,183,258,1.3604651162790697,0.03794655774804542,666,Wanna split it?
5520,656,17,59,182,258,1.3604651162790697,0.0375470113605157,666,You could've at least brought dessert.
5853,656,13,67,178,258,1.3604651162790697,0.03590439152569628,666,It lulls them into a false sense of security.
3316,656,22,49,187,258,1.3604651162790697,0.0395043538891848,666,"I know you're not supposed to play with your food, but I can't help myself."
1618,656,14,65,179,258,1.3604651162790697,0.036322011420756174,666,Don't knock it. This lure works much better than a bare fin.
6271,656,15,63,180,258,1.3604651162790697,0.03673488391799534,666,I carry him with me in case my blood sugar drops and I have to eat something quick.
5869,656,18,57,183,258,1.3604651162790697,0.03794655774804542,666,I'm taking home the leftovers.
1361,656,14,65,179,258,1.3604651162790697,0.036322011420756174,666,They taste terrible but you should see the look on their faces when they find out I’m not a rock
6081,669,17,60,184,261,1.3601532567049808,0.03724715206580815,666,Want to help me ruin the summer tourist season?
3495,670,20,69,214,303,1.3597359735973598,0.034638110362168434,666,Do you think he could balance on ONE leg?
2204,671,18,65,198,281,1.3594306049822065,0.03577479780255778,666,I switched to using live bait
3243,671,18,65,198,281,1.3594306049822065,0.03577479780255778,666,Surf for him--turf for me.
0,673,15,62,179,256,1.359375,0.036910708865064736,666,"I bought it on sale, it was Half Off."
2648,673,10,26,92,128,1.359375,0.05516436495087269,666,"In about one minute, he won't have a leg to stand on."
3585,673,20,52,184,256,1.359375,0.03893053690140136,666,He says we can’t close until your lawyer is here too.
3909,673,19,54,183,256,1.359375,0.038535041825972005,666,"You gotta stop letting people walk all over you, Jeff"
357,673,19,54,183,256,1.359375,0.038535041825972005,666,"I just ate his wife, it's the least I could do."
930,678,19,55,185,259,1.359073359073359,0.03821896463957706,666,The recipe calls for fifteen minutes of brining.
3106,679,22,51,192,265,1.3584905660377358,0.03873046017361999,666,They taste better after you betray them.
4477,680,17,47,162,226,1.3584070796460177,0.04111738874013913,666,This guy figures he's a shoo-in for the 2019 Darwin Award.
4090,681,24,62,221,307,1.3583061889250814,0.0355293607495905,666,"I wanted to go somewhere nice, you're the one who said let's just get takeout!"""
1498,682,13,65,176,254,1.358267716535433,0.03623998646202975,666,I think they call him a sociopath--he acts like he is drowning and I get the rescuers.
2443,682,14,63,177,254,1.358267716535433,0.03666686802356525,666,I'm on the low ph diet. So I'll wait until he's finished peeing before I eat him.
3293,682,12,67,175,254,1.358267716535433,0.035808016237689665,666,My chiropractor said it’s good for my aching cartilage.
3737,682,21,49,184,254,1.358267716535433,0.03952616037365279,666,Of all the days to go vegan.
4336,682,20,51,183,254,1.358267716535433,0.03913048379453374,666,"We're both warm blooded, but he's a lot dumber."
1903,682,25,41,188,254,1.358267716535433,0.04107076480224748,666,Wanna join me for lunch?
1078,682,21,49,184,254,1.358267716535433,0.03952616037365279,666,It's a new game called 'Survival of the Idiot.'
2748,682,16,59,179,254,1.358267716535433,0.03750605810314458,666,Here is your carry out
37,682,17,57,180,254,1.358267716535433,0.03791868914303222,666,Let him take a few selfies first.
1018,682,21,49,184,254,1.358267716535433,0.03952616037365279,666,Did the water just get really warm?
6024,692,20,50,182,252,1.3571428571428572,0.03933318679595271,666,Please tell me those are feet.
5941,692,13,64,175,252,1.3571428571428572,0.03641102455029218,666,I think my vegan diet days are just about over.
3900,692,19,52,181,252,1.3571428571428572,0.03892916682891383,666,"I can’t, it’s too easy."
3650,692,17,56,179,252,1.3571428571428572,0.0381082789289886,666,I haven't yet had the appetite to tell him he lost his surfboard a few meters back.
3359,692,19,52,181,252,1.3571428571428572,0.03892916682891383,666,Suzanne ate the top half.
2413,692,19,52,181,252,1.3571428571428572,0.03892916682891383,666,"Normally I'd eat him, but this just feels sooo good."
2004,692,16,58,178,252,1.3571428571428572,0.037691131176945225,666,I just like the top part.
1778,692,15,60,177,252,1.3571428571428572,0.03726931466858209,666,"Remember, it’ll take lots of responsibility to take him on walks every day."
871,692,13,64,175,252,1.3571428571428572,0.03641102455029218,666,"What, do I have food all over my face?"
551,692,21,48,183,252,1.3571428571428572,0.03973309875981501,666,"The invitation said ""bring a dish to pass."""
372,692,15,60,177,252,1.3571428571428572,0.03726931466858209,666,He has my back so don’t bite him
1958,703,22,57,204,283,1.3568904593639577,0.036949106803140216,666,"Fine then, you tell me how to accessorize."
1377,704,13,65,177,255,1.3568627450980393,0.036124920541713366,666,Ready?
2175,705,18,53,179,250,1.356,0.03871759559729066,666,And he's eating a tuna fish sandwich
3999,705,16,57,177,250,1.356,0.03787869032481048,666,"I know! But his feet are really warm and, when he falls off, well, lunch!"
4719,705,19,51,180,250,1.356,0.039130304405812714,666,It's a great decoy. . .works like charm every time!
5112,705,14,61,175,250,1.356,0.03702078001083231,666,"We do have a standing date for lunch, don't we?"
6140,705,15,59,176,250,1.356,0.037452191747168365,666,Help yourself. I'm vegan.
6239,705,16,57,177,250,1.356,0.03787869032481048,666,tourist...am I right?
2064,705,18,53,179,250,1.356,0.03871759559729066,666,"Mr, Magoo here thinks I am a surf board."
2174,705,10,69,171,250,1.356,0.035242362241846695,666,I didn’t invite him. I thought you did.
1773,705,16,57,177,250,1.356,0.03787869032481048,666,"No, no. On Fridays we can eat meat..."
1927,705,15,59,176,250,1.356,0.037452191747168365,666,I’m sorry I am late but I picked up dinner on the way home.
5637,715,16,58,179,253,1.3557312252964426,0.03756838917778839,666,For my birthday I wished to grow another 2 feet.
6249,716,17,54,177,248,1.3548387096774193,0.03849522679204499,666,"It’s a condition of my parole, to prove that I can resist temptation."
6134,716,19,50,179,248,1.3548387096774193,0.03933423714160643,666,"Like the American electorate, he does not know he’s standing on a shark"
5378,716,17,54,177,248,1.3548387096774193,0.03849522679204499,666,Don't you try to shame me into sharing just because you forgot to pack a lunch.
2564,716,15,58,175,248,1.3548387096774193,0.03763751798445039,666,I’m trying something different.  I’m letting my food play with me.
1490,716,21,46,181,248,1.3548387096774193,0.0401557211023944,666,There are times I just wish I could forget I'm a vegan!
432,721,18,62,197,277,1.3537906137184115,0.03604479470953664,666,It's a balanced breakfast.
282,722,19,49,178,246,1.353658536585366,0.03954102601050859,666,Gross. Callouses.
1232,722,15,57,174,246,1.353658536585366,0.0378253448989689,666,I'm saving the bottom half for later.
1136,722,13,61,172,246,1.353658536585366,0.03693763265434144,666,"He's taking a selfie right now, isn't he?"
989,722,21,45,180,246,1.353658536585366,0.040371533889395364,666,It's white male privilege
942,722,18,51,177,246,1.353658536585366,0.039119160684430276,666,I ate the other half.
471,722,15,57,174,246,1.353658536585366,0.0378253448989689,666,Sometimes I like to play with my food before I eat.
1230,722,16,55,175,246,1.353658536585366,0.03826147830436501,666,He's just finishing up his goodbyes.
247,722,21,45,180,246,1.353658536585366,0.040371533889395364,666,Money got a little tight so I signed up to be an Uber shark.
4139,722,18,51,177,246,1.353658536585366,0.039119160684430276,666,It’s a SHARK TANK audition.
2887,722,18,51,177,246,1.353658536585366,0.039119160684430276,666,"He's here to get a loan,"
3442,722,15,57,174,246,1.353658536585366,0.0378253448989689,666,But you said to bring lunch
6257,722,18,51,177,246,1.353658536585366,0.039119160684430276,666,Do I look like a surfboard? I don't feel like a surfboard.
5965,722,17,53,176,246,1.353658536585366,0.03869269604647413,666,I was saving him for later.
1992,722,23,41,182,246,1.353658536585366,0.04118529785252839,666,Get your own hood ornament!
5118,722,15,57,174,246,1.353658536585366,0.0378253448989689,666,Of course I bring my own lunch.
4851,722,15,57,174,246,1.353658536585366,0.0378253448989689,666,"Quick question. Can I get sick from eating someone who's ""going viral""?"
2853,722,17,53,176,246,1.353658536585366,0.03869269604647413,666,"Sometimes, it’s just too damn easy."
2807,722,19,49,178,246,1.353658536585366,0.03954102601050859,666,Its an exercise in delaying gratification
5577,740,15,52,165,232,1.353448275862069,0.03935810378112527,666,Half a billion years old and the planet’s most vicious predator - where’s the respect?
3766,741,16,46,159,221,1.3529411764705883,0.04118528435964406,666,AH! What is it? Where is it? Get it off!
478,742,19,48,177,244,1.3524590163934427,0.03975073377558323,666,I need to work on my fear of confrontation.
2281,742,21,44,179,244,1.3524590163934427,0.040590436836041965,666,It's just professional courtesy.  He's a lawyer.
3853,742,17,52,175,244,1.3524590163934427,0.038892905636553746,666,Hang on a minute. He’s almost worked out that knot.”
4993,742,17,52,175,244,1.3524590163934427,0.038892905636553746,666,"I'm sick of you looking at me like I'm a piece of meat, Kyle."""
5400,742,21,44,179,244,1.3524590163934427,0.040590436836041965,666,April Fools!  I ate the top half!
5954,742,10,66,168,244,1.3524590163934427,0.03572867986508749,666,They call it shark-surfing. Want to help teach him a lesson?
3521,742,18,50,176,244,1.3524590163934427,0.03932415888834221,666,I work for Uber now...
4269,742,15,56,173,244,1.3524590163934427,0.03801572545684819,666,Human Week is the worst.
5976,750,19,47,176,242,1.3512396694214877,0.039963425054070224,666,"Bro, You can't eat him. It's Steven Spielberg!"
5195,750,16,53,173,242,1.3512396694214877,0.038654860129592745,666,Back off. He’s my chum.
5172,750,12,61,169,242,1.3512396694214877,0.036837870519613826,666,I ate his surfboard and felt bad about it.
4542,750,19,47,176,242,1.3512396694214877,0.039963425054070224,666,He claims to be a pilot fish.
4427,750,16,53,173,242,1.3512396694214877,0.038654860129592745,666,You have no idea what this anger management class has done for me!
4150,750,11,63,168,242,1.3512396694214877,0.036369442223042094,666,I know what you’re thinking but it kinda feels good.
3423,750,15,55,172,242,1.3512396694214877,0.03820871412169929,666,"Well, I would eat him, but he's scratching that itch even my remoras can't get to."
540,750,13,59,170,242,1.3512396694214877,0.03730041663607084,666,This kind of thing only happens now that I'm vegetarian.
730,750,20,45,177,242,1.3512396694214877,0.04039019335008096,666,I ate the top half. I'm full. You want the rest?
864,750,17,51,174,242,1.3512396694214877,0.039095915239868925,666,"Professional courtesy, he's my lawyer."
909,750,18,49,175,242,1.3512396694214877,0.03953204984879549,666,I'll give you an arm and a leg if you can knock him off my back.
3273,750,16,53,173,242,1.3512396694214877,0.038654860129592745,666,I'm saving the leftovers for tomorrow.
2983,750,16,53,173,242,1.3512396694214877,0.038654860129592745,666,I packed my snack for the trip.
1256,750,18,49,175,242,1.3512396694214877,0.03953204984879549,666,"WAY too skinny for me. 
You want him?"
2271,750,22,41,179,242,1.3512396694214877,0.04123047989614233,666,I'm gonna charge an arm and a leg for this.
1335,765,15,56,174,245,1.3510204081632653,0.03788756342558671,666,I wouldn’t mind so much if he cut his toe nails.
2571,766,20,47,181,248,1.3508064516129032,0.039686606705828686,666,"Well, the sharks in Japan say it helps with their back pain."
4996,767,19,46,175,240,1.35,0.040179166385535446,666,"When you have kids, you'll know it's always important to carry some snacks with you."
6277,767,18,48,174,240,1.35,0.03974289757868431,666,What? Do I have something stuck in my teeth?
5310,767,14,56,170,240,1.35,0.03794769945599851,666,"Look,I saved HALF for you!"
3417,767,16,52,172,240,1.35,0.038855667552833144,666,Those idiot resort dolphins talked me into this.
2889,767,13,58,169,240,1.35,0.037485469058236943,666,The tourists are here!
1414,767,17,50,173,240,1.35,0.0393017862757285,666,"Augh, I caught it in NY. Long Island Sound is totally infested this time of year."
624,767,19,46,175,240,1.35,0.040179166385535446,666,You go ahead.  I'd prefer some finger food.
4594,774,15,55,173,243,1.3497942386831276,0.03807859528619371,666,The dermatologist said it was benign.
3805,775,14,53,165,232,1.3491379310344827,0.0388096861275043,666,So anger management is going well.
6110,776,17,48,170,235,1.348936170212766,0.03986411590297503,666,Can you see if he's wearing a Yankees hat?
2705,777,12,66,180,258,1.3488372093023255,0.035296028067809515,666,It's an Androcles and the lion relationship. He pulled a plastic straw out of my gills.
3191,778,16,51,171,238,1.3487394957983194,0.039059299361196786,666,I invited him to dinner. I don't think he quite understood the repercussions.
3998,778,15,53,170,238,1.3487394957983194,0.03860274142757946,666,My lawyer got the charge reduced to an “investigatory bite” provided I go through a tourist tolerance course
2875,778,20,43,175,238,1.3487394957983194,0.04083451665000705,666,I'm his Emotional Support Animal....but you're not.
4805,778,20,43,175,238,1.3487394957983194,0.04083451665000705,666,I brought carry-out.
5451,778,12,59,167,238,1.3487394957983194,0.037199462135029226,666,I was an extra in Sharknado 6.  True story.
1441,778,15,53,170,238,1.3487394957983194,0.03860274142757946,666,"The skinny ones aren't as tender, but they usually have fewer preservatives."
5795,778,15,53,170,238,1.3487394957983194,0.03860274142757946,666,“These millennials are so entitled.”
3335,778,18,47,173,238,1.3487394957983194,0.039956767991338404,666,They are dumber than I thought
3184,778,19,45,174,238,1.3487394957983194,0.04039802630298508,666,"I swear, if they give dolphins credit for this, I'm eating the next one."
5289,787,15,54,172,241,1.3485477178423237,0.038272244840422624,666,Less scary when it's not a fin sticking out of the water
1352,788,16,50,170,236,1.347457627118644,0.03926581778111893,666,I brought dinner home.
3826,788,14,54,168,236,1.347457627118644,0.03833641079506839,666,Sometimes they're just asking for it.
1764,788,19,44,173,236,1.347457627118644,0.0406200754070907,666,"Working for Uber is so so, but the tips are pretty tasty."
2608,788,18,46,172,236,1.347457627118644,0.04017372897045823,666,Is he wild or farm raised?
2945,788,16,50,170,236,1.347457627118644,0.03926581778111893,666,Give a shark a man and it eats for today. Teach a shark to lure other men and ... well you get the idea.
1053,788,19,44,173,236,1.347457627118644,0.0406200754070907,666,"I just ate the top half, it scares the daylights outta them!"
6228,788,16,50,170,236,1.347457627118644,0.03926581778111893,666,"He’s waving frantically, right?  Good.  His friends will arrive soon and then we’ll REALLY have a feast."
5511,788,17,48,171,236,1.347457627118644,0.03972236741064076,666,I got it through Amazon.  You blow it up and they can't see your fin.
5191,788,11,60,165,236,1.347457627118644,0.03689843238662771,666,I like to fool people into thinking this is the shallow end of the pool.
5182,788,17,48,171,236,1.347457627118644,0.03972236741064076,666,"Yeah, so I’ve been Uber-ing on the weekends."
4986,788,16,50,170,236,1.347457627118644,0.03926581778111893,666,"Tell me honestly, do you think I have started to lose my killer instinct?"
4564,788,18,46,172,236,1.347457627118644,0.04017372897045823,666,Watch this. If a dog can do it with a treat on his nose...
3852,788,14,54,168,236,1.347457627118644,0.03833641079506839,666,"No, I'm actually a hammer toe"
3033,788,18,46,172,236,1.347457627118644,0.04017372897045823,666,Best.decoy.ever.
445,788,14,54,168,236,1.347457627118644,0.03833641079506839,666,I got mine to go.
125,788,12,58,166,236,1.347457627118644,0.03738390481579521,666,He thinks I’m a dolphin.
132,788,16,50,170,236,1.347457627118644,0.03926581778111893,666,"Yeah, I know, but I’m hoping he has a beer gut."
64,788,17,48,171,236,1.347457627118644,0.03972236741064076,666,"I always wanted a periscope,"
351,788,15,52,169,236,1.347457627118644,0.03880389696066795,666,He's a lawyer.
3983,807,18,47,174,239,1.3472803347280335,0.03981598001172436,666,They say if I stop swimming he’ll die.
920,808,17,50,175,242,1.3471074380165289,0.03902971164529715,666,"Right now, I'm playing with my food"
2379,809,13,42,141,196,1.346938775510204,0.04292063772211089,666,I told you vacationing at Sea World would be a mistake.
4947,810,14,42,146,202,1.3465346534653466,0.04261725112590026,666,I’m waiting for my musical cue.
1343,811,15,49,164,228,1.3464912280701755,0.03971340081136952,666,"Well, I guess I'm just more of a people pleaser than you."
4697,812,18,52,184,254,1.3464566929133859,0.038146624564512906,666,He’s started talking about his divorce and I just don’t have in me.
929,812,17,54,183,254,1.3464566929133859,0.037736485975464744,666,It stands for Make America Great White Again.
2432,814,11,59,164,234,1.3461538461538463,0.03707945620968811,666,You go ahead...they get stuck in my teeth.
2767,814,14,53,167,234,1.3461538461538463,0.03853483350364872,666,"When the rides over, he'll know it."
3174,814,15,51,168,234,1.3461538461538463,0.039007894499316985,666,Trust me; this is the most humane way.
3180,814,9,63,162,234,1.3461538461538463,0.03607660173262367,666,He scratches the spot I can't reach.
3979,814,12,57,165,234,1.3461538461538463,0.03757084658245133,666,I've been waiting on you.  Which leg do you want.
4282,814,17,47,170,234,1.3461538461538463,0.03993720963589817,666,"Da dumb, da dumb, da dumb"
4500,814,17,47,170,234,1.3461538461538463,0.03993720963589817,666,"Of course it's degrading.  But Sea World auditions, here I come."
4544,814,15,51,168,234,1.3461538461538463,0.039007894499316985,666,Don't ask. He's an admissions officer at USC.
4861,814,16,49,169,234,1.3461538461538463,0.03947528686894829,666,Now you jump the human.
5319,814,16,49,169,234,1.3461538461538463,0.03947528686894829,666,I got the patch. I'm trying to quit.
5611,814,13,46,149,208,1.3461538461538463,0.04119772993058664,666,"Say what you will, but I believe finding a friend trumps finding a meal."
2811,814,13,55,166,234,1.3461538461538463,0.038055892487734555,666,Which leg do you want?
2346,814,12,57,165,234,1.3461538461538463,0.03757084658245133,666,"I'm telling you, it's Spielberg.  He's casting Son of Jaws and wants to see what I can do."
2394,814,20,41,173,234,1.3461538461538463,0.04129198510424786,666,Why do I always end up carrying all the groceries in?
1315,814,16,49,169,234,1.3461538461538463,0.03947528686894829,666,He’s working on a hamburger up there. I’m trying to fatten him up.
1320,814,12,57,165,234,1.3461538461538463,0.03757084658245133,666,All I could find for lunch was this take-out
202,830,14,54,169,237,1.3459915611814346,0.038202452484072225,666,He thinks I'm a lone shark.
4725,831,13,38,134,185,1.345945945945946,0.04464886488710323,666,"If you don’t attack first, they think they can just walk all over you."
1150,832,14,52,166,232,1.3448275862068966,0.0387360463451082,666,"With this stunt, I think we've finally jumped the shark!"
1684,832,16,48,168,232,1.3448275862068966,0.039687772576989744,666,I'm a victim of  compassion
1705,832,14,52,166,232,1.3448275862068966,0.0387360463451082,666,"Well, you know the old expression,
""Ignorance is bliss- until it's not."""
1856,832,15,50,167,232,1.3448275862068966,0.039214796815572245,666,Has he never seen Jaws?
1938,832,13,54,165,232,1.3448275862068966,0.038251304338729766,666,Don't eat him till he finishes rubbing my back.
1146,832,17,46,169,232,1.3448275862068966,0.040155177685562586,666,I don't know why. Some guy named Jesus asked me to do this.
2215,832,13,54,165,232,1.3448275862068966,0.038251304338729766,666,Everyone has baggage.
3306,832,19,42,171,232,1.3448275862068966,0.0410740343846522,666,Today's special is the Surf and Turf
3556,832,13,54,165,232,1.3448275862068966,0.038251304338729766,666,Looks like you get the bottom half.
3948,832,16,48,168,232,1.3448275862068966,0.039687772576989744,666,He’s on his mobile. Doesn’t realize the sand bar is now moving
2764,832,22,36,174,232,1.3448275862068966,0.04241501278015043,666,He's my old chum.
4588,832,16,48,168,232,1.3448275862068966,0.039687772576989744,666,The secret is to brine the legs.
5419,832,19,42,171,232,1.3448275862068966,0.0410740343846522,666,The ‘swim-with-the-sharks’ folks have  really become entitled.
3001,832,20,40,172,232,1.3448275862068966,0.04152583898571871,666,"No, bull sharks are the aggressive ones, I’m more passive aggressive."
5870,832,17,46,169,232,1.3448275862068966,0.040155177685562586,666,"It's crazy, but he looks out for me."
5935,832,11,58,163,232,1.3448275862068966,0.037262907534727316,666,"“Some body’s a little more than knee deep 
                  in troubled waters.”"
6133,832,13,54,165,232,1.3448275862068966,0.038251304338729766,666,I hate it when they take all the challenge out of it.
6218,832,15,50,167,232,1.3448275862068966,0.039214796815572245,666,"You were late, so it’s Take Out."
3078,832,17,46,169,232,1.3448275862068966,0.040155177685562586,666,Dinner will be ready in fifteen …
3611,832,11,58,163,232,1.3448275862068966,0.037262907534727316,666,"You ordered a medium,with no anchovies,right?"
889,832,11,58,163,232,1.3448275862068966,0.037262907534727316,666,He's so asking for it.
552,832,16,48,168,232,1.3448275862068966,0.039687772576989744,666,"The massage is very relaxing, but I'm looking forward to the happy ending."
649,832,11,58,163,232,1.3448275862068966,0.037262907534727316,666,"I told you Felix, you have to eat at least one or they’ll walk all over you."
743,832,14,52,166,232,1.3448275862068966,0.0387360463451082,666,"Yeah, but my back has never felt better."""
392,832,16,48,168,232,1.3448275862068966,0.039687772576989744,666,"It was my turn to bring lunch, wasn't it?"
134,832,17,46,169,232,1.3448275862068966,0.040155177685562586,666,This is so embarrassing. Tell the dolphins we want to switch back.
2596,858,16,51,174,241,1.3443983402489628,0.038652738500992954,666,It’s Spielberg. Again.
3458,859,15,47,162,224,1.34375,0.04015187026501191,666,"I've been swimming for Swyft a few months now, and posting reviews of my clients on Gulp."
1262,860,14,50,163,227,1.3436123348017621,0.039290776451186615,666,Why do I always have to carry the decoy?
4043,861,13,53,164,230,1.3434782608695652,0.03844944638987108,666,I need to learn to use the word “no” more often.
3976,861,15,49,166,230,1.3434782608695652,0.039424668523126816,666,"Ew! Get it off me, get it off me!"
3899,861,21,37,172,230,1.3434782608695652,0.042215378353995546,666,I had a hat like that last week.
3798,861,20,39,171,230,1.3434782608695652,0.04176321215298899,666,Don’t worry about fixing dinner. I brought home takeout.
2469,861,14,51,165,230,1.3434782608695652,0.03894011052787342,666,Do you prefer the breast or the thigh?
2414,861,19,41,170,230,1.3434782608695652,0.04130609651250211,666,"I don't like their taste, but I love the naïveté."
2389,861,13,53,164,230,1.3434782608695652,0.03844944638987108,666,But he's nothing but skin and bones!
2326,861,13,53,164,230,1.3434782608695652,0.03844944638987108,666,He's lucky I already ate a quarter flounder for lunch
5064,861,14,51,165,230,1.3434782608695652,0.03894011052787342,666,"You bring the salad, I’ve got the main course"
5106,861,18,43,169,230,1.3434782608695652,0.04084386525372826,666,You’re my witness. This one was provoked.
2203,861,13,53,164,230,1.3434782608695652,0.03844944638987108,666,Want to hear about my new balanced diet?
419,861,14,51,165,230,1.3434782608695652,0.03894011052787342,666,And me without my Grey Poupon.
4836,861,14,51,165,230,1.3434782608695652,0.03894011052787342,666,Our deal: Skinny lawyer calls for help and we eat tender lifeguard.
3118,861,15,49,166,230,1.3434782608695652,0.039424668523126816,666,Market price is $8.99/lb.
6071,861,19,41,170,230,1.3434782608695652,0.04130609651250211,666,He thinks I'm his attorney.
5466,861,17,45,168,230,1.3434782608695652,0.04037634268515764,666,I think he’s confused me with a dolphin.
912,877,13,60,178,251,1.342629482071713,0.036266799001704056,666,The key is to give them a false sense of security.
5230,878,16,58,189,263,1.3422053231939164,0.03638082309697694,666,He says his name's Jonah
4624,878,15,60,188,263,1.3422053231939164,0.03597970595483757,666,Today's beach buffet is standing room only.
5128,880,15,48,165,228,1.3421052631578947,0.039637576143015094,666,"After the backrub, I'll have my lunch."
5115,880,16,46,166,228,1.3421052631578947,0.0401220675583473,666,You wanna hear the punchline or are you going to keep interrupting me?
4978,880,15,48,165,228,1.3421052631578947,0.039637576143015094,666,My wife insisted I bring my own lunch to work...
4820,880,19,40,169,228,1.3421052631578947,0.041541652508613365,666,"Sometimes they tip, sometimes I eat them."
4817,880,12,54,162,228,1.3421052631578947,0.03814719982519714,666,I got carryout.
4614,880,13,52,163,228,1.3421052631578947,0.03865037796926166,666,"Tee-hee, he thinks he's still on his surfboard..."
3679,880,13,52,163,228,1.3421052631578947,0.03865037796926166,666,"C'mon, when do we let him know we're not dolphins ?"
3314,880,12,54,162,228,1.3421052631578947,0.03814719982519714,666,I'm packing my lunch today.
3198,880,10,58,160,228,1.3421052631578947,0.03712038697504363,666,Let's flip him for it.
2817,880,13,52,163,228,1.3421052631578947,0.03865037796926166,666,"Sure, it’s humiliating, but it feels great!"
2730,880,14,50,164,228,1.3421052631578947,0.039147089033925025,666,Just picking up a little takeout for the family.
2412,880,16,46,166,228,1.3421052631578947,0.0401220675583473,666,You said we weren't exchanging gifts this year!
764,880,17,44,167,228,1.3421052631578947,0.04060077792136317,666,I like to play with my food first.
1600,880,7,64,157,228,1.3421052631578947,0.0355245625052187,666,His balance is unnerving.
2259,880,10,58,160,228,1.3421052631578947,0.03712038697504363,666,"Excuse me, did you order the caucasian male?"
3369,880,11,56,161,228,1.3421052631578947,0.03763729522481995,666,He thought I was just a helpful dolphin and now I’m afraid to tell him the truth
1648,880,9,60,159,228,1.3421052631578947,0.03659617830475913,666,I always use the skinny ones as bait.
2538,880,16,46,166,228,1.3421052631578947,0.0401220675583473,666,I'll eat him after my massage.
6251,898,18,44,172,234,1.3418803418803418,0.04032296268889191,666,"Strong under-toe this time of year, huh?"
3420,898,15,50,169,234,1.3418803418803418,0.03893448342616118,666,Apparently we're serial predators and need to create a less-hostile beach environment.
86,900,11,60,169,240,1.3416666666666666,0.03639607904661513,666,Hors d'oeuvre?
2732,900,14,54,172,240,1.3416666666666666,0.03780578104506913,666,K. F. Sea had a special on their Thighs and Legs.
1546,902,17,36,152,205,1.3414634146341464,0.04376406270555432,666,Do you smell something?
883,903,15,46,162,223,1.3408071748878925,0.040223855165702246,666,"Now watch carefully, Andy, next comes the fun part."
210,903,17,42,164,223,1.3408071748878925,0.041215977623583124,666,He thinks he's standing in shallow water.
2063,903,16,44,163,223,1.3408071748878925,0.04072293785975599,666,Uber Eats at your service!
2139,903,16,44,163,223,1.3408071748878925,0.04072293785975599,666,It started out as a wart on my dorsal.
2318,903,17,42,164,223,1.3408071748878925,0.041215977623583124,666,In the mood for a slider?
4504,903,16,44,163,223,1.3408071748878925,0.04072293785975599,666,I'd feel guitly eating someone so stupid.
5205,903,11,54,158,223,1.3408071748878925,0.038162310598793193,666,It's the pizza guy with dinner.  I had a swimmer for lunch.
5506,903,11,54,158,223,1.3408071748878925,0.038162310598793193,666,I've got humans. You should get yourself checked.
5784,903,11,54,158,223,1.3408071748878925,0.038162310598793193,666,Do you prefer the leg or thigh?
6021,903,13,50,160,223,1.3408071748878925,0.039206635118498465,666,She asked me to grab some carryout tonight.
1211,903,16,44,163,223,1.3408071748878925,0.04072293785975599,666,Summer people.
1737,903,19,38,166,223,1.3408071748878925,0.04218477330203422,666,"I couldn't finish the bottom half, so I'm taking it home for later."
3449,915,17,43,166,226,1.3407079646017699,0.040828558922771215,666,It is a fake! I use it to lure swimmers out where I can eat them.
3552,915,16,45,165,226,1.3407079646017699,0.040344018849703185,666,I'm his emotional support shark. Really.
2338,915,14,49,163,226,1.3407079646017699,0.03935704668055284,666,"He isn't organic, but he is free range."
2315,915,11,55,160,226,1.3407079646017699,0.03782833624573292,666,What was that movie that Grandpa starred in called again?
5455,915,15,47,164,226,1.3407079646017699,0.03985358817196026,666,"Took  you long enough, did you grab the fork and napkins?"
5550,915,14,49,163,226,1.3407079646017699,0.03935704668055284,666,Wanna come over to my place?  I have takeout
5930,915,12,53,161,226,1.3407079646017699,0.038344678768836044,666,I'm sorry I ever got friendly with a lifeguard.  I can't get him off my back.
977,915,15,47,164,226,1.3407079646017699,0.03985358817196026,666,They are completely unaware while posing for selfies.
1891,915,14,49,163,226,1.3407079646017699,0.03935704668055284,666,I didn’t have the heart to tell him he can’t walk on water.
236,924,12,55,165,232,1.3405172413793103,0.037682515469936555,666,My therapist says I'm a little too empathetic.
511,925,15,45,161,221,1.339366515837104,0.04044881670932078,666,Sometimes I pity their naiveté.
840,925,17,41,163,221,1.339366515837104,0.04145331643777363,666,I type feet porn in to google ONE TIME and now I get this everyday.
2278,925,11,53,157,221,1.339366515837104,0.03836098841495483,666,I would kill him if I didn’t respect him.
2897,925,14,47,160,221,1.339366515837104,0.03993709350880765,666,Where the hell have you been? My shift's been over for 5 minutes.
3546,925,15,45,161,221,1.339366515837104,0.04044881670932078,666,Some days being a vegan is harder than others.
4384,925,15,45,161,221,1.339366515837104,0.04044881670932078,666,I said I’d split it with you...
3652,931,13,50,161,224,1.3392857142857142,0.03906085552958395,666,It's part of a new program to change our image.
495,932,14,50,166,230,1.3391304347826087,0.03886265781114961,666,"Sure, I could eat him, but as an Uber driver I can't really afford the lower rating."""
926,933,16,50,176,242,1.3388429752066116,0.038448101481676766,666,"It's called Ashiatsu, and it's heaven... so don't even think about it."
6031,934,11,52,156,219,1.3378995433789955,0.03856247540066294,666,They said 'Don't go near shore' . Did I listen - Nooo…
4954,934,10,54,155,219,1.3378995433789955,0.03801542678631177,666,I can't seem to shake the feeling that I've been taken for a ride.
1882,934,11,52,156,219,1.3378995433789955,0.03856247540066294,666,Think of it as bait.
5236,934,14,46,159,219,1.3378995433789955,0.040158934433954366,666,We're here for the Bar Association annual meeting.  How about you?
6293,938,14,45,158,217,1.336405529953917,0.040384099561381816,666,I just can't bring myself to eat him. I like the thrill of the hunt.
433,938,13,47,157,217,1.336405529953917,0.03985230357050257,666,I've got a foot fetish.
2537,938,15,43,159,217,1.336405529953917,0.04090898305863525,666,It's supposed to be a decoy that attracts other swimmers.
3841,938,17,39,161,217,1.336405529953917,0.04193904731760034,666,I hope you don't mind fast food tonight.
1390,938,13,47,157,217,1.336405529953917,0.03985230357050257,666,"Yeah, a stand up comic, but I'll  get  the  last  laugh."
4032,938,9,55,153,217,1.336405529953917,0.03765007981190827,666,You want the leg or the breast?
5001,938,15,43,159,217,1.336405529953917,0.04090898305863525,666,"I know, Mom, ""quit playing with my food."""
4995,938,14,45,158,217,1.336405529953917,0.040384099561381816,666,Just when he thought it was safe to go back in the water.
4857,938,14,45,158,217,1.336405529953917,0.040384099561381816,666,"What hood ornament?"""
922,938,17,39,161,217,1.336405529953917,0.04193904731760034,666,You forgot to pack a lunch?
1215,938,14,45,158,217,1.336405529953917,0.040384099561381816,666,Another lawyer catching a free ride.
5989,938,18,37,162,217,1.336405529953917,0.04244470623547803,666,Take a good look. He's about to undergo an Extreme Mako-ver.
3372,950,19,37,167,223,1.336322869955157,0.04210740153123612,666,See! Humans ARE dumb enough to use UberShark.
4433,950,13,49,161,223,1.336322869955157,0.03912337411936507,666,I promised him a ride before lunch.
4733,952,16,44,166,226,1.336283185840708,0.04026521659174408,666,I'm full. I'm taking this half home for the wife.
5858,953,13,52,167,232,1.3362068965517242,0.0380953909098139,666,Of course I'm not happy with this relationship. I always have the feeling he's looking out for something better.
4388,954,13,46,156,215,1.3348837209302327,0.04007392974907857,666,"Well I'm hungry, too, but this really gets the kinks out of my back."
5224,954,20,32,163,215,1.3348837209302327,0.043705852278959095,666,He must be a Republican
4937,954,14,44,157,215,1.3348837209302327,0.0406126662097196,666,"Free fish or not, if this crowd sings BABY SHARK one more time..."
3943,954,15,42,158,215,1.3348837209302327,0.041144349159879974,666,Just saving this for dessert.
3315,954,13,46,156,215,1.3348837209302327,0.04007392974907857,666,He thinks he's wading. I hate to disappoint him.
3223,954,14,44,157,215,1.3348837209302327,0.0406126662097196,666,I told you I'd find my sea legs!
2972,954,15,42,158,215,1.3348837209302327,0.041144349159879974,666,I think I’ve been attacked by a hammertoe.
2613,954,13,46,156,215,1.3348837209302327,0.04007392974907857,666,"Yeah, I'm going to eat him, but right now this feels AMAZING on my sciatica."
1988,954,14,44,157,215,1.3348837209302327,0.0406126662097196,666,"Yeah, the ashiatsu massage helps temporarily but I think taking human cartilage supplements is what has truly healed my arthritis."
1952,954,12,48,155,215,1.3348837209302327,0.03952785137603698,666,I'm saving this half for dinner.
1260,954,7,58,150,215,1.3348837209302327,0.03667570011282662,666,Allow me to cull this one from the herd.
1194,954,14,44,157,215,1.3348837209302327,0.0406126662097196,666,I always like to bring my own lunch to school.
5837,954,13,46,156,215,1.3348837209302327,0.04007392974907857,666,I wasn't in the mood to cook tonight ... so I just ordered in.
1068,954,14,44,157,215,1.3348837209302327,0.0406126662097196,666,I stopped eating meat but I can't seem to get it off my mind.
688,954,10,52,153,215,1.3348837209302327,0.03841241221467402,666,How many times have I told you to not play with your dinner?
148,954,11,50,154,215,1.3348837209302327,0.038974122482463326,666,It's a new ride-share offering by Uber.
1040,954,16,40,159,215,1.3348837209302327,0.041669248600354335,666,You want him? I'm still digesting his wife.
2594,971,15,41,157,213,1.3333333333333333,0.041383348935037194,666,It's not my fault you ate your chiropractor.
2828,971,13,45,155,213,1.3333333333333333,0.040298880428392206,666,Watch this!  I saw a dog do it.  They put a biscuit on his nose and...
2928,971,15,41,157,213,1.3333333333333333,0.041383348935037194,666,"She's a lawyer, so it's a professional courtesy on my part."
4002,971,12,36,132,180,1.3333333333333333,0.04456841803099171,666,"Once you get past the temptation, it's actually really good for your core."
4146,971,13,45,155,213,1.3333333333333333,0.040298880428392206,666,In a minute he's going to discover there's another definition of  'chum'.
5114,971,10,51,152,213,1.3333333333333333,0.03861511434446445,666,Don't tell me I never bring you gifts.
5133,971,22,27,164,213,1.3333333333333333,0.04497352429618137,666,"It's the new rideshare, 'Unter'."
1957,971,15,41,157,213,1.3333333333333333,0.041383348935037194,666,"He calls it ""shark surfing,"" I call it ""toppings."""
5492,971,15,41,157,213,1.3333333333333333,0.041383348935037194,666,I've tried everything.  I have an appointment with my dermatologest next week to have it removed
6163,971,12,47,154,213,1.3333333333333333,0.03974555146344375,666,"He said his big brother was, like, twice as fat.  So, we are going over to where he’s swimming."
1596,971,13,45,155,213,1.3333333333333333,0.040298880428392206,666,"Suddenly, he's not half the man he used to be, oh yesterday came suddenly."
1645,971,12,47,154,213,1.3333333333333333,0.03974555146344375,666,He’s holding me down. I’m very bloated.
224,971,10,51,152,213,1.3333333333333333,0.03861511434446445,666,Was the top half tasty?
1023,971,15,41,157,213,1.3333333333333333,0.041383348935037194,666,It's like Uber Eats only quicker.
5609,971,12,54,168,234,1.3333333333333333,0.03733540845370287,666,Did I mention he is now topless.
31,971,12,56,172,240,1.3333333333333333,0.03671798108312892,666,It's a lure for boaters. I call it 'Bob'!
4463,971,12,54,168,234,1.3333333333333333,0.03733540845370287,666,He promised me a part in a movie.
3655,988,20,43,187,250,1.332,0.039156569663227205,666,If you wanted a fresh packed lunch Morty you should have brought one.
5097,989,16,45,171,232,1.331896551724138,0.03945912813155782,666,"What really irks me is that if our positions were reversed, they'd harpoon my ass."
4720,990,9,56,158,223,1.3318385650224216,0.036909874443314734,666,5 second rule.
1251,991,12,47,155,214,1.3317757009345794,0.039590042253156356,666,I like to start with a false sense of security!
2536,991,10,51,153,214,1.3317757009345794,0.03846579659449079,666,This is what I get for hiring a reputation management consultant.
2933,993,12,46,153,211,1.3317535545023698,0.039966486520512046,666,I brought you the fresh catch of the day
2711,993,15,40,156,211,1.3317535545023698,0.04162606946225971,666,I’m just going to eat in today. I brought my lunch.
3863,993,18,34,159,211,1.3317535545023698,0.043221976735909134,666,"And we would have been on TV too, if Alabama Public Television didn't take exception to the fact that we're both male."
3059,993,9,52,150,211,1.3317535545023698,0.03823493730492664,666,"Ironically, he's a shark spotter."
3190,993,11,48,152,211,1.3317535545023698,0.03939776017449136,666,"I know it's dangerous, but I just love the thrill of it all."
3388,993,15,40,156,211,1.3317535545023698,0.04162606946225971,666,He's an attorney and my mentor.
3454,993,17,36,158,211,1.3317535545023698,0.04269663610791765,666,You already had your half.
3694,993,13,44,154,211,1.3317535545023698,0.04052723260749251,666,What? Do I have a booger or something?
2866,993,13,44,154,211,1.3317535545023698,0.04052723260749251,666,I feel responsible for him now.
3903,993,11,48,152,211,1.3317535545023698,0.03939776017449136,666,I'm taking him home for dinner.
5787,993,13,44,154,211,1.3317535545023698,0.04052723260749251,666,I get hypoglycemic.
4690,993,10,50,151,211,1.3317535545023698,0.03882070283674942,666,Don't look at me like that. He'll be more tender not so worn out.
4873,993,9,52,150,211,1.3317535545023698,0.03823493730492664,666,He's an old chum of mine.
5136,993,16,38,157,211,1.3317535545023698,0.04216475064439969,666,We actually get along ok; he's a lawyer.
5146,993,14,42,155,211,1.3317535545023698,0.04108032522813491,666,I learned it from a duck hunter I ate.
5240,993,14,42,155,211,1.3317535545023698,0.04108032522813491,666,Make all the fun you want—my chiropractor said it'll help!
5361,993,9,52,150,211,1.3317535545023698,0.03823493730492664,666,"Someday, and that day may never come, I will call upon you to do a service for me.'"
2672,993,13,44,154,211,1.3317535545023698,0.04052723260749251,666,White men can’t jump.
6144,993,14,42,155,211,1.3317535545023698,0.04108032522813491,666,It's the best kind of hood ornament--edible.
6278,993,13,44,154,211,1.3317535545023698,0.04052723260749251,666,"Hop on,"" I said. ""Come join the circle of life."
6306,993,16,38,157,211,1.3317535545023698,0.04216475064439969,666,I just couldn't. It's Bobby Darin.
4058,993,9,52,150,211,1.3317535545023698,0.03823493730492664,666,"He's a human who can stand sharks, so I support him."
2517,993,13,44,154,211,1.3317535545023698,0.04052723260749251,666,Nothing quite like a foot massage and then dinner.
4803,993,10,50,151,211,1.3317535545023698,0.03882070283674942,666,I feel as though I’ve got a monkey on my back.
2433,993,13,44,154,211,1.3317535545023698,0.04052723260749251,666,I want to eat him but hes growing on me....
491,993,14,42,155,211,1.3317535545023698,0.04108032522813491,666,How was the top half?
508,993,16,38,157,211,1.3317535545023698,0.04216475064439969,666,"No, really, it's the best invertebrate deep tissue massage there is."
613,993,13,44,154,211,1.3317535545023698,0.04052723260749251,666,"No, leave him alone.  He's really helping my back problem."
708,993,11,48,152,211,1.3317535545023698,0.03939776017449136,666,The fin isn't intimidating anymore
812,993,16,38,157,211,1.3317535545023698,0.04216475064439969,666,I’m saving half my snack for later.
1326,993,15,40,156,211,1.3317535545023698,0.04162606946225971,666,It's my emotional support prey.
1413,993,16,38,157,211,1.3317535545023698,0.04216475064439969,666,"First a massage, then dinner."
1573,993,11,48,152,211,1.3317535545023698,0.03939776017449136,666,I just can't shake this feeling that I'm missing the obvious.
752,993,13,44,154,211,1.3317535545023698,0.04052723260749251,666,The Dr. said take two of these and call him in the morning.
1677,993,11,48,152,211,1.3317535545023698,0.03939776017449136,666,Do you want to tell him?
1920,993,14,42,155,211,1.3317535545023698,0.04108032522813491,666,"So here I am, asking the Sea Witch to give me legs..."
1946,993,17,36,158,211,1.3317535545023698,0.04269663610791765,666,I had to give him a minute because he wants a selfie.
2314,993,14,42,155,211,1.3317535545023698,0.04108032522813491,666,Peek up there and see if anyone's noticed the top half is missing.
2105,993,12,46,153,211,1.3317535545023698,0.039966486520512046,666,I just remembered why we never stop swimming.
1993,993,11,48,152,211,1.3317535545023698,0.03939776017449136,666,I wasn’t hungry so I got it to go
2083,993,15,40,156,211,1.3317535545023698,0.04162606946225971,666,I'm saving it for a mid-afternoon snack.
1548,1034,14,33,137,184,1.3315217391304348,0.045194720704425935,666,He wants to compete but can't afford a surfboard
2612,1035,13,48,163,224,1.3303571428571428,0.038891174462652445,666,"Crazy, 30 minutes walking on my back and I’m completely relaxed....I may not even eat him"
6274,1036,10,50,152,212,1.330188679245283,0.038668829553996815,666,Because he asked politely.
3834,1037,12,45,152,209,1.3301435406698565,0.04019073031693538,666,What happened to yours?
3687,1037,11,47,151,209,1.3301435406698565,0.03961424211637319,666,The dolphins told me this would be fun.
3880,1037,12,45,152,209,1.3301435406698565,0.04019073031693538,666,If he gives me less than four stars I'm going to eat him.
3914,1037,13,43,153,209,1.3301435406698565,0.04075906559727078,666,"It's my new ""Meat, Greet, and Eat service."""
3954,1037,10,49,150,209,1.3301435406698565,0.039029239724860665,666,He promised me a cut when they come watch him walk on water.
3598,1037,14,41,154,209,1.3301435406698565,0.041319584379766156,666,I got the idea from Uber.
3988,1037,11,47,151,209,1.3301435406698565,0.03961424211637319,666,We're going to need a bigger ocean.
4056,1037,12,45,152,209,1.3301435406698565,0.04019073031693538,666,"Yeah, my wife made me take a lunch today."
4315,1037,15,39,155,209,1.3301435406698565,0.041872600567323365,666,"No, sorry.  I'm saving this half for later."
4468,1037,12,45,152,209,1.3301435406698565,0.04019073031693538,666,I saved this part for you.
4527,1037,12,45,152,209,1.3301435406698565,0.04019073031693538,666,Want to join me for dinner?
5681,1037,12,45,152,209,1.3301435406698565,0.04019073031693538,666,"You can have this half, I’m full"
4572,1037,13,43,153,209,1.3301435406698565,0.04075906559727078,666,I always pack a lunch.
4606,1037,14,41,154,209,1.3301435406698565,0.041319584379766156,666,He's running for Congress. Testing the waters.
4627,1037,11,47,151,209,1.3301435406698565,0.03961424211637319,666,I’m using him as a lure.
4631,1037,12,45,152,209,1.3301435406698565,0.04019073031693538,666,I hate these swim with the sharks days.
4976,1037,13,43,153,209,1.3301435406698565,0.04075906559727078,666,"It's an eatable back scratcher"""
5616,1037,12,45,152,209,1.3301435406698565,0.04019073031693538,666,No hurry. He’s wading for Godot.”
3399,1037,11,47,151,209,1.3301435406698565,0.03961424211637319,666,I saved the best part for last !
6041,1037,14,41,154,209,1.3301435406698565,0.041319584379766156,666,I swear . . . it's not what you think.
6066,1037,14,41,154,209,1.3301435406698565,0.041319584379766156,666,"He’s not using me, our love is real."
6155,1037,15,39,155,209,1.3301435406698565,0.041872600567323365,666,Did you forget lunch?
6206,1037,16,37,156,209,1.3301435406698565,0.042418407598878605,666,Have you ever seen that trick where you put a treat on a dog's nose?
4541,1037,12,45,152,209,1.3301435406698565,0.04019073031693538,666,I took my lunch to go.
3230,1037,12,45,152,209,1.3301435406698565,0.04019073031693538,666,"Call me old fashioned, but I was fine with the pilot fish."
3232,1037,15,39,155,209,1.3301435406698565,0.041872600567323365,666,"Honey, come on in! It's not that deep!"
482,1037,12,45,152,209,1.3301435406698565,0.04019073031693538,666,"Suit yourself, but Shiatsu is the only thing that restores my Qi."
74,1037,18,33,158,209,1.3301435406698565,0.04348947634925706,666,These Internet challenges are getting out of hand!
274,1037,10,49,150,209,1.3301435406698565,0.039029239724860665,666,If you like bones start with his feet.
277,1037,19,31,159,209,1.3301435406698565,0.04401523802146914,666,Sorry I already ate the top half.
332,1037,14,41,154,209,1.3301435406698565,0.041319584379766156,666,"I swear, if he calls me Flipper one more time..."
553,1037,16,37,156,209,1.3301435406698565,0.042418407598878605,666,I can't believe you ate yours already. We were supposed to meet for dinner.
646,1037,10,49,150,209,1.3301435406698565,0.039029239724860665,666,It was either him . . .  or a tracking collar!
831,1037,18,33,158,209,1.3301435406698565,0.04348947634925706,666,Doesn’t he hear the music?
869,1037,15,39,155,209,1.3301435406698565,0.041872600567323365,666,"I put in a standing order for meat, and this is what happened."
3116,1037,16,37,156,209,1.3301435406698565,0.042418407598878605,666,I hate this diet...
1132,1037,14,41,154,209,1.3301435406698565,0.041319584379766156,666,You asked for take-out.
1534,1037,10,49,150,209,1.3301435406698565,0.039029239724860665,666,How did they ever dominate the world when they are not that bright!
1646,1037,11,47,151,209,1.3301435406698565,0.03961424211637319,666,"Ok, stop messing with me . You seriously don’t see anything at all on my back?  I sure as heck feel something"
2381,1037,11,47,151,209,1.3301435406698565,0.03961424211637319,666,I have to take these leftovers home for the newborn.
2485,1037,13,43,153,209,1.3301435406698565,0.04075906559727078,666,Just watch. This will go viral.
2838,1037,15,39,155,209,1.3301435406698565,0.041872600567323365,666,"It's symbiotic.  He gets chicks, and I eat them."
919,1037,15,39,155,209,1.3301435406698565,0.041872600567323365,666,I like the skin nice and crispy.
2852,1080,9,51,150,210,1.3285714285714285,0.03828416356619136,666,I am getting cold feet
1492,1081,9,50,148,207,1.328502415458937,0.038638547847777704,666,I got a job as a surfboard.
3770,1081,8,52,147,207,1.328502415458937,0.03802677036640908,666,Freeloader.
1063,1081,17,34,156,207,1.328502415458937,0.043222150595131216,666,Can you believe this guy doesn’t clip his toenails before hitting the beach?
1422,1081,8,52,147,207,1.328502415458937,0.03802677036640908,666,I'm brown bagging it today.
1089,1081,13,42,152,207,1.328502415458937,0.04099446110057558,666,I signed up as an uber driver.
6146,1081,8,52,147,207,1.328502415458937,0.03802677036640908,666,"""You want half?"""
3110,1081,14,40,153,207,1.328502415458937,0.04156257879646069,666,I liked it better in the Jaws era when we got some respect.
3125,1081,18,32,157,207,1.328502415458937,0.043761357581245136,666,"He's not just a friend, he's my best chum."
841,1081,16,36,155,207,1.328502415458937,0.042676131347426545,666,"Law of attraction, my friend."
3657,1081,15,38,154,207,1.328502415458937,0.042123034927429,666,A lot of trouble for toothpicks.
3351,1081,11,46,150,207,1.328502415458937,0.03983392536966205,666,Get your own Lean Cuisine.
3568,1081,13,42,152,207,1.328502415458937,0.04099446110057558,666,"I joined Uber's new water program. If I don't get five stars, I eat him."
2666,1081,11,46,150,207,1.328502415458937,0.03983392536966205,666,"...and if I balance him on my head for 10 seconds, then toss him up and catch him, I win the bet, right?"
619,1081,16,36,155,207,1.328502415458937,0.042676131347426545,666,"As a lawyer, he is one of us."
3594,1081,14,40,153,207,1.328502415458937,0.04156257879646069,666,They pee on us every day and then wonder why we’re so mean.
3952,1081,13,42,152,207,1.328502415458937,0.04099446110057558,666,"I know, I know... I’m going to the dermatologist to get it checked out."
323,1081,13,42,152,207,1.328502415458937,0.04099446110057558,666,It's for a documentary.
229,1081,11,46,150,207,1.328502415458937,0.03983392536966205,666,"No thanks, I'm full of plastic bags."
35,1081,14,40,153,207,1.328502415458937,0.04156257879646069,666,You just move like a surfboard until your hungry.
5997,1081,11,46,150,207,1.328502415458937,0.03983392536966205,666,Let him finish his text.
6191,1081,17,34,156,207,1.328502415458937,0.043222150595131216,666,I regret going vegan.
6244,1081,11,46,150,207,1.328502415458937,0.03983392536966205,666,"No, he's the one who needs a bigger boat."
5039,1081,11,46,150,207,1.328502415458937,0.03983392536966205,666,I like to weigh my food first...you know portion control.
4898,1081,10,48,149,207,1.328502415458937,0.03924078866524482,666,"Wait, that’s what chum means?"
487,1081,16,36,155,207,1.328502415458937,0.042676131347426545,666,"Dolphins, yes, but I also blame the breakdown of traditional aquatic values."
3619,1081,13,42,152,207,1.328502415458937,0.04099446110057558,666,"On the other hand, my back has never felt better."
2603,1107,11,37,132,180,1.3277777777777777,0.0437464589721055,666,"Oh, the quandary this poses. The Internet say,""For every human killed by a shark, humans kill approximately two million sharks."""
1812,1108,11,47,153,211,1.3270142180094786,0.03929990440269058,666,It just started out as a barnacle....
660,1109,12,43,150,205,1.326829268292683,0.04064945001265904,666,"Normally I would, but it actually feels very good."
1066,1109,11,45,149,205,1.326829268292683,0.04005688178927342,666,"You take the left, I'll take the right"
3275,1109,12,43,150,205,1.326829268292683,0.04064945001265904,666,"It sounds like screaming, but that's just the sound they make when dropped in the water"
4037,1109,9,49,147,205,1.326829268292683,0.03884463622401608,666,It's okay. I appreciate not being stereotyped.
5421,1109,8,51,146,205,1.326829268292683,0.03822409914863006,666,"Okay, Okay, Okay...I am a humanitarian...Is there a problem?"
6294,1109,13,41,151,205,1.326829268292683,0.04123350329505737,666,Why can't I play with my food?
1943,1109,10,47,148,205,1.326829268292683,0.03945541497726242,666,I decided to pack a lunch today.
1189,1109,17,33,155,205,1.326829268292683,0.04349135344629863,666,"Well he was floundering and I don’t care what Spielberg says, I’m no monster"
1088,1117,12,42,148,202,1.3267326732673268,0.041055133096935925,666,stop showing off and just eat him
1309,1117,10,46,146,202,1.3267326732673268,0.03983725190307578,666,Trying to convince his friends it’s only 3 feet deep.
5523,1117,10,46,146,202,1.3267326732673268,0.03983725190307578,666,I got some carryout.
5519,1117,14,38,150,202,1.3267326732673268,0.042237912685466984,666,Is it just me or are we losing some of our fear factor to plastic pollution?
3750,1117,9,48,145,202,1.3267326732673268,0.03921412987661604,666,I'm part of his walk on water trick.
3696,1117,13,40,149,202,1.3267326732673268,0.041650721612189724,666,We had a much better turnout at last week's 'Yoga with Sharks' class.
79,1117,13,40,149,202,1.3267326732673268,0.041650721612189724,666,My level of intimidation has dramatically decreased.
1096,1124,9,38,125,172,1.3255813953488371,0.043543976100408846,666,It's new bait to fish for humans.
3242,1125,14,40,155,209,1.325358851674641,0.04122357901978112,666,"Uber Eats.....what can I say, it's a living!"
114,1126,14,37,149,200,1.325,0.042495935365786046,666,"I'm not hungry, but this guy deserves to die."
2030,1127,11,29,117,157,1.3248407643312101,0.048001511107020556,666,Is this the future of climate change?
4516,1128,6,22,77,105,1.3238095238095238,0.05660614861831635,666,My therapist recommended this mental exercise.
5294,1129,10,45,146,201,1.3233830845771144,0.03989416954573026,666,I'm doing this for Lent.
808,1129,8,49,144,201,1.3233830845771144,0.038626963072202335,666,You eat yet?
3499,1131,14,47,171,232,1.3232758620689655,0.03833426881476336,666,Flip for it?
884,1132,11,42,145,198,1.3232323232323233,0.04091989820171758,666,"It's like migraine, a sudden weight on the back of my head."
1663,1132,13,38,147,198,1.3232323232323233,0.042154316442536574,666,The top half was pretty good. Saved you the legs and thighs.
456,1132,18,28,152,198,1.3232323232323233,0.04509276227382792,666,He doesn't know he's in over his head.
65,1132,9,46,143,198,1.3232323232323233,0.03964706474558173,666,I got take out.
2721,1132,7,50,141,198,1.3232323232323233,0.03833198947409031,666,I've got a busy day so I brought my lunch.
3364,1132,16,32,150,198,1.3232323232323233,0.04394097044428331,666,I saved you the legs.
3450,1132,12,40,146,198,1.3232323232323233,0.041541692692862425,666,I ate the top part and I'm saving this for later.
1242,1132,10,44,144,198,1.3232323232323233,0.040288508360196706,666,I hate 'Shark Week'
768,1132,10,44,144,198,1.3232323232323233,0.040288508360196706,666,I had just eaten and he asked me nicely.
4940,1132,8,48,142,198,1.3232323232323233,0.03899507122690072,666,That top half was filling. I'm saving these leftovers for tomorrow's breakfast.
5367,1132,9,46,143,198,1.3232323232323233,0.03964706474558173,666,"Help yourself, I’ve already had my half."
5748,1132,8,48,142,198,1.3232323232323233,0.03899507122690072,666,Does it make me look younger?
5849,1132,8,48,142,198,1.3232323232323233,0.03899507122690072,666,I'm still waiting for the Jaws music to kick in.
5936,1132,13,38,147,198,1.3232323232323233,0.042154316442536574,666,"He thinks he's hanging ten, but when I get through with him it'll be more like two."
6200,1132,15,34,149,198,1.3232323232323233,0.043353601011174255,666,One trip to SeaWorld and you think you're a dolphin.
4014,1132,9,46,143,198,1.3232323232323233,0.03964706474558173,666,Can you hear his accent?   I think we’re somewhere on Oklahoma.
4348,1132,11,42,145,198,1.3232323232323233,0.04091989820171758,666,"First, I'll tickle his toes, then ..."
4701,1149,11,41,143,195,1.323076923076923,0.04133835352961087,666,"He's on top of me, isn't he?"
4219,1150,10,29,113,152,1.3223684210526316,0.048146160577332814,666,Looks like six more weeks of winter.
3698,1151,10,48,153,211,1.3222748815165877,0.03861904983405377,666,Wait'll you see his face when he realizes he's not on a rock.
940,1152,12,40,147,199,1.321608040201005,0.04136431657393289,666,"Fine, don’t guess.  I’m Carmen Miranda."
4471,1153,9,45,142,196,1.3214285714285714,0.03986830754653129,666,It's the eagle holding his upper body upright who I feel sorry for.
5827,1154,14,34,145,193,1.3212435233160622,0.043488734308127545,666,I ordered Chinese.
612,1155,7,53,149,209,1.3205741626794258,0.03700259962507475,666,Amazon delivery of your Mako-at-Home Meal Kit
665,1155,14,39,156,209,1.3205741626794258,0.041124673295863834,666,I 'm saving the other half for later
5927,1157,11,41,145,197,1.3197969543147208,0.040982947500927604,666,I'm using his GPS.
1286,1158,12,38,144,194,1.3195876288659794,0.04204381606325179,666,The woman he was with was actually quite tasty.
2498,1158,10,42,142,194,1.3195876288659794,0.04075353443758232,666,So who's the Great White these days?
1836,1158,13,36,145,194,1.3195876288659794,0.04267432974474491,666,You’ve got to be kidding. A great white?
4171,1158,13,36,145,194,1.3195876288659794,0.04267432974474491,666,"I packed a lunch today, it's cheaper than eating out."
4272,1158,8,46,140,194,1.3195876288659794,0.039421043481240654,666,I'm not hungry and my back feels great.
61,1158,11,40,143,194,1.3195876288659794,0.0414037017567014,666,He's found the sweet spot. I can't reach him.
5418,1158,8,46,140,194,1.3195876288659794,0.039421043481240654,666,"Look, man, depression has hit me hard. I just don't have the energy anymore to even bite."
5875,1158,13,36,145,194,1.3195876288659794,0.04267432974474491,666,I'll tolerate him for a while since he thinks he is swimming with the dolphins.  Then I'll grab a leg.  Want the other?
5919,1158,11,40,143,194,1.3195876288659794,0.0414037017567014,666,I just feel like my food choices are weighing me down
2555,1158,9,44,141,194,1.3195876288659794,0.04009282503332157,666,His phone isn’t waterproof.
1318,1168,9,20,90,119,1.319327731092437,0.05589169577273062,666,Leftovers.
1374,1169,16,34,157,207,1.318840579710145,0.04248189999618684,666,"Yeah, yeah, I've heard it all: 'I hear you should always eat a balanced diet'; 'It's good to support your food choices; or 'He's a lawyer; professional courtesy'... Let's hope the winning entry is more original!"
2675,1170,14,34,147,195,1.317948717948718,0.04310422960405288,666,"It's just a snack for later. It won't ""ruin my dinner,"" mom."
5569,1170,13,36,146,195,1.317948717948718,0.042486545113173194,666,His arms were delicious but I had to save the rest for later.
967,1172,14,33,145,192,1.3177083333333333,0.04357115391389811,666,It's times like this that really make me regret going vegan.
2245,1172,9,43,140,192,1.3177083333333333,0.04032068754762938,666,We have a standing dinner date.
822,1172,10,41,141,192,1.3177083333333333,0.04099140600331445,666,"Mate, you've still got a bit of food on you..."
1672,1172,9,43,140,192,1.3177083333333333,0.04032068754762938,666,I wish he'd jump already.
2029,1172,12,37,143,192,1.3177083333333333,0.04230095045928142,666,I've got this guy right where I want him.
2165,1172,11,39,142,192,1.3177083333333333,0.04165132516431587,666,Are you sure these are the toppings we ordered?
5437,1172,9,43,140,192,1.3177083333333333,0.04032068754762938,666,But he's the only one who's ever made me happy!
4900,1172,16,29,147,192,1.3177083333333333,0.04480536236901356,666,Rideshare app
4579,1172,13,35,144,192,1.3177083333333333,0.04294074908025697,666,"He ain't heavy, he's my Darwinian brother..."
2353,1172,11,39,142,192,1.3177083333333333,0.04165132516431587,666,The problem with this generation is they didn't grow up watching Jaws.
1387,1172,8,45,139,192,1.3177083333333333,0.039638621601899154,666,I like foot massages.
733,1172,15,31,146,192,1.3177083333333333,0.044192566967801356,666,I’m waiting until he drops the child
1353,1172,9,43,140,192,1.3177083333333333,0.04032068754762938,666,It’s all part of a balanced diet.
54,1172,14,33,145,192,1.3177083333333333,0.04357115391389811,666,I'm playing a long game.
223,1172,15,31,146,192,1.3177083333333333,0.044192566967801356,666,Watch this.
2324,1187,13,34,143,190,1.3157894736842106,0.04321158643721909,666,"Hey Sal, Do I have food on my head?"
1470,1187,11,38,141,190,1.3157894736842106,0.04190288316270685,666,I do this for an arm and a leg.
5508,1187,9,42,139,190,1.3157894736842106,0.04055196705800677,666,See? They are not all blood-thirsty monsters.
5311,1187,10,40,140,190,1.3157894736842106,0.04123295799249144,666,I'll hold off on attacking until after he posts on Instagram.
5145,1187,12,36,142,190,1.3157894736842106,0.04256226509344115,666,"If I can't see him, I won't eat him."
4890,1187,13,34,143,190,1.3157894736842106,0.04321158643721909,666,Do you think it’s malignant?
1974,1187,8,44,138,190,1.3157894736842106,0.03985934319249087,666,"I want to eat him, but then I'll have to wait 30 minutes until I can go swimming."
4784,1187,13,34,143,190,1.3157894736842106,0.04321158643721909,666,"He keeps singing
""Why not take all of me""."
4570,1187,14,32,144,190,1.3157894736842106,0.04385129410813499,666,Join me for lunch?
3848,1187,10,40,140,190,1.3157894736842106,0.04123295799249144,666,"Don't attack him, the foot massage feels great."
3822,1187,9,42,139,190,1.3157894736842106,0.04055196705800677,666,So I thought Why not take-out tonight ?
2093,1187,10,40,140,190,1.3157894736842106,0.04123295799249144,666,He's a chiropractor.  I'll eat him once he's finished adjusting me.
3782,1187,14,32,144,190,1.3157894736842106,0.04385129410813499,666,I like a massage before my meal.
1048,1187,7,46,137,190,1.3157894736842106,0.039154469057821106,666,what?
1032,1187,14,32,144,190,1.3157894736842106,0.04385129410813499,666,"What he doesn't know if, after the massage, I get a happy ending."
3113,1187,11,38,141,190,1.3157894736842106,0.04190288316270685,666,"And after the massage, there'll be a full course meal."
819,1187,12,36,142,190,1.3157894736842106,0.04256226509344115,666,"The kids call it ""Sharking."""
978,1187,15,30,145,190,1.3157894736842106,0.04448180288044823,666,"Yeah, but if I don't deliver it in 30 minutes or less, it's free."
115,1187,10,40,140,190,1.3157894736842106,0.04123295799249144,666,I’m taking this one to go.
4625,1206,14,31,142,187,1.3155080213903743,0.04434077046618917,666,Vinny's experience with a lone shark did not go as planned.
2510,1206,11,37,139,187,1.3155080213903743,0.042350925689203595,666,Mom always put extra snacks in my back pack
2532,1206,13,33,141,187,1.3155080213903743,0.04368756023478153,666,It's a human decoy I made.  Everyone thinks it's safe and pile into the water and then we feast.
2624,1206,8,43,136,187,1.3155080213903743,0.04026285990748318,666,"I  can't make it any easier for you  , can I  ?"
2758,1206,12,35,140,187,1.3155080213903743,0.04302443390679365,666,And I thought barnicles were a bummer.
2936,1206,8,43,136,187,1.3155080213903743,0.04026285990748318,666,"I told him he should just jump the shark already but, he didn't get it."
3145,1206,7,45,135,187,1.3155080213903743,0.03954234289545836,666,"The guy at the store said you need to keep the head as dry as possible, but I just know I'm going to forget."
5414,1206,12,35,140,187,1.3155080213903743,0.04302443390679365,666,He wants to impress some woman. We all know how that is.
3239,1206,9,41,137,187,1.3155080213903743,0.04097070775807059,666,"I can’t break his heart, he thinks I’m a dolphin."
5371,1206,16,27,144,187,1.3155080213903743,0.04561914004089176,666,I’m a pacifist.
3294,1206,11,37,139,187,1.3155080213903743,0.042350925689203595,666,There is a $10 delivery fee
3356,1206,12,35,140,187,1.3155080213903743,0.04302443390679365,666,We won the surfing contest.
3436,1206,12,35,140,187,1.3155080213903743,0.04302443390679365,666,We met on a fetish site.
3465,1206,6,47,134,187,1.3155080213903743,0.03880845108213412,666,I enjoy lulling them into a false sense of security.
5355,1206,12,35,140,187,1.3155080213903743,0.04302443390679365,666,It's today's special. Surf & Turf.
4039,1206,8,43,136,187,1.3155080213903743,0.04026285990748318,666,"I would, but his arm only got one star on Yelp."
4091,1206,7,45,135,187,1.3155080213903743,0.03954234289545836,666,I saved the bottom half for you- I knew it is your favorite.
5274,1206,9,41,137,187,1.3155080213903743,0.04097070775807059,666,"He's doing something called ""selfie?"""
4284,1206,13,33,141,187,1.3155080213903743,0.04368756023478153,666,Do you want him?  He supposedly has bone spurs!!
4441,1206,12,35,140,187,1.3155080213903743,0.04302443390679365,666,"Yes, I suppose I could use some assertiveness training."
2481,1206,11,37,139,187,1.3155080213903743,0.042350925689203595,666,Say when
3299,1206,11,37,139,187,1.3155080213903743,0.042350925689203595,666,Let’s wait til he finishes his cigarette.
2255,1206,13,33,141,187,1.3155080213903743,0.04368756023478153,666,He must be an attorney. He seems very comfortable in this environment.
1073,1206,13,33,141,187,1.3155080213903743,0.04368756023478153,666,"Oh, him? I just signed up to be a Lyft driver."
5933,1206,12,35,140,187,1.3155080213903743,0.04302443390679365,666,"There’s gotta be, like, a million things I could do to this idiot to get on “Shark Week.”"
5940,1206,15,29,143,187,1.3155080213903743,0.044984496571628806,666,It's bring your lunch to school day.
4793,1206,8,43,136,187,1.3155080213903743,0.04026285990748318,666,They do takeout.
5977,1206,10,39,138,187,1.3155080213903743,0.04166653213869419,666,You're late for dinner.
5806,1206,8,43,136,187,1.3155080213903743,0.04026285990748318,666,"And now, what the hell do I do?"
5782,1206,10,39,138,187,1.3155080213903743,0.04166653213869419,666,I bought my own lunch today.
5556,1206,14,31,142,187,1.3155080213903743,0.04434077046618917,666,We have to throw it back. It's under the weight allowance.
6095,1206,10,39,138,187,1.3155080213903743,0.04166653213869419,666,"I've tried everything, but I can't get this monkey off my back."
2322,1206,12,35,140,187,1.3155080213903743,0.04302443390679365,666,"He's giving a speech on how sharks keep oceans clean. Professionally, I'm on the horns of a dilemma."
6175,1206,15,29,143,187,1.3155080213903743,0.044984496571628806,666,"I can’t remember if I’m supposed to stop swimming, play dead or rap him on the nose."
369,1206,10,39,138,187,1.3155080213903743,0.04166653213869419,666,"I don't agree with everything he says, but I do support his platform."""
550,1206,11,37,139,187,1.3155080213903743,0.042350925689203595,666,I ordered take out.
707,1206,10,39,138,187,1.3155080213903743,0.04166653213869419,666,I'm giving intermittent fasting a try.
965,1206,13,33,141,187,1.3155080213903743,0.04368756023478153,666,"Since  I hired him to be my lookout, I’ve  stopped scaring the swimmers away."
996,1206,10,39,138,187,1.3155080213903743,0.04166653213869419,666,I'm a breast man myself. Do you want a leg?
6292,1206,7,45,135,187,1.3155080213903743,0.03954234289545836,666,It was my therapist's idea.
5108,1206,10,39,138,187,1.3155080213903743,0.04166653213869419,666,I think you should know that this guy has a spear gun pointed at you and perhaps you should take a swim back to your own waters .
4795,1247,7,21,83,111,1.3153153153153154,0.05576066497003428,666,Want the other half?
6204,1248,14,33,147,194,1.3144329896907216,0.04318263309474422,666,I'm emotionally attached because years ago when I was really hungry  he gave me a hand.
2823,1248,8,45,141,194,1.3144329896907216,0.039296871389199343,666,"The wife was in the mood for tourist."""
3544,1248,13,35,146,194,1.3144329896907216,0.04255965050364756,666,"Why don’t you tell him I’m not a 
sand bar"
2104,1251,13,34,144,191,1.3141361256544504,0.04301653749697982,666,You have Chip on your shoulder.
6090,1251,13,34,144,191,1.3141361256544504,0.04301653749697982,666,What did you do with yours?
3279,1253,7,51,149,207,1.3140096618357489,0.03706727316067928,666,It's how big? That's odd because it feels more like two feet to me.
1537,1254,13,48,175,236,1.3135593220338984,0.03721183551854735,666,"Once again, looks like you got more of it on you than in you."
5884,1255,11,36,138,185,1.3135135135135134,0.04261440543311185,666,Do you ever feel like “the man” is always on your back?
4330,1255,9,40,136,185,1.3135135135135134,0.04121260410671286,666,"I know it's not bacon, but it looks delicious."
3272,1255,7,44,134,185,1.3135135135135134,0.03976141250126382,666,"Hey, Dad.  He followed me home.  Can I keep him?"
2450,1258,12,42,157,211,1.3127962085308056,0.03956301882463941,666,I don't know if I should eat him or enjoy the back massage.
129,1259,11,38,143,192,1.3125,0.04153009905357379,666,Heads or tails?
1794,1260,11,42,152,205,1.3121951219512196,0.03973233982784261,666,I know we said we weren't going to eat any humans this summer but if he starts to pee I'm gonna lose it...
5338,1261,19,19,145,183,1.3114754098360655,0.048158891783800006,666,"His feet stink like the Bronx so maybe he tastes good, too."
4609,1261,12,33,138,183,1.3114754098360655,0.04357676187148369,666,"He thinks he's my surf buddy, but he's just chum."
4266,1261,11,35,137,183,1.3114754098360655,0.04288222166384206,666,A little nip on the ankle should get him off my back.
4227,1261,7,43,133,183,1.3114754098360655,0.03998359630296466,666,I know you hate talking about dinner plans when we’ve just had lunch...
4197,1261,7,43,133,183,1.3114754098360655,0.03998359630296466,666,"Yeah, I just don't have the heart, OK? His glasses fell off, then he started swimming in my direction yelling here Flipper, here boy!"
4119,1261,10,37,136,183,1.3114754098360655,0.04217624561823606,666,Professional courtesy. We might need a good lawyer some day.
4094,1261,9,39,135,183,1.3114754098360655,0.04145824952976991,666,Just wait until he finds out I'm not a dolphin.
4019,1261,8,41,134,183,1.3114754098360655,0.04072759769119163,666,My psychiatrist recommended exposure therapy to combat my compulsive overeating.
3995,1261,12,33,138,183,1.3114754098360655,0.04357676187148369,666,"Hey, wanna play wishbone?"
3857,1261,15,27,141,183,1.3114754098360655,0.04559695051574527,666,"Open real wide now. When I go low, you go high!"
3851,1261,13,31,139,183,1.3114754098360655,0.04426040460254633,666,They're much more comfortable approaching since I got the doll.
3771,1261,7,43,133,183,1.3114754098360655,0.03998359630296466,666,"No, honey, it's not an affair, just a great little massage."
3721,1261,11,35,137,183,1.3114754098360655,0.04288222166384206,666,Where have you been? Dinner's ready.
3695,1261,9,39,135,183,1.3114754098360655,0.04145824952976991,666,"Not a fan of legs and thighs, you?"
3614,1261,14,29,140,183,1.3114754098360655,0.04493364725857688,666,"It's working, Ralph. He's telling everyone to come out and stand on this sandbar !"
4074,1261,12,33,138,183,1.3114754098360655,0.04357676187148369,666,"I know, honey, I know. But, we have just got to watch the carbs."
4755,1261,14,29,140,183,1.3114754098360655,0.04493364725857688,666,"He's making a sequel to ""Jaws"" and I am auditioning for the lead."
4904,1261,11,35,137,183,1.3114754098360655,0.04288222166384206,666,I’m waiting for him to get off his phone.
4839,1261,12,33,138,183,1.3114754098360655,0.04357676187148369,666,"Get it off, get it off, get it off!"
5364,1261,13,31,139,183,1.3114754098360655,0.04426040460254633,666,What?! You have a problem with carry-out?
5381,1261,14,29,140,183,1.3114754098360655,0.04493364725857688,666,I'm carrying 125 pounds in the finals of the handicapped shark races. How about you?
5583,1261,12,33,138,183,1.3114754098360655,0.04357676187148369,666,What do you say we see how he hangs five?
3534,1261,10,37,136,183,1.3114754098360655,0.04217624561823606,666,"Technically, we would remain vegan because he was."
5831,1261,14,29,140,183,1.3114754098360655,0.04493364725857688,666,"Of course we’ll eat him, but let him adjust my spine first"
5902,1261,7,43,133,183,1.3114754098360655,0.03998359630296466,666,These millennials think they're entitled to everything.
6013,1261,12,33,138,183,1.3114754098360655,0.04357676187148369,666,"I’m on Step 9, Making Amends."
6052,1261,11,35,137,183,1.3114754098360655,0.04288222166384206,666,Poor guy thinks he’s walking on water... at least he’ll go out in style.
6053,1261,13,31,139,183,1.3114754098360655,0.04426040460254633,666,You should start packing a lunch too.
6182,1261,9,39,135,183,1.3114754098360655,0.04145824952976991,666,I can't shake him.  How did you get rid of yours?
6189,1261,10,37,136,183,1.3114754098360655,0.04217624561823606,666,I lost a bet to a vulture. He gets to go first.
6261,1261,7,43,133,183,1.3114754098360655,0.03998359630296466,666,I packed a lunch.
5027,1261,14,29,140,183,1.3114754098360655,0.04493364725857688,666,"Works such a drag, I just can’t get this guy off my back!"
5006,1261,11,35,137,183,1.3114754098360655,0.04288222166384206,666,Please go up and see if he's as bony as he feels.  I'm on a low-fat diet.
5119,1261,8,41,134,183,1.3114754098360655,0.04072759769119163,666,"I'm waiting for a seal, they have more meat on them !!"
4792,1261,13,31,139,183,1.3114754098360655,0.04426040460254633,666,"Hey, you promised dessert if I brought the entree."
3476,1261,9,39,135,183,1.3114754098360655,0.04145824952976991,666,I stopped by the shore on my way home.  Thought you might like this.
4685,1261,13,31,139,183,1.3114754098360655,0.04426040460254633,666,"You know you can just eat him, right?"
3238,1261,14,29,140,183,1.3114754098360655,0.04493364725857688,666,We're gonna need a bigger ocean.
80,1261,14,29,140,183,1.3114754098360655,0.04493364725857688,666,It’s not what it looks like - I’m taking him to lunch.
93,1261,13,31,139,183,1.3114754098360655,0.04426040460254633,666,"I don’t know, I guess I’m just not that hungry."
110,1261,12,33,138,183,1.3114754098360655,0.04357676187148369,666,Do I have a pimple on my back?
119,1261,7,43,133,183,1.3114754098360655,0.03998359630296466,666,I say it's a 60% - 40% split since he is standing on me!
644,1261,7,43,133,183,1.3114754098360655,0.03998359630296466,666,It's just the old bait and switch.
682,1261,10,37,136,183,1.3114754098360655,0.04217624561823606,666,Give him a break. The guy lost his surfboard.
842,1261,7,43,133,183,1.3114754098360655,0.03998359630296466,666,Going vegan is much more annoying than I thought it would be.
1027,1261,16,25,142,183,1.3114754098360655,0.04625074201256053,666,When should I break the news to him that the dolphins are in the other tank?
1472,1261,12,33,138,183,1.3114754098360655,0.04357676187148369,666,"Luckily for me, Uber's driver background checks are rather lax."
1647,1261,12,33,138,183,1.3114754098360655,0.04357676187148369,666,I use him as my look out - the fin thing is just too much of a give-away.
1805,1261,14,29,140,183,1.3114754098360655,0.04493364725857688,666,No! You ate the top half!
404,1261,10,37,136,183,1.3114754098360655,0.04217624561823606,666,I'll consume him in due time. Finish your story.
2119,1261,8,41,134,183,1.3114754098360655,0.04072759769119163,666,Are you interested in the leftovers?
1810,1261,10,37,136,183,1.3114754098360655,0.04217624561823606,666,Should I tell him?
3146,1261,11,35,137,183,1.3114754098360655,0.04288222166384206,666,I'm starting a balanced diet today.
3109,1261,12,33,138,183,1.3114754098360655,0.04357676187148369,666,"it's only my second week, but I'm already finding it really hard to be vegan"
3017,1261,9,39,135,183,1.3114754098360655,0.04145824952976991,666,It was either this or the chiropractor.
2900,1261,9,39,135,183,1.3114754098360655,0.04145824952976991,666,It's customary to tip for your grubhub delivery
3289,1261,13,31,139,183,1.3114754098360655,0.04426040460254633,666,The salesman said it would be less conspicuous than a fin.
2164,1261,13,31,139,183,1.3114754098360655,0.04426040460254633,666,I just let him think we have a ‘special  bond’ then I’ll eat him.
2152,1261,15,27,141,183,1.3114754098360655,0.04559695051574527,666,Here comes the triple flip. I'm going for a vertical entry with this one.
2858,1261,9,39,135,183,1.3114754098360655,0.04145824952976991,666,Should I break it to him?
5970,1321,6,30,99,135,1.3111111111111111,0.04756847982341376,666,"I was always told that we were on top of the food 
chain."
2331,1322,12,35,143,190,1.3105263157894738,0.042439843043943645,666,Uber doesn't care if you're a shark.
3248,1323,12,34,141,187,1.3101604278074865,0.04289918055832344,666,Don't eat my emotional support animal!
2371,1324,11,34,136,181,1.3093922651933703,0.04315448043932483,666,"I’m sorry man, but I can’t do it without the music"
1936,1324,10,36,135,181,1.3093922651933703,0.04243726932524094,666,I disagree. I think this ride shark service could habe some legs to it.
2442,1324,12,32,137,181,1.3093922651933703,0.04385996507286688,666,I'm just keeping him fresh for dinner when I get hungry.
2546,1324,12,32,137,181,1.3093922651933703,0.04385996507286688,666,"He thinks I'm sandbar, and now I don't have the heart."
2717,1324,12,32,137,181,1.3093922651933703,0.04385996507286688,666,He complained about the rate so I told him I'd take half off.
2751,1324,8,40,133,181,1.3093922651933703,0.04096519399896659,666,"No, ma!  I won't stop playing with my food!"
4695,1324,9,38,134,181,1.3093922651933703,0.041707726785069475,666,Uber shark food delivery ... here's your order.
3656,1324,11,34,136,181,1.3093922651933703,0.04315448043932483,666,Bait. The fin was a dead giveaway.
4398,1324,11,34,136,181,1.3093922651933703,0.04315448043932483,666,Uber Eats delivery.
4486,1324,18,20,143,181,1.3093922651933703,0.04787505259969231,666,"It's my first time as an Uber driver, but if I get humgry it's all over."
4791,1324,8,40,133,181,1.3093922651933703,0.04096519399896659,666,I brought you leftovers...
5564,1324,10,36,135,181,1.3093922651933703,0.04243726932524094,666,It's an Uber experimental ride-share-eat option.
4834,1324,12,32,137,181,1.3093922651933703,0.04385996507286688,666,Snacks on me!
3219,1324,10,36,135,181,1.3093922651933703,0.04243726932524094,666,"matter of fact, no, i’m a man-standing shark."
336,1324,11,34,136,181,1.3093922651933703,0.04315448043932483,666,I've really lost the urge since I  can't hear the theme music.
5178,1324,11,34,136,181,1.3093922651933703,0.04315448043932483,666,This intermittent fasting is getting harder and harder.
66,1324,8,40,133,181,1.3093922651933703,0.04096519399896659,666,It's either this or pain pills.
211,1324,9,38,134,181,1.3093922651933703,0.041707726785069475,666,"Yeah, it's great, I make my own hours and eat on the job!"
3919,1342,8,31,113,152,1.3092105263157894,0.045952936954475276,666,He thinks all sharks are bottom feeders.
4249,1343,11,34,137,182,1.3076923076923077,0.04295036788466059,666,"Hi, I have an Uber Eats order for Bruce"
5541,1344,7,41,131,179,1.3072625698324023,0.04043753495493227,666,"I ate the last two, so the resort put me on probation."
4223,1344,11,33,135,179,1.3072625698324023,0.04343129088322004,666,Shorts week
2633,1344,6,43,130,179,1.3072625698324023,0.03965379596701296,666,I always bring a snack.
1686,1344,11,33,135,179,1.3072625698324023,0.04343129088322004,666,"I think can we can take the mixed doubles water ballet title, if I can control my appetite."
1249,1344,11,33,135,179,1.3072625698324023,0.04343129088322004,666,"He's heavy, but he's a great decoy."
1202,1344,8,39,132,179,1.3072625698324023,0.041206370039949466,666,It's symbiotic for now. I'm not making any promises.
979,1344,8,39,132,179,1.3072625698324023,0.041206370039949466,666,"As above, so below."
4385,1351,7,31,109,147,1.3061224489795917,0.045904128089684255,666,Think cognitive dissonance.
6282,1352,7,42,134,183,1.3060109289617485,0.039839718195839695,666,An hour a week and the back’s good as new.
2337,1352,13,30,140,183,1.3060109289617485,0.044130472331333326,666,Did you enjoy the top half?
980,1354,9,30,118,157,1.305732484076433,0.04577745874766909,666,It’s a symbiotic relationship
2275,1355,12,31,137,180,1.3055555555555556,0.04393524255438892,666,"I know he's heavy, but you should see my abs."
1870,1356,12,30,135,177,1.305084745762712,0.044441052888565744,666,Call PR...aren’t they supposed to be scared of us!
2169,1356,7,40,130,177,1.305084745762712,0.04066940502276149,666,I'm on a balanced diet.
2406,1356,9,36,132,177,1.305084745762712,0.042218516976333616,666,I like to mess with them a little before I take a bite.
2426,1356,9,36,132,177,1.305084745762712,0.042218516976333616,666,"Here's your Uber Eats Delivery"""
5376,1356,15,24,138,177,1.305084745762712,0.04655761149380008,666,I met him in my “Vegan for Dummies” cooking class.
5607,1356,10,34,133,177,1.305084745762712,0.042972136449899084,666,I got us takeout.
1716,1356,14,26,137,177,1.305084745762712,0.045862946401423556,666,Can you finish the rest?  I just wanted the wings and breast.
3352,1356,6,42,129,177,1.305084745762712,0.03987228573229332,666,"""Your delivery of a gluten-free person for dinner."""
3358,1356,7,40,130,177,1.305084745762712,0.04066940502276149,666,The family meal always ends up being too much food.
3713,1356,15,24,138,177,1.305084745762712,0.04655761149380008,666,It's take-out tonight.  End of discussion.
3855,1356,16,22,139,177,1.305084745762712,0.047242063073022145,666,"Word is, Sharkworld may raise our pay to $15 per hour, plus chum."
4025,1356,12,30,135,177,1.305084745762712,0.044441052888565744,666,I've lost my edge!
4232,1356,11,32,134,177,1.305084745762712,0.043712765257491105,666,"Sorry, I can't go out to lunch today.  I brought leftovers."
4382,1356,9,36,132,177,1.305084745762712,0.042218516976333616,666,"He loves the ocean, but he can't swim."
4417,1356,10,34,133,177,1.305084745762712,0.042972136449899084,666,I don't know if I should eat him or rescind his pro-surfer's certificate.
4566,1356,10,34,133,177,1.305084745762712,0.042972136449899084,666,I'm evolving.
4774,1356,14,26,137,177,1.305084745762712,0.045862946401423556,666,I'm making extra money as a uber driver.
4846,1356,15,24,138,177,1.305084745762712,0.04655761149380008,666,"I 'm taking a course in Anger Management"""
5309,1356,6,42,129,177,1.305084745762712,0.03987228573229332,666,"If anything, it's a conflict of interest."
5554,1356,5,44,128,177,1.305084745762712,0.03905890211116878,666,I thought you said to pack a lunch?
3267,1356,16,22,139,177,1.305084745762712,0.047242063073022145,666,"Out of the Way! He is one of us,  Binsky just passed the Bar."
1428,1356,7,40,130,177,1.305084745762712,0.04066940502276149,666,Fast food to go!
810,1356,9,36,132,177,1.305084745762712,0.042218516976333616,666,"Trust me, it’s a great way to lure the others."
504,1356,12,30,135,177,1.305084745762712,0.044441052888565744,666,He’s gonna be surprised when he finds out I’m not Shamu.
423,1356,9,36,132,177,1.305084745762712,0.042218516976333616,666,Why don't they ever talk about our good qualities?
1267,1356,14,26,137,177,1.305084745762712,0.045862946401423556,666,"I'd take his legs off, but he's scratching a spot I can't reach."
4085,1382,11,31,132,174,1.3045977011494252,0.04421797840187394,666,When do you think I should tell him?
3932,1382,12,29,133,174,1.3045977011494252,0.044962989024350565,666,"If he shouts 'Hey, Bro!--Who's the Man!' one more time, let's snap him in half!"
3908,1382,4,45,125,174,1.3045977011494252,0.038602386423142794,666,''I owe him 'cause I ate his surfboard.''
3736,1382,10,33,131,174,1.3045977011494252,0.04346019841065284,666,I found him on decoys.com
6198,1382,8,37,129,174,1.3045977011494252,0.041903547699243246,666,There is no other half.
3094,1382,9,35,130,174,1.3045977011494252,0.042688969041639234,666,"Shall I tell him, or should you?"
3076,1382,10,33,131,174,1.3045977011494252,0.04346019841065284,666,As a support shark I get into the movies for free.
2725,1382,7,39,128,174,1.3045977011494252,0.04110312082710357,666,He said he needs to finish tweeting first.
2629,1382,9,35,130,174,1.3045977011494252,0.042688969041639234,666,It's only humiliating if you don't eat him afterwards.
2627,1382,7,39,128,174,1.3045977011494252,0.04110312082710357,666,"I'm not hungry, but I don't think I can pass up the teachable moment."
2551,1382,10,33,131,174,1.3045977011494252,0.04346019841065284,666,Leftovers. Why do you ask?
2459,1382,9,35,130,174,1.3045977011494252,0.042688969041639234,666,"He's all yours... I am a ""breast guy"" !"
2409,1382,9,35,130,174,1.3045977011494252,0.042688969041639234,666,He is going to have a sinking feeling soon...
2034,1382,11,31,132,174,1.3045977011494252,0.04421797840187394,666,I thought I’d try an edible back massager
3010,1382,7,39,128,174,1.3045977011494252,0.04110312082710357,666,I'd say it's a fair exchange--he scratches my back and I don't eat him.
3099,1382,10,33,131,174,1.3045977011494252,0.04346019841065284,666,My generation always swam against the current in freezing water to hunt for food. Your soft generation lays around in globally-warmed water waiting for delivery.
4332,1382,11,31,132,174,1.3045977011494252,0.04421797840187394,666,"I can’t stand this anymore, and they wonder why we bite them from time to time !"
4345,1382,8,37,129,174,1.3045977011494252,0.041903547699243246,666,My PR team thought it would help soften my image.
3426,1382,11,31,132,174,1.3045977011494252,0.04421797840187394,666,"He said he was a lawyer, so I knew he was one of us."
3453,1382,4,45,125,174,1.3045977011494252,0.038602386423142794,666,Just in case I get hungry later.
3393,1382,12,29,133,174,1.3045977011494252,0.044962989024350565,666,I brought the hors d'oeuvre.
3300,1382,9,35,130,174,1.3045977011494252,0.042688969041639234,666,Climate change.
3553,1382,6,41,127,174,1.3045977011494252,0.04028679403566629,666,"Man, that damn 'Shark Tale"" movie really killed our street cred."
6193,1382,9,35,130,174,1.3045977011494252,0.042688969041639234,666,I've become a bottom feeder.
4305,1382,8,37,129,174,1.3045977011494252,0.041903547699243246,666,This one's O.K. The last guy was wearing cleats.
1276,1382,13,27,134,174,1.3045977011494252,0.045695854845479666,666,On the count of 3...
5790,1382,10,33,131,174,1.3045977011494252,0.04346019841065284,666,Talk about a false sense of security!
3278,1382,15,23,136,174,1.3045977011494252,0.04712740907550197,666,I told you we look like surfboards
3711,1382,10,33,131,174,1.3045977011494252,0.04346019841065284,666,I don’t know how much longer I can take working under this guy!
4952,1382,14,25,135,174,1.3045977011494252,0.046417151120188606,666,Goat yoga is so passé
4939,1382,10,33,131,174,1.3045977011494252,0.04346019841065284,666,"We make a wish, and then we each grab an end…"
4640,1382,8,37,129,174,1.3045977011494252,0.041903547699243246,666,I’m working on a balanced diet.
6022,1382,4,45,125,174,1.3045977011494252,0.038602386423142794,666,He works on my back and I don't eat him.
1085,1382,10,33,131,174,1.3045977011494252,0.04346019841065284,666,I just know I’m going to get Athlete’s Fin from this.”
121,1382,12,29,133,174,1.3045977011494252,0.044962989024350565,666,Have you met Finn?
872,1382,9,35,130,174,1.3045977011494252,0.042688969041639234,666,I still don't get why my folks told me not to play with my food.
298,1382,11,31,132,174,1.3045977011494252,0.04421797840187394,666,Let’s see if he can swim with one leg.”
358,1382,8,37,129,174,1.3045977011494252,0.041903547699243246,666,I'm not hungry. Are you?
387,1382,6,41,127,174,1.3045977011494252,0.04028679403566629,666,"I call it my ""Scenic Dinner Cruise"". I'm the cruise part."
444,1382,9,35,130,174,1.3045977011494252,0.042688969041639234,666,"I'm trying a new approach, because those suck-up dolphins aren't getting killed for their fins."
475,1382,9,35,130,174,1.3045977011494252,0.042688969041639234,666,"I swim carefully, but they rarely give me five stars."
462,1382,8,37,129,174,1.3045977011494252,0.041903547699243246,666,Some situations really test my decision to go vegan.
693,1382,7,39,128,174,1.3045977011494252,0.04110312082710357,666,The Twelve Apostles still think He can walk on water...
857,1382,13,27,134,174,1.3045977011494252,0.045695854845479666,666,He's my attorney
865,1382,5,43,126,174,1.3045977011494252,0.039453580390338694,666,I just don't have the heart to tell him he's in too deep.
964,1382,11,31,132,174,1.3045977011494252,0.04421797840187394,666,Something like this happens every time I try to quit.
1181,1428,14,42,174,230,1.3043478260869565,0.038159591174347966,666,"I'm gonna swish this guy right offa my fin, and send him on his way."""
461,1429,9,41,144,194,1.3041237113402062,0.039715046201601725,666,I find them really useful as bait.
1598,1430,9,37,135,181,1.3038674033149171,0.04156517762166635,666,Professional respect...he's a lawyer.
3748,1431,6,42,130,178,1.303370786516854,0.03968468109733341,666,Bite me in the snout next time I say work well with people.
1673,1432,9,32,124,165,1.303030303030303,0.04419288704814212,666,He says he's honoring me by 'standing on the shoulders of greatness.'
2640,1433,7,32,113,152,1.3026315789473684,0.044806498577351,666,Talk about white privilege.
26,1434,8,36,128,172,1.302325581395349,0.04216010142658346,666,"Yes, he's adopted. How did you know?"
1357,1434,15,22,135,172,1.302325581395349,0.047470731449286395,666,"White privilege, need I say more?"
3331,1434,9,34,129,172,1.302325581395349,0.0429589758758767,666,I'll take this half to go
5513,1434,8,36,128,172,1.302325581395349,0.04216010142658346,666,This intermittent fasting is killing me.
2279,1438,5,48,139,192,1.3020833333333333,0.037101271226784104,666,And they wonder why we attack.
1401,1439,9,31,123,163,1.3006134969325154,0.04449125800158343,666,Yes I’m giving him a ride. You’ve never heard of SCUBER?
3690,1440,13,29,141,183,1.3005464480874316,0.04399642738753328,666,"My ad was supposed to say ‘Wanted: Sucker Fish’, but in print it got cut off..."
745,1441,11,29,130,170,1.3,0.04481465873252761,666,"He Is Heavy, He Ain’t My Brother."
867,1441,9,33,128,170,1.3,0.04323339390753816,666,"He’s right on top of me, isn’t he?"
905,1441,5,41,124,170,1.3,0.03988322669578336,666,"No, I know he's there, but sometimes I just want to have to work for it."
995,1441,6,30,104,140,1.3,0.0461241900136937,666,Jump the shark?
1263,1441,6,39,125,170,1.3,0.04074660005376552,666,You’re holding up dinner.
1769,1441,10,31,129,170,1.3,0.04403112527563468,666,I can't.  We've bonded.
3542,1441,10,31,129,170,1.3,0.04403112527563468,666,He made a bet that he could walk on water. I get a cut if he wins.
2361,1441,11,29,130,170,1.3,0.04481465873252761,666,It really helps my back!
3028,1441,6,39,125,170,1.3,0.04074660005376552,666,"Yeah, I prefer wings."
3937,1441,11,29,130,170,1.3,0.04481465873252761,666,I hate being vegan....
4102,1441,9,33,128,170,1.3,0.04323339390753816,666,"You wanted the lower torso, right?"
4578,1441,8,35,127,170,1.3,0.04242066364980727,666,He's on Retainer.
4652,1441,8,35,127,170,1.3,0.04242066364980727,666,"It's a temporary symbiotic relationship; he likes to surf, I like to eat."
4704,1441,12,27,131,170,1.3,0.04558472640684806,666,Not happy about this gig economy I find myself in.
4840,1441,11,29,130,170,1.3,0.04481465873252761,666,I could be here a while. He’s reading the Mueller Report.
4943,1441,9,33,128,170,1.3,0.04323339390753816,666,I'm thinking of writing a country music song about it.
5238,1441,8,35,127,170,1.3,0.04242066364980727,666,I know this area is for members only--I'm about to take care of that.
5538,1441,11,29,130,170,1.3,0.04481465873252761,666,Legs or thighs?
5690,1441,8,35,127,170,1.3,0.04242066364980727,666,I love to watch their face when they slip
6256,1441,6,39,125,170,1.3,0.04074660005376552,666,"I have to swim constantly anyway, so really the new gig economy is working for me."
6273,1441,9,33,128,170,1.3,0.04323339390753816,666,He’s telling everyone that he’s a standup comic. Is there such a thing?
1976,1441,12,27,131,170,1.3,0.04558472640684806,666,"I know it’s a cliché, but yes, he’s a lawyer."
685,1441,6,39,125,170,1.3,0.04074660005376552,666,My therapist says I need to be less reactive.
23,1441,7,37,126,170,1.3,0.04159205525356738,666,I told you meeting Aquaman would be a disappointment.
4226,1465,11,34,142,187,1.2994652406417113,0.041957022885600576,666,"I know it's tempting, but I'm on this new gluten-free diet."
3779,1465,10,36,141,187,1.2994652406417113,0.04126609701868109,666,One lousy surfer and I get 300 hours of community service.
3644,1467,10,27,120,157,1.2993630573248407,0.04648775357524984,666,It's good for my core.
3258,1468,10,32,132,174,1.2988505747126438,0.043308373847682456,666,I'm about to give him a fish pedicure he won't ever forget.
5197,1469,6,38,124,168,1.2976190476190477,0.04098126646225077,666,He does not take advantage of me! It's a symbiotic relationship.
385,1469,9,32,127,168,1.2976190476190477,0.043512322382735856,666,It's rebranding - folks were starting to have a negative association with the fin.
512,1469,9,32,127,168,1.2976190476190477,0.043512322382735856,666,I just picked up dinner.
652,1469,6,38,124,168,1.2976190476190477,0.04098126646225077,666,The vet said I have to start lifting weights.
1060,1469,11,28,129,168,1.2976190476190477,0.04512088427766636,666,"Yeah, I'm doing a gig now for Uber Eats."
1071,1469,6,38,124,168,1.2976190476190477,0.04098126646225077,666,"It's symbiotic. He eases my back pain, and I don't eat him."
1919,1469,11,28,129,168,1.2976190476190477,0.04512088427766636,666,I just hate those skinny bones stuck in my throat.
2222,1469,8,34,126,168,1.2976190476190477,0.04268531597293645,666,"Some fins wrong. 
I'm just not sure what."
5098,1469,10,30,128,168,1.2976190476190477,0.04432390098545984,666,"Nah, it would be like shooting fish in a barrel."
6096,1469,8,34,126,168,1.2976190476190477,0.04268531597293645,666,Compliments of the Chef
2508,1469,9,32,127,168,1.2976190476190477,0.043512322382735856,666,I'm sick of shark week.
3486,1469,8,34,126,168,1.2976190476190477,0.04268531597293645,666,"I used to think ""When your a shark you're a shark all the way"", but now I dunno"
5834,1469,12,26,130,168,1.2976190476190477,0.045904032474590635,666,"If this doesn’t get us on the caption contest, I don’t know what will."
5410,1469,12,26,130,168,1.2976190476190477,0.045904032474590635,666,So I guess now I'm a HammerToe Shark?
5392,1469,11,28,129,168,1.2976190476190477,0.04512088427766636,666,I just love this place.  Every massage comes with a free meal.
5282,1469,10,30,128,168,1.2976190476190477,0.04432390098545984,666,It's a new ride share program called SCUBER.
2504,1485,9,32,128,169,1.2958579881656804,0.043289922033493675,666,They call it shark pilates.
5767,1486,6,35,118,159,1.2955974842767295,0.04237351316828499,666,But I can't do it.  He's so clueless and trusting.
1757,1487,8,28,113,149,1.2953020134228188,0.04616958199434513,666,We need a Jaws reboot to teach this generation some respect.
5002,1488,7,35,124,166,1.2951807228915662,0.04209559201874108,666,He says that if I support him it will improve our reputation.
6114,1488,6,37,123,166,1.2951807228915662,0.041219164441804415,666,Camouflage.
5864,1488,9,31,126,166,1.2951807228915662,0.043795862449138565,666,Weight-bearing exercise is super important as you get older.
3034,1488,11,27,128,166,1.2951807228915662,0.04543254635082028,666,Are you hungry for schmuck?
3305,1488,8,33,125,166,1.2951807228915662,0.042954140865998955,666,I'm no marine biologist but this doesn't feel like a sucker fish.
2107,1488,5,39,122,166,1.2951807228915662,0.040323692379948664,666,I feel like I forgot something...
896,1488,9,31,126,166,1.2951807228915662,0.043795862449138565,666,This will keep it fresh until we get home and eat.
6283,1488,5,39,122,166,1.2951807228915662,0.040323692379948664,666,I'm saving it for a snack attack.
5674,1488,7,35,124,166,1.2951807228915662,0.04209559201874108,666,That's when I get this sense of things being unreal and I feel detached from myself and I just don't know what to do.
4778,1497,10,28,125,163,1.294478527607362,0.04516501369728003,666,And I  had to pick this week to go vegan!
4796,1497,10,28,125,163,1.294478527607362,0.04516501369728003,666,Do you ever feel like the man is holding you down?
5708,1497,9,30,124,163,1.294478527607362,0.044318597679039465,666,"I know, I know; but he said 
he could get me on ‘Shark Tank’!"
2643,1497,7,34,122,163,1.294478527607362,0.042575314163946,666,I’ve taken a job with Lyft!
2661,1497,11,26,126,163,1.294478527607362,0.045995856599420154,666,"I know, but he's nice and I'm so done with being dangerous."
1848,1497,10,28,125,163,1.294478527607362,0.04516501369728003,666,You got some food on your face.
1487,1497,10,28,125,163,1.294478527607362,0.04516501369728003,666,"Humans, always looking out for danger when it's right under their feet."
1217,1497,12,24,127,163,1.294478527607362,0.0468119555920638,666,Stop judging my taste in symbiotic relationships!
460,1497,8,32,123,163,1.294478527607362,0.04345569856989565,666,When should we tell him that he's not on a sandbar?
188,1497,8,32,123,163,1.294478527607362,0.04345569856989565,666,"He tells everyone he's the ""great white one""."
2746,1497,10,28,125,163,1.294478527607362,0.04516501369728003,666,Global warming is bringing them out earlier in the season.
3290,1497,9,30,124,163,1.294478527607362,0.044318597679039465,666,"So, I get this sonar call, I show up at some spot, someone climbs aboard and off we go."
3246,1497,9,30,124,163,1.294478527607362,0.044318597679039465,666,God is great.  God is good.  Let us thank him for this food.
2006,1510,10,33,137,180,1.2944444444444445,0.04220580228924804,666,You should see him from the waist up.
3221,1511,10,35,142,187,1.2941176470588236,0.04112427588048697,666,Grab one and make a wish.
1922,1511,9,27,117,153,1.2941176470588236,0.046258677391591126,666,"To combat our bad reputation, I thought I'd try the eco-tourism angle."
324,1511,11,28,131,170,1.2941176470588236,0.04465675942615504,666,Ashiatsu. Works out my aggressions.
521,1514,7,35,125,167,1.2934131736526946,0.04188007969615104,666,"Since I started seeing him three times a week, my neck is 100% better."
1473,1514,10,29,128,167,1.2934131736526946,0.04438891388662403,666,I don't have the heart to tell the guy that he's no longer standing on a sandbar.
1474,1514,8,33,126,167,1.2934131736526946,0.042732726829078936,666,"Okay, yes I'm using a decoy. Some of us are not as fast as we used to be."
2806,1514,9,31,127,167,1.2934131736526946,0.043568690698039154,666,No kidding? I've never tried shiatsu.
3642,1514,10,29,128,167,1.2934131736526946,0.04438891388662403,666,Too skinny. I’m gonna throw this one back.
3810,1514,10,29,128,167,1.2934131736526946,0.04438891388662403,666,Yeah Jack. All they see from shore is a guy bobbing around having fun. It's my sure-fire meal ticket!
5026,1514,13,23,131,167,1.2934131736526946,0.04676334330126842,666,Here you go. Thanks for calling GrubHub.
5121,1514,11,27,129,167,1.2934131736526946,0.045194253428138896,666,"He’s my emotional support pet, or if that doesn’t help, a midday snack."
6188,1514,10,29,128,167,1.2934131736526946,0.04438891388662403,666,Hungry? I just ate his other half.
4543,1523,7,39,135,181,1.292817679558011,0.039750859696826096,666,More effective than hot rocks and tastes better too.
2306,1524,7,34,123,164,1.2926829268292683,0.042352992580866784,666,He thinks he is standing on the bottom.  Watch this!
4765,1524,9,30,125,164,1.2926829268292683,0.04408411708007125,666,Shark surfing is trending.  You free for dinner?
1853,1524,14,20,130,164,1.2926829268292683,0.04814034559665739,666,He wants me to swim near the surface so he can impress some chick Mary Magdalene...
1736,1524,7,34,123,164,1.2926829268292683,0.042352992580866784,666,I ate his surfboard. Now what?
1699,1524,9,30,125,164,1.2926829268292683,0.04408411708007125,666,"One leg, his Instagram goes viral, and I'm the bad guy."
1567,1524,8,32,124,164,1.2926829268292683,0.04322722151193844,666,He keeps calling me Flipper. I'm playing along until lunchtime.
1504,1524,5,38,121,164,1.2926829268292683,0.04054802809484679,666,I picked up dinner on the way home.
1325,1524,7,34,123,164,1.2926829268292683,0.042352992580866784,666,Dinner is served Madam.
1316,1524,6,36,122,164,1.2926829268292683,0.04146033383208245,666,Works great for my sciatica.
1120,1524,9,30,125,164,1.2926829268292683,0.04408411708007125,666,I'm saving this half for brunch.
4650,1524,10,28,126,164,1.2926829268292683,0.04492467114867582,666,I think they’re taking this “apex predator” thing a little too far.
2046,1524,5,38,121,164,1.2926829268292683,0.04054802809484679,666,"This is why I don't come to New York anymore, it's just not a challenge here."
2374,1524,9,30,125,164,1.2926829268292683,0.04408411708007125,666,"The ones trying to swim with us are a little more satisfying. 
Less fat, more filling."
2478,1524,9,30,125,164,1.2926829268292683,0.04408411708007125,666,I brought home takeout.
3993,1524,7,34,123,164,1.2926829268292683,0.042352992580866784,666,You wanna take him for a while. I gotta keep movin’.
3963,1524,11,26,127,164,1.2926829268292683,0.045749784446529385,666,"Ok fine, as long as it won’t spoil your dinner."
3872,1524,5,38,121,164,1.2926829268292683,0.04054802809484679,666,"I'm not holding him up, he thinks he's holding me down."
4051,1524,6,36,122,164,1.2926829268292683,0.04146033383208245,666,I thought you said it was a potluck.
3709,1524,5,38,121,164,1.2926829268292683,0.04054802809484679,666,"I’d dump him, but turns out he does wonders for my sciatica."
4110,1524,10,28,126,164,1.2926829268292683,0.04492467114867582,666,I didn’t have a choice - I ate his surfboard!
3584,1524,8,32,124,164,1.2926829268292683,0.04322722151193844,666,"After he  gives me shiatsu, I'm giving him a pedicure."
3551,1524,10,28,126,164,1.2926829268292683,0.04492467114867582,666,I knew I it was a mistake to go Vegan.
3375,1524,11,26,127,164,1.2926829268292683,0.045749784446529385,666,"AND TODAY'S SPECIAL APPETIZER,,HOMME."
3347,1524,7,34,123,164,1.2926829268292683,0.042352992580866784,666,Please don't eat him. My back has never felt so good.
3307,1524,7,34,123,164,1.2926829268292683,0.042352992580866784,666,"I tried being nice to him for once, and now he won't leave me alone."
3280,1524,7,34,123,164,1.2926829268292683,0.042352992580866784,666,He thinks he's standing on the bottom.  We can dine when the others arrive.
3084,1524,7,34,123,164,1.2926829268292683,0.042352992580866784,666,port-a-snack
2915,1524,11,26,127,164,1.2926829268292683,0.045749784446529385,666,I have to digest his surfboard before I eat him.
4127,1524,8,32,124,164,1.2926829268292683,0.04322722151193844,666,I'm his Uber diver.
4316,1524,8,32,124,164,1.2926829268292683,0.04322722151193844,666,He's a cousin of ours - a loan shark.
2642,1524,5,38,121,164,1.2926829268292683,0.04054802809484679,666,I don’t have the heart to tell him.
2611,1524,4,40,120,164,1.2926829268292683,0.03961471801355208,666,It's just easier than carrying a lunch sack.
2509,1524,11,26,127,164,1.2926829268292683,0.045749784446529385,666,Back off -- where are we gonna find another chiropractor?
1110,1524,9,30,125,164,1.2926829268292683,0.04408411708007125,666,I didn't believe in chiropractors either.
4903,1524,2,44,118,164,1.2926829268292683,0.03767880684308854,666,Isn't this what you wanted for dinner?
318,1524,9,30,125,164,1.2926829268292683,0.04408411708007125,666,Time to let him know I'm not a dolphin.
1002,1524,9,30,125,164,1.2926829268292683,0.04408411708007125,666,Don’t judge me. I think we can make this relationship work.
6235,1524,12,24,128,164,1.2926829268292683,0.0465602778770825,666,One more lawyer joke and he’s toast.
6128,1524,11,26,127,164,1.2926829268292683,0.045749784446529385,666,"On the count of three, let’s grab lunch."
6020,1524,4,40,120,164,1.2926829268292683,0.03961471801355208,666,"Go ahead, I had a late lunch."
5910,1524,7,34,123,164,1.2926829268292683,0.042352992580866784,666,I know I look funny but you wouldn't believe the reception.
5866,1524,7,34,123,164,1.2926829268292683,0.042352992580866784,666,"Well, Darren, maybe this is my happy place."
5709,1524,11,26,127,164,1.2926829268292683,0.045749784446529385,666,I'm bringing the food. Did you get the drinks?
5693,1524,11,26,127,164,1.2926829268292683,0.045749784446529385,666,Should I let him finish his hot dog first?
5627,1524,6,36,122,164,1.2926829268292683,0.04146033383208245,666,"He’s afraid of water over his head.  Sharks, not so much."
4960,1524,4,40,120,164,1.2926829268292683,0.03961471801355208,666,"When you said ""meet me at noon"" I didn't realize it was for lunch."
5548,1524,8,32,124,164,1.2926829268292683,0.04322722151193844,666,I'm just giving him a lift before I have a bite to eat.
5465,1524,12,24,128,164,1.2926829268292683,0.0465602778770825,666,You can have the first bite.
5290,1524,10,28,126,164,1.2926829268292683,0.04492467114867582,666,I carry my lunch.
4015,1524,10,28,126,164,1.2926829268292683,0.04492467114867582,666,This guy just won't get off my back - can you give him a scare?
788,1524,9,30,125,164,1.2926829268292683,0.04408411708007125,666,"Eat this guy, will ya.  I can't shake him."
5181,1524,8,32,124,164,1.2926829268292683,0.04322722151193844,666,I’m stuffed. Would you like the other half?
913,1524,9,30,125,164,1.2926829268292683,0.04408411708007125,666,The worst part is his feet smell.
4992,1524,6,36,122,164,1.2926829268292683,0.04146033383208245,666,I like to play with my food before eating it.
46,1524,11,26,127,164,1.2926829268292683,0.045749784446529385,666,On 3. 1...2...
71,1524,10,28,126,164,1.2926829268292683,0.04492467114867582,666,Its something called ride sharing.
103,1524,11,26,127,164,1.2926829268292683,0.045749784446529385,666,The surfboard was very filling.
4013,1524,8,32,124,164,1.2926829268292683,0.04322722151193844,666,He's the best ashiatsu massage therapist outside of Cancun.
531,1524,10,28,126,164,1.2926829268292683,0.04492467114867582,666,How long have you been an Uber Shark?
729,1524,9,30,125,164,1.2926829268292683,0.04408411708007125,666,I don’t get it.  This massage thing is just not what it’s cracked up to be.
5271,1524,7,34,123,164,1.2926829268292683,0.042352992580866784,666,Will you get this guy off my back please?
1049,1585,8,36,134,178,1.2921348314606742,0.04094089112198094,666,Drumstick?
1786,1586,7,33,121,161,1.2919254658385093,0.042841386967846944,666,I think he’s got a career in stand-up.
1747,1586,10,27,124,161,1.2919254658385093,0.045478606970609715,666,Don’t knock it. I’m getting 60 bucks an hour as a powered surfboard.
1713,1586,6,35,120,161,1.2919254658385093,0.041925465838509306,666,"Some of these guys, it's like they don't even want to be eaten!"
1636,1586,4,39,118,161,1.2919254658385093,0.04003080292312934,666,It’s called shark boarding but it isn’t catching on.
1631,1586,10,27,124,161,1.2919254658385093,0.045478606970609715,666,"Lawyers are taking this professional-courtesy thing to a whole other level."""
1437,1586,10,27,124,161,1.2919254658385093,0.045478606970609715,666,"It's symbiotic, he's promised not to turn my fins into soup."
1431,1586,9,29,123,161,1.2919254658385093,0.04461685713308811,666,He's gonna have to get a bigger shark.
1406,1586,9,29,123,161,1.2919254658385093,0.04461685713308811,666,The worst part is that he keeps repeating that ridiculous song.
1893,1586,12,23,126,161,1.2919254658385093,0.04715488516678607,666,It's a long story.
1867,1586,8,31,122,161,1.2919254658385093,0.04373813197750449,666,And you get a snack after the back rub.
6136,1586,8,31,122,161,1.2919254658385093,0.04373813197750449,666,I hate it when the old Sea World training kicks in.
2292,1586,10,27,124,161,1.2919254658385093,0.045478606970609715,666,I had to go and attack a damn lawyer!
5818,1586,9,29,123,161,1.2919254658385093,0.04461685713308811,666,"Packing my own lunch is a chore, but nothing beats eating locals."
5775,1586,8,31,122,161,1.2919254658385093,0.04373813197750449,666,These millennial snorkelers are awfully entitled.
5764,1586,6,35,120,161,1.2919254658385093,0.041925465838509306,666,"That's the deal: I let him take a selfie surfing a shark, and he lets me eat him with no fuss"
5759,1586,6,35,120,161,1.2919254658385093,0.041925465838509306,666,"I just like the way it feels, okay ?"
5742,1586,7,33,121,161,1.2919254658385093,0.042841386967846944,666,“He sure as hell stuck the landing!”
5510,1586,11,25,125,161,1.2919254658385093,0.04632432885147918,666,"Don't judge me, bro... everyone's side gig is Uber"
5317,1586,6,35,120,161,1.2919254658385093,0.041925465838509306,666,"I know, but they're even more delicious if they bake in the sun for a few minutes until they're well done."
5254,1586,9,29,123,161,1.2919254658385093,0.04461685713308811,666,Did you order Grubhub?
5185,1586,7,33,121,161,1.2919254658385093,0.042841386967846944,666,He thinks I'm a sandbar and it would be awkward to move now.
5029,1586,11,25,125,161,1.2919254658385093,0.04632432885147918,666,Hungry for some surf 'n' turf?
4766,1586,6,35,120,161,1.2919254658385093,0.041925465838509306,666,"It just pee`d on me. 
What do I do?
WHAT DO I DO?!"
4565,1586,9,29,123,161,1.2919254658385093,0.04461685713308811,666,This all started with those @#&* dolphins.
4511,1586,7,33,121,161,1.2919254658385093,0.042841386967846944,666,I ate his paddle board by mistake and now I feel sorry for him.
4356,1586,9,29,123,161,1.2919254658385093,0.04461685713308811,666,"You’ve never had a foot massage?  Oh, man, try it!"
2082,1586,9,29,123,161,1.2919254658385093,0.04461685713308811,666,He’s a Shark Fin Soup protestor!
4202,1586,13,21,127,161,1.2919254658385093,0.047971063638881054,666,"I know I said I'd be home an hour ago, but look -- I brought you my leftovers!"
3769,1586,13,21,127,161,1.2919254658385093,0.047971063638881054,666,They get a tad mealy if you just let 'em drown.
3753,1586,10,27,124,161,1.2919254658385093,0.045478606970609715,666,"The legs are enticing, but the massage is incredible."
3692,1586,14,19,128,161,1.2919254658385093,0.048773586070724496,666,Says he's a shark spotter
3428,1586,8,31,122,161,1.2919254658385093,0.04373813197750449,666,He said his name is Fonzie and he's just doing it for the ratings.
3252,1586,10,27,124,161,1.2919254658385093,0.045478606970609715,666,I'm picking up  a few extra bucks working for Uber.
2904,1586,7,33,121,161,1.2919254658385093,0.042841386967846944,666,It's my new diet.  You have to balance your food.
2883,1586,8,31,122,161,1.2919254658385093,0.04373813197750449,666,I think it's some kind of remora.  See if you can scrape it off me.
2879,1586,10,27,124,161,1.2919254658385093,0.045478606970609715,666,I Think I'm A Vegan.
2733,1586,7,33,121,161,1.2919254658385093,0.042841386967846944,666,"He’s already booked me for Shark Week. And, he thinks I could be the next Jaws! So no you may not eat him."
1311,1586,9,29,123,161,1.2919254658385093,0.04461685713308811,666,Do you want to break it to him...or should I?
2726,1586,10,27,124,161,1.2919254658385093,0.045478606970609715,666,"When did this become a ""thing""?"
2422,1586,11,25,125,161,1.2919254658385093,0.04632432885147918,666,"If you don’t tell him, I won’t tell him."
2313,1586,8,31,122,161,1.2919254658385093,0.04373813197750449,666,Predatory lending? I’m only charging 10% interest to keep this guy afloat.
2305,1586,7,33,121,161,1.2919254658385093,0.042841386967846944,666,I stopped biting people after my cardiologist suggested a plant-based diet.
3787,1586,8,31,122,161,1.2919254658385093,0.04373813197750449,666,I promised once more around before we eat him.
1069,1586,10,27,124,161,1.2919254658385093,0.045478606970609715,666,The lack of respect for the environment is getting out of control
2779,1586,9,29,123,161,1.2919254658385093,0.04461685713308811,666,"I lost his law suit, I gotta live with the shame."
736,1586,11,25,125,161,1.2919254658385093,0.04632432885147918,666,"Dinner, ma'am , freshly served."
34,1586,14,19,128,161,1.2919254658385093,0.048773586070724496,666,"It's BYOB, right?"
185,1586,7,33,121,161,1.2919254658385093,0.042841386967846944,666,Why does stupid taste so good?
249,1586,10,27,124,161,1.2919254658385093,0.045478606970609715,666,"Wow, the odds of being stepped on by a human is a million to one, we should play powerball this week."
383,1586,10,27,124,161,1.2919254658385093,0.045478606970609715,666,"Yeah, you just sign up through the ridesharing app."
891,1586,9,29,123,161,1.2919254658385093,0.04461685713308811,666,If he calls me Flipper one more time...
576,1586,8,31,122,161,1.2919254658385093,0.04373813197750449,666,"He's free-range, humanely raised, and non-GMO."
610,1586,8,31,122,161,1.2919254658385093,0.04373813197750449,666,"Look...I did not go vegan because it was going to be easy, Walter!"
631,1586,7,33,121,161,1.2919254658385093,0.042841386967846944,666,I know you told me not to give it a name...
4176,1640,7,35,126,168,1.2916666666666667,0.04166666666666666,666,It was a typo-the email said “shark attach”.
4047,1640,7,35,126,168,1.2916666666666667,0.04166666666666666,666,"Who takes ""Jumping the shark"" literally?"
4909,1640,5,32,107,144,1.2916666666666667,0.04393587720031666,666,"You've got to believe me,it's completely platonic."
1476,1643,10,21,110,141,1.2907801418439717,0.049862025529338536,666,'cuz you are what you eat
1496,1644,4,30,97,131,1.2900763358778626,0.045319443741206736,666,I think it helps our image.
1804,1645,11,33,146,190,1.2894736842105263,0.04124184344847057,666,We're bartering. I get a barefoot massage. He gets to swim back to shore.
4121,1646,11,24,124,159,1.2893081761006289,0.04665885721987165,666,“I know it’s a mannequin. I’m fishing for lifeguards.”
4029,1646,8,30,121,159,1.2893081761006289,0.0440251572327044,666,But I did get the better half!
4018,1646,6,34,119,159,1.2893081761006289,0.04217809238887326,666,"No, really! The guy in the white coat said  if I hold off for 15 minutes, I can have two."
4006,1646,7,32,120,159,1.2893081761006289,0.04311151787474359,666,It feels so good when he wiggles his toes.
3866,1646,8,30,121,159,1.2893081761006289,0.0440251572327044,666,Wanna see me flip him into my mouth whole? The look of fear and surprise is delightful.
3609,1646,9,28,122,159,1.2893081761006289,0.04492021777846088,666,"You've heard of the marshmallow test?  If I wait, a second one will come along and I can eat both of them."
3600,1646,10,26,123,159,1.2893081761006289,0.04579778882396355,666,So how do you like my new periscope?
3527,1646,10,26,123,159,1.2893081761006289,0.04579778882396355,666,"Yes, I am saving it for later."
3505,1646,7,32,120,159,1.2893081761006289,0.04311151787474359,666,I hate it when lawyers go on vacation and think they’re one of us.
4079,1646,7,32,120,159,1.2893081761006289,0.04311151787474359,666,I found him first.
4068,1646,12,22,125,159,1.2893081761006289,0.047504320361040596,666,I'm rethinking this Uber gig.
3156,1646,7,32,120,159,1.2893081761006289,0.04311151787474359,666,"Yes, Steve, I do know this looks bad, and no, I do not have a plan to resolve this amicably."
3144,1646,4,38,117,159,1.2893081761006289,0.04024634748352094,666,I’m lulling him into a false sense of security.
2158,1646,7,32,120,159,1.2893081761006289,0.04311151787474359,666,I find it much more convenient to pack a lunch.
2192,1646,9,28,122,159,1.2893081761006289,0.04492021777846088,666,"He doesn't believe me when I say, 'Get off my back.'"
2269,1646,8,30,121,159,1.2893081761006289,0.0440251572327044,666,It's supposed to be like goat yoga.
2722,1646,7,32,120,159,1.2893081761006289,0.04311151787474359,666,"Ah, ha, ha, I fooled you!   This is the bottom half of the guy I bit in two off Florida!"
2759,1646,8,30,121,159,1.2893081761006289,0.0440251572327044,666,A balanced diet is always best!
2784,1646,7,32,120,159,1.2893081761006289,0.04311151787474359,666,"Lenny, you do realize they can see through the tank... right?"
3269,1646,8,30,121,159,1.2893081761006289,0.0440251572327044,666,"Swimming with the sharks, he calls it. To think I left a good job at Sea World for this."
2818,1646,9,28,122,159,1.2893081761006289,0.04492021777846088,666,"Finders, keepers!"
3000,1646,7,32,120,159,1.2893081761006289,0.04311151787474359,666,It’s too easy!
3050,1646,8,30,121,159,1.2893081761006289,0.0440251572327044,666,"Yeah, I'm hungry... but where's the sport in it?"
3074,1646,8,30,121,159,1.2893081761006289,0.0440251572327044,666,He’s made no eye contact whatsoever and has been on the phone since he stepped off shore!
3087,1646,8,30,121,159,1.2893081761006289,0.0440251572327044,666,No thanks I have my own lunch.
3101,1646,9,28,122,159,1.2893081761006289,0.04492021777846088,666,"He knows it's dangerous, but sometimes the only way to keep your head above water is a loan shark."
3131,1646,9,28,122,159,1.2893081761006289,0.04492021777846088,666,Will you judge me if I drop him?
2953,1646,14,18,127,159,1.2893081761006289,0.04915163725415861,666,Wanna a Bite?
4239,1646,10,26,123,159,1.2893081761006289,0.04579778882396355,666,"For being a Shepard of the sea, Aquaman is kinda an ass"
4299,1646,11,24,124,159,1.2893081761006289,0.04665885721987165,666,I'm off probation after my community service hours are completed.
6174,1646,7,32,120,159,1.2893081761006289,0.04311151787474359,666,What about you? Ever wanted to try paddle boarding?
5685,1646,4,38,117,159,1.2893081761006289,0.04024634748352094,666,"It's called ""delayed gratification""."
5697,1646,10,26,123,159,1.2893081761006289,0.04579778882396355,666,It was either this or goat yoga.
5704,1646,8,30,121,159,1.2893081761006289,0.0440251572327044,666,I decided to go with Lyft.
5720,1646,7,32,120,159,1.2893081761006289,0.04311151787474359,666,"I had a big breakfast, but I'll be hungry again in an hour."
5779,1646,11,24,124,159,1.2893081761006289,0.04665885721987165,666,Looks like someone is getting excited for People Week...
5880,1646,10,26,123,159,1.2893081761006289,0.04579778882396355,666,"No, Frank, you can't ""borrow"" my emotional support animal."
5646,1646,7,32,120,159,1.2893081761006289,0.04311151787474359,666,"Please don’t eat my therapy human this time, Steve."
5900,1646,9,28,122,159,1.2893081761006289,0.04492021777846088,666,"If I hear ""nice hat!"" one more time..."
5959,1646,10,26,123,159,1.2893081761006289,0.04579778882396355,666,I owe him. I ate his ex-wife.
6051,1646,7,32,120,159,1.2893081761006289,0.04311151787474359,666,Airbnb. The wife's idea.
6064,1646,6,34,119,159,1.2893081761006289,0.04217809238887326,666,"If he thinks he’s on a surfboard, he’s in for a big surprise!!"
6075,1646,8,30,121,159,1.2893081761006289,0.0440251572327044,666,"We're a duo - I've got the fins, he's got the shins...
for now."
6156,1646,7,32,120,159,1.2893081761006289,0.04311151787474359,666,Because they taste better when they're really fresh.
6194,1646,7,32,120,159,1.2893081761006289,0.04311151787474359,666,Working for Uber Eats has really helped pay down my student loan debt.
5950,1646,13,20,126,159,1.2893081761006289,0.04833499714352308,666,I think of it as the massage lunch package.
5598,1646,9,28,122,159,1.2893081761006289,0.04492021777846088,666,Snack time!  Ready?  on 1...2...3!
5595,1646,8,30,121,159,1.2893081761006289,0.0440251572327044,666,You know the one about the scorpion and the frog?
5352,1646,11,24,124,159,1.2893081761006289,0.04665885721987165,666,I was told it was potluck.
4335,1646,7,32,120,159,1.2893081761006289,0.04311151787474359,666,And the bottom half makes a one-of-a-kind hat.
4366,1646,9,28,122,159,1.2893081761006289,0.04492021777846088,666,Your order is here.
2134,1646,8,30,121,159,1.2893081761006289,0.0440251572327044,666,Get ready.  These decoys really draw them in.
4656,1646,9,28,122,159,1.2893081761006289,0.04492021777846088,666,If I don't carry a snack for the kids I can't even get them out of the bay
4672,1646,7,32,120,159,1.2893081761006289,0.04311151787474359,666,It is proprietary. I think this idea has legs.
4707,1646,10,26,123,159,1.2893081761006289,0.04579778882396355,666,"Morty, be honest.... does this pair of human legs make me look fat?"
4745,1646,8,30,121,159,1.2893081761006289,0.0440251572327044,666,Don’t ask. It’s Brexit.
4783,1646,10,26,123,159,1.2893081761006289,0.04579778882396355,666,Marco?
4821,1646,8,30,121,159,1.2893081761006289,0.0440251572327044,666,"You're about to witness, ""The Ultimate Wedgie!"""
4974,1646,6,34,119,159,1.2893081761006289,0.04217809238887326,666,He's not heavy. He's my brother up the food chain.
5100,1646,11,24,124,159,1.2893081761006289,0.04665885721987165,666,I have a family to feed.
5127,1646,12,22,125,159,1.2893081761006289,0.047504320361040596,666,"I had the top half for lunch, the bottom half I'm saving for supper."
5149,1646,7,32,120,159,1.2893081761006289,0.04311151787474359,666,"Not only that, he's spinning a hula hoop."
5221,1646,9,28,122,159,1.2893081761006289,0.04492021777846088,666,Cirque de Soleil. Avoid 'em--it's like chewing on a broomstick.
5283,1646,7,32,120,159,1.2893081761006289,0.04311151787474359,666,"Our deal is that he scratches my back, and I don't scratch his."
4298,1646,7,32,120,159,1.2893081761006289,0.04311151787474359,666,I might as well come out and admit it. I feel that I 'm a dolphin.
4505,1646,9,28,122,159,1.2893081761006289,0.04492021777846088,666,"Apparently this is an example of what is known as ""Florida Man""."
2087,1646,4,38,117,159,1.2893081761006289,0.04024634748352094,666,My chiropractor says this helps.
1998,1646,7,32,120,159,1.2893081761006289,0.04311151787474359,666,"Well, I say just because I'm a sand shark doesn't mean you can walk all over me!"
498,1646,9,28,122,159,1.2893081761006289,0.04492021777846088,666,This is my friend Larry. He’s not much of a swimmer.”
770,1646,6,34,119,159,1.2893081761006289,0.04217809238887326,666,Say what you will about chiropractors...
455,1646,8,30,121,159,1.2893081761006289,0.0440251572327044,666,He thinks I am an Uber
396,1646,8,30,121,159,1.2893081761006289,0.0440251572327044,666,Just toying with him before my dinner
954,1646,6,34,119,159,1.2893081761006289,0.04217809238887326,666,"My shrink is calling it ""exposure therapy""."
1009,1646,8,30,121,159,1.2893081761006289,0.0440251572327044,666,Give these humans an inch and they walk all over you.
1033,1646,6,34,119,159,1.2893081761006289,0.04217809238887326,666,We're both vegan.
1034,1646,12,22,125,159,1.2893081761006289,0.047504320361040596,666,He thinks he's safe on a rock; I'm saving him for our family frenzy at suppertime.
1075,1646,8,30,121,159,1.2893081761006289,0.0440251572327044,666,"Yeah, it's kinda like uber."
1227,1646,6,34,119,159,1.2893081761006289,0.04217809238887326,666,"So then he looks at his cellphone and says, ""You must be my Uber Fish."""
1337,1646,6,34,119,159,1.2893081761006289,0.04217809238887326,666,"Got drunk, lost a bet, its hell..."
380,1646,6,34,119,159,1.2893081761006289,0.04217809238887326,666,I ordered it to go.
1524,1646,10,26,123,159,1.2893081761006289,0.04579778882396355,666,"He calls himself the ""Shark Whisperer"".  I'm going to wait until there's a huge crowd and then I'll rip him to shreds."
1560,1646,5,36,118,159,1.2893081761006289,0.0412235367437623,666,I know ... But I like ... how he rubs my neck ...
171,1646,9,28,122,159,1.2893081761006289,0.04492021777846088,666,Tell them you're a vegetarian and they think they can walk all over you.
1580,1646,11,24,124,159,1.2893081761006289,0.04665885721987165,666,"Yes, Modell, I am going to eat it. If you want a piece, just ask!"
1697,1646,11,24,124,159,1.2893081761006289,0.04665885721987165,666,Did you order the thighs?
1850,1646,8,30,121,159,1.2893081761006289,0.0440251572327044,666,It started out as a rash.
1864,1646,7,32,120,159,1.2893081761006289,0.04311151787474359,666,I’m working on my instant gratification issues
1970,1646,6,34,119,159,1.2893081761006289,0.04217809238887326,666,I’m starting to rethink my “friends not food” mantra.
1984,1646,6,34,119,159,1.2893081761006289,0.04217809238887326,666,"I know, but he satisfies an itch."
608,1646,6,34,119,159,1.2893081761006289,0.04217809238887326,666,I told you that it was all over when they started with that swimming with the dolphins thing.
570,1646,5,36,118,159,1.2893081761006289,0.0412235367437623,666,Are you sick of white meat?
1336,1737,11,28,134,173,1.2890173410404624,0.043977660004968416,666,"He's my brother-in-law. I tried to talk her out of it, but she said I was exhibiting a species bias."
2701,1738,11,20,115,146,1.2876712328767124,0.04952195097813759,666,I’m codependent...
6185,1739,9,28,123,160,1.2875,0.04467519044737731,666,One day we’re going to look back at this and laugh.
1133,1739,5,36,119,160,1.2875,0.04100496595175274,666,Welcome to Sea World.
848,1741,11,28,135,174,1.2873563218390804,0.043755722846009815,666,I wish he'd stuck with goat yoga.
5409,1741,10,30,134,174,1.2873563218390804,0.04298979546033624,666,"Actually, I think I prefer Rolfing."
2283,1743,6,33,118,157,1.286624203821656,0.042434254624546065,666,"I’ve turned the page, Jeff, and now think of them as family."
558,1743,7,31,119,157,1.286624203821656,0.04338577281631521,666,Tell me I’m not hallucinating.
353,1743,6,33,118,157,1.286624203821656,0.042434254624546065,666,I figured I'd give him a false sense of security.
248,1743,10,25,122,157,1.286624203821656,0.04612269761032238,666,What odd growth? I don’t feel anything.
6073,1743,7,31,119,157,1.286624203821656,0.04338577281631521,666,First I must gain his trust.
3214,1743,9,27,121,157,1.286624203821656,0.04522879522522273,666,I mistakenly ate his board. A ride is the least I can do...
3009,1743,7,31,119,157,1.286624203821656,0.04338577281631521,666,"Yup. I know... ""shark boarding"". What's next?"
1965,1743,12,21,124,157,1.286624203821656,0.0478604415933394,666,"When I'm through playing, would you like breast or thigh?"
200,1743,4,37,116,157,1.286624203821656,0.040464148710736454,666,I don't enjoy this whole 'let's change our image' thing.
6195,1743,10,25,122,157,1.286624203821656,0.04612269761032238,666,The gig economy has its ups and downs.
2199,1743,7,31,119,157,1.286624203821656,0.04338577281631521,666,"I know what it looks like, but it’s been great for my back pain!"
6259,1743,8,29,120,157,1.286624203821656,0.044316865866135244,666,Hold still. The wife is meatier.
2841,1743,6,33,118,157,1.286624203821656,0.042434254624546065,666,I hear it’s good for your core.
1831,1743,6,33,118,157,1.286624203821656,0.042434254624546065,666,Looks like they're making another Happy Days spin-off
2799,1743,9,27,121,157,1.286624203821656,0.04522879522522273,666,"Animal, vegetable, or optometrist?"
2581,1743,9,27,121,157,1.286624203821656,0.04522879522522273,666,You call Uber eats?
2578,1743,8,29,120,157,1.286624203821656,0.044316865866135244,666,Next time you troll the bait.
1972,1743,8,29,120,157,1.286624203821656,0.044316865866135244,666,Why not?  He gives a great back massage.
203,1743,6,33,118,157,1.286624203821656,0.042434254624546065,666,Please don't eat my massage therapist!
2554,1743,7,31,119,157,1.286624203821656,0.04338577281631521,666,"Get ready.  I heard him call out ""C'mon everybody.  The water feels great!"""
2501,1743,10,25,122,157,1.286624203821656,0.04612269761032238,666,It's my community service and its killing me.
2453,1743,12,21,124,157,1.286624203821656,0.0478604415933394,666,My Chiropractor said it's good for the Cartilage
2157,1743,11,23,123,157,1.286624203821656,0.046999601617262084,666,How do I get this monkey off my back?
3394,1743,7,31,119,157,1.286624203821656,0.04338577281631521,666,"No, I'm on this 30 day cleanse now."
863,1743,7,31,119,157,1.286624203821656,0.04338577281631521,666,Do you prefer him over easy or sunny-side up?
3675,1743,4,37,116,157,1.286624203821656,0.040464148710736454,666,"We made a deal.....I get a back rub, and he gets to live."
762,1743,6,33,118,157,1.286624203821656,0.042434254624546065,666,It's part of my community service for that incident last summer.
901,1743,6,33,118,157,1.286624203821656,0.042434254624546065,666,I’m more of a leg and butt shark.
1007,1743,8,29,120,157,1.286624203821656,0.044316865866135244,666,It's the lack of respect that bothers me most.
1581,1743,5,35,117,157,1.286624203821656,0.041460905057809604,666,He's mine... I'm taking him for a ride.
1512,1743,8,29,120,157,1.286624203821656,0.044316865866135244,666,Please tell me you like white meat.
1696,1743,8,29,120,157,1.286624203821656,0.044316865866135244,666,"he's telling them all to come on in, I'm serving in 5 minutes."
1723,1743,7,31,119,157,1.286624203821656,0.04338577281631521,666,"It’s leftovers, I ate the other half last night."
5461,1743,8,29,120,157,1.286624203821656,0.044316865866135244,666,I told you not to eat that surfboard
5457,1743,11,23,123,157,1.286624203821656,0.046999601617262084,666,They’re treading a fin line.
5169,1743,9,27,121,157,1.286624203821656,0.04522879522522273,666,Another consequence of global warming:  a dorsal Finn.
5140,1743,9,27,121,157,1.286624203821656,0.04522879522522273,666,Who’s gonna tell him?
802,1743,9,27,121,157,1.286624203821656,0.04522879522522273,666,Welcome to Sea World. It will all make sense after a while.
5087,1743,10,25,122,157,1.286624203821656,0.04612269761032238,666,... because he thinks I'm a dolphin. You hungry?
1244,1743,8,29,120,157,1.286624203821656,0.044316865866135244,666,I'm not very hungry.
1795,1743,9,27,121,157,1.286624203821656,0.04522879522522273,666,"You always say  “save the leftovers “, but you never eat ‘em..."
4698,1743,6,33,118,157,1.286624203821656,0.042434254624546065,666,I'm stuffed. You want leftovers?
758,1743,5,35,117,157,1.286624203821656,0.041460905057809604,666,"Here's your dinner dear.
 You did say you wanted white meat meat, right?"
4507,1743,8,29,120,157,1.286624203821656,0.044316865866135244,666,Can we get fined for chumming?
5873,1743,4,37,116,157,1.286624203821656,0.040464148710736454,666,"I wasn't really hungry when I found him, so I figure I'll save him for later."
753,1743,9,27,121,157,1.286624203821656,0.04522879522522273,666,Go ahead. Dare him to hang ten.
4246,1743,8,29,120,157,1.286624203821656,0.044316865866135244,666,Manna from heaven.
611,1743,10,25,122,157,1.286624203821656,0.04612269761032238,666,These young kids have never even heard of Jaws.
4213,1743,8,29,120,157,1.286624203821656,0.044316865866135244,666,Of course he's an attorney.
3757,1743,10,25,122,157,1.286624203821656,0.04612269761032238,666,Professional courtesy. He’s a member of the bar.
5071,1743,6,33,118,157,1.286624203821656,0.042434254624546065,666,Your delivery of a gluten free dinner
3461,1743,8,29,120,157,1.286624203821656,0.044316865866135244,666,I had a big breakfast.
5702,1743,9,27,121,157,1.286624203821656,0.04522879522522273,666,This new workplace tolerance training is so humiliating.
178,1743,7,31,119,157,1.286624203821656,0.04338577281631521,666,"I feel sorry for him, he can't swim!"
5537,1743,6,33,118,157,1.286624203821656,0.042434254624546065,666,I'm gonna count to three...
2650,1798,8,31,125,164,1.2865853658536586,0.04304478831253317,666,It’s from that new take-out place down the beach. I’ll let you know later if it lives up to the buzz.
2288,1798,5,37,122,164,1.2865853658536586,0.040353484404808015,666,I picked up lunch for you
5329,1798,9,29,126,164,1.2865853658536586,0.043905244560963654,666,"I told him that if he doesn’t get off my back, I’m going to eat him.  But I didn’t tell him that I’m going to him anyway."
3414,1801,7,30,117,154,1.2857142857142858,0.0439094972056236,666,Do me a favor and eat this guy off my back
3498,1801,7,30,117,154,1.2857142857142858,0.0439094972056236,666,"Yeah, well, you should see his other half. Course, you can't."
3539,1801,7,30,117,154,1.2857142857142858,0.0439094972056236,666,"I know; I'm an embarrassment to my species"""
3746,1801,6,32,116,154,1.2857142857142858,0.04293205686927954,666,"Hey, honey. Want to split a dessert?"
3828,1801,9,26,119,154,1.2857142857142858,0.045801842981455405,666,It's either this or extinction.
3892,1801,5,34,115,154,1.2857142857142858,0.041931838371378836,666,"Oh
I thought it was a potluck!"
3981,1801,4,36,114,154,1.2857142857142858,0.04090717090413152,666,"I know this looks bad, but I'm just not hungry, okay?"
4138,1801,10,24,120,154,1.2857142857142858,0.04671928144055204,666,So... What do you think?  Should we get him now or save him for later?
4140,1801,5,34,115,154,1.2857142857142858,0.041931838371378836,666,It's the latest thing in evolution - my own decoy!
199,1801,10,24,120,154,1.2857142857142858,0.04671928144055204,666,Free delivery!
4436,1801,9,26,119,154,1.2857142857142858,0.045801842981455405,666,"I'm only eating locally sourced. This guy was flown in from DesMoines."""
4643,1801,8,24,108,140,1.2857142857142858,0.04785825496092456,666,"Until Shark Week starts filming again, I have to make ends meet by providing ride-sharing for swimmers."
4982,1801,6,32,116,154,1.2857142857142858,0.04293205686927954,666,You know what’s been on my mind lately?
5187,1801,7,30,117,154,1.2857142857142858,0.0439094972056236,666,I like to save the bottom half for dessert.
5251,1801,9,26,119,154,1.2857142857142858,0.045801842981455405,666,"I've got the entree"""
5470,1801,7,30,117,154,1.2857142857142858,0.0439094972056236,666,"""The dolphin mask worked like a charm."""
5778,1801,8,28,118,154,1.2857142857142858,0.044865648136121705,666,I was told to bring lunch.
5894,1801,8,28,118,154,1.2857142857142858,0.044865648136121705,666,This guy walks on my back every Wednesday. Does wonders for my sciatica.
6004,1801,6,32,116,154,1.2857142857142858,0.04293205686927954,666,"I hope you didn't cook, I brought take-out.""

David and Miriam, Pacifica, C"
6305,1801,8,28,118,154,1.2857142857142858,0.044865648136121705,666,I just can't shake this funny feeling.
5020,1801,6,36,126,168,1.2857142857142858,0.040617258660421936,666,Lyft was hiring. I needed money. Don't mess this up for me.
4365,1801,9,26,119,154,1.2857142857142858,0.045801842981455405,666,I was going to eat him but my back is really feeling the benefit.
4217,1801,8,28,118,154,1.2857142857142858,0.044865648136121705,666,I'm so full. Do you want the bottom half?
3068,1801,9,26,119,154,1.2857142857142858,0.045801842981455405,666,He failed to jump the shark.
2846,1801,9,26,119,154,1.2857142857142858,0.045801842981455405,666,I was full; I'm planning to finish it later on.
437,1801,3,38,113,154,1.2857142857142858,0.03985616882687308,666,I'm saving him for dinner.
507,1801,8,28,118,154,1.2857142857142858,0.044865648136121705,666,What? Do I have food on my face?
632,1801,8,28,118,154,1.2857142857142858,0.044865648136121705,666,I am bringing supper over to the new shark family that just moved in across the bay
638,1801,6,32,116,154,1.2857142857142858,0.04293205686927954,666,I'm tired of going around with a Chip on my shoulder.
697,1801,5,34,115,154,1.2857142857142858,0.041931838371378836,666,"I know it’s cliché, Gary, but I think it gives me an edge with the girls."
897,1801,5,34,115,154,1.2857142857142858,0.041931838371378836,666,I'm saving this half for lunch tomorrow.
936,1801,5,34,115,154,1.2857142857142858,0.041931838371378836,666,He thinks he's on a sandbar. Watch me introduce some sharp shells.
948,1801,4,36,114,154,1.2857142857142858,0.04090717090413152,666,I have an appointment with the doctor this week to get it removed.
1206,1801,9,26,119,154,1.2857142857142858,0.045801842981455405,666,Some guy named Steven Spielberg.
1234,1801,4,36,114,154,1.2857142857142858,0.04090717090413152,666,"I ate this guy's surfboard, now I have to do this for 2 weeks."
1378,1801,7,26,107,140,1.2857142857142858,0.046772188798323865,666,"I don't care which cultures still eat our fins, I'm not gonna racially profile this guy!"
1464,1801,7,30,117,154,1.2857142857142858,0.0439094972056236,666,He insists; just because I ate his surfboard by mistake.
1659,1801,6,32,116,154,1.2857142857142858,0.04293205686927954,666,They call it shark surfing.  I call it playing with my food.
1767,1801,9,26,119,154,1.2857142857142858,0.045801842981455405,666,No one told me becoming vegan would lead to this!
2060,1801,7,30,117,154,1.2857142857142858,0.0439094972056236,666,It’s the takeout half off meal deal.
105,1801,7,30,117,154,1.2857142857142858,0.0439094972056236,666,"No, it's not like shooting fish in a barrel."
2094,1801,8,28,118,154,1.2857142857142858,0.044865648136121705,666,I signed on with Uber.
2230,1801,10,24,120,154,1.2857142857142858,0.04671928144055204,666,Play it cool. It's for his PETA campaign against Shark fin soup.
2301,1801,7,30,117,154,1.2857142857142858,0.0439094972056236,666,I thought it was a really big remora.
2655,1801,9,26,119,154,1.2857142857142858,0.045801842981455405,666,"Catch up, dude. The fin thing is a dead give away."
2691,1801,5,34,115,154,1.2857142857142858,0.041931838371378836,666,"He a fantastic and loving husband, but the constant surfacing for him to breath is getting old."
2727,1801,8,28,118,154,1.2857142857142858,0.044865648136121705,666,I thought I'd help him find his surfboard before I eat him
2761,1801,5,34,115,154,1.2857142857142858,0.041931838371378836,666,He wanted to say goodbye to his family.
3403,1801,9,26,119,154,1.2857142857142858,0.045801842981455405,666,white people
4324,1801,6,36,126,168,1.2857142857142858,0.040617258660421936,666,"In the good old days, it was an albatross around the neck."
4797,1801,10,24,120,154,1.2857142857142858,0.04671928144055204,666,If I stop swimming his shorts fall down.
595,1801,9,24,114,147,1.2857142857142858,0.04729176506299245,666,Do you have a problem with professional courtesy?  He’s a lawyer.
2252,1801,6,34,121,161,1.2857142857142858,0.04172947056216268,666,Please tell me it's lunchtime.
4892,1801,11,24,126,161,1.2857142857142858,0.04614702017641418,666,This joker thinks he’s standing on a sandbar!  Ya hungry?
449,1855,10,31,138,179,1.2849162011173185,0.04209878718218982,666,I hate the gig economy.
2885,1856,8,29,121,158,1.2848101265822784,0.04407283644001138,666,He thinks he’s swimming with dolphins.
3582,1857,8,38,144,190,1.2842105263157895,0.039011965968052564,666,Don’t tell him!
2461,1858,12,28,143,183,1.284153005464481,0.04287456890717119,666,"Its a symbiotic relationship, he gets to swim without getting tired and I get to eat him when he's done."
653,1859,7,30,118,155,1.2838709677419355,0.043664216237242676,666,"No, I haven't seen Jaws. Why do you ask?"
5412,1859,9,26,120,155,1.2838709677419355,0.045542706778752565,666,You'll have to talk to the man upstairs.
5281,1859,5,34,116,155,1.2838709677419355,0.041701192051186484,666,I brought you dinner.
5211,1859,7,30,118,155,1.2838709677419355,0.043664216237242676,666,Do I look like a surfboard?
703,1859,8,28,119,155,1.2838709677419355,0.04461334957357563,666,So what are YOU bringing to Terry's pot-luck dinner?
5176,1859,7,30,118,155,1.2838709677419355,0.043664216237242676,666,His Uber rating is a 4.7
5092,1859,5,34,116,155,1.2838709677419355,0.041701192051186484,666,It's one of those no frills around the world cruise
4981,1859,6,32,117,155,1.2838709677419355,0.04269398785603557,666,"Thanks,but I brought my lunch today."
4736,1859,8,28,119,155,1.2838709677419355,0.04461334957357563,666,It’s the latest millennial thing - shark yoga.
4618,1859,6,32,117,155,1.2838709677419355,0.04269398785603557,666,It’s the same guy who was struck by lightning last week.
1349,1859,8,28,119,155,1.2838709677419355,0.04461334957357563,666,It’s less conspicuous than when my dorsal fin sticks out of the water.
4116,1859,9,26,120,155,1.2838709677419355,0.045542706778752565,666,I keep telling him I'm a fish not a mammal.
5532,1859,8,28,119,155,1.2838709677419355,0.04461334957357563,666,"They`re featuring me in a nature film - ""When Fish Had Feet""."
1011,1859,7,30,118,155,1.2838709677419355,0.043664216237242676,666,"You ordered, lunch?"
3448,1859,6,32,117,155,1.2838709677419355,0.04269398785603557,666,It's the least I could offer after eating his surfboard.
3380,1859,10,24,121,155,1.2838709677419355,0.04645347480325674,666,"I’d eat this guy, but I’m still full from  those plastic bags."
3218,1859,8,28,119,155,1.2838709677419355,0.04461334957357563,666,"You ordered the ‘Businessman Express’ lunch, Sir?"
2662,1859,8,28,119,155,1.2838709677419355,0.04461334957357563,666,"I finally got the monkey off my back, now this!"
2402,1859,9,26,120,155,1.2838709677419355,0.045542706778752565,666,Grab the other leg and let's make a wish.
1572,1859,12,20,123,155,1.2838709677419355,0.048223434991916087,666,"He's too skinny.  I'm taking him back to shore.""
Michael Rogness, St. Paul, MN"
1521,1859,7,30,118,155,1.2838709677419355,0.043664216237242676,666,"If you think this looks bad, stick your head up and get a look at the other half"
1131,1859,8,28,119,155,1.2838709677419355,0.04461334957357563,666,"Hey honey, there was too much to eat at the party so I brought you some leftovers."
3992,1859,5,34,116,155,1.2838709677419355,0.041701192051186484,666,I got a summer job as a surfboard.
1727,1859,4,36,115,155,1.2838709677419355,0.04068417675126983,666,Call it! Heads or tails?
5700,1859,8,28,119,155,1.2838709677419355,0.04461334957357563,666,"He's got my back, Dude.  Move on!"
572,1859,6,32,117,155,1.2838709677419355,0.04269398785603557,666,Better than any pilot fish.  He's a professional pilot.
5645,1859,8,28,119,155,1.2838709677419355,0.04461334957357563,666,He doesn’t understand what jumping the shark really means!
6105,1859,6,32,117,155,1.2838709677419355,0.04269398785603557,666,They think he's standing on a sandbar.
4871,1887,10,25,124,159,1.2830188679245282,0.04561155137981816,666,When do we let him know he's not standing on a rock?
6312,1887,7,31,121,159,1.2830188679245282,0.042913624078767434,666,"I'm not distracted, I've just got a lot on my mind."
5578,1887,6,33,120,159,1.2830188679245282,0.04197579821365831,666,Just play along. Dinner is later.
4760,1887,7,31,121,159,1.2830188679245282,0.042913624078767434,666,Standing room only.
3241,1887,9,27,123,159,1.2830188679245282,0.04473032666294518,666,It's all I can get after that Katy Perry gig.
3192,1887,7,31,121,159,1.2830188679245282,0.042913624078767434,666,I call it lifeguard bating.
3648,1887,7,31,121,159,1.2830188679245282,0.042913624078767434,666,My headache's gone.
2040,1887,11,23,125,159,1.2830188679245282,0.046476070349953214,666,"His feet feel really nice on my back, but I also want to eat him."
5947,1895,4,35,113,152,1.2828947368421053,0.04113432073215858,666,"The money is not great, but it's a job."
5877,1895,8,27,117,152,1.2828947368421053,0.04517284411080174,666,The back massage comes with a lunch option.
5553,1895,6,31,115,152,1.2828947368421053,0.04320079968678176,666,You want to split an appetizer?
5385,1895,8,27,117,152,1.2828947368421053,0.04517284411080174,666,It's still better than wearing Crocs.
648,1895,10,23,119,152,1.2828947368421053,0.04706232672255111,666,This is our version of meals on wheels
4826,1895,8,27,117,152,1.2828947368421053,0.04517284411080174,666,I guess he thinks I'm a skate.
2870,1895,5,33,114,152,1.2828947368421053,0.04218021713833118,666,"The top half tasted great, I’m just way too full to finish up."
1762,1895,11,21,120,152,1.2828947368421053,0.04797917227590347,666,Weird. I heard him say “Hold my beer—watch this.”
3658,1895,9,25,118,152,1.2828947368421053,0.046127261145655206,666,"Well, it WAS a shared ride."
3187,1895,7,29,116,152,1.2828947368421053,0.04419782199744824,666,"Nah, too easy."
294,1895,10,23,119,152,1.2828947368421053,0.04706232672255111,666,"It's not my dream job, but he pays me scale."
1861,1895,8,27,117,152,1.2828947368421053,0.04517284411080174,666,It's like Lyft and Uber Eats all in one.
2425,1895,6,31,115,152,1.2828947368421053,0.04320079968678176,666,"Sea World has the nerve to call this ""a promotion""?"
2967,1895,9,25,118,152,1.2828947368421053,0.046127261145655206,666,"Yeah, I can't believe it either."
4325,1895,10,23,119,152,1.2828947368421053,0.04706232672255111,666,I enjoy them dry on top and wet on the bottom.
329,1895,7,29,116,152,1.2828947368421053,0.04419782199744824,666,I lost a bet.
5216,1895,9,25,118,152,1.2828947368421053,0.046127261145655206,666,Doctor says it will help me quit
4971,1912,7,36,134,177,1.2824858757062148,0.04001304126401449,666,Bad hair day
3926,1912,9,32,136,177,1.2824858757062148,0.04158661012839684,666,I might be hungry later.
2187,1914,9,30,131,170,1.2823529411764707,0.0427260511642095,666,I hope he will attract a plumper one.
4128,1915,9,28,126,163,1.2822085889570551,0.04395538908017317,666,These days you just look at an endangered species and The Man will be ridin’ your back for years”
6208,1916,9,26,121,156,1.2820512820512822,0.045286398422963496,666,He wanted to impress his girlfriend but enough is enough!
3800,1916,8,28,120,156,1.2820512820512822,0.04436377910170186,666,Is being vegan written all over my fins?
3603,1916,7,30,119,156,1.2820512820512822,0.043421560430802184,666,Would you like fries with that?
3597,1916,7,30,119,156,1.2820512820512822,0.043421560430802184,666,I’ve had it up my neck with bloody tourists!
3503,1916,7,30,119,156,1.2820512820512822,0.043421560430802184,666,There's this great new takeout place down the coast.
3004,1916,7,30,119,156,1.2820512820512822,0.043421560430802184,666,Dibs on the crunchy part.
2628,1916,8,28,120,156,1.2820512820512822,0.04436377910170186,666,You had to choose NOW to suggest that we become Pescatarians?!
2380,1916,4,36,116,156,1.2820512820512822,0.04046347677139755,666,"Normally I'd be asking myself the same question, but his specialty is sshiatsu and my dorsal fin's been killing me."
1886,1916,8,28,120,156,1.2820512820512822,0.04436377910170186,666,"I was saving him for later, but I'm hungry now.  Want a bite?"
4485,1916,8,28,120,156,1.2820512820512822,0.04436377910170186,666,Did you order takeout?
1079,1916,6,32,118,156,1.2820512820512822,0.04245843761029148,666,He ain't heavy he's my dinner.
330,1916,4,36,116,156,1.2820512820512822,0.04046347677139755,666,Heads he's mine. Tails he's yours.
428,1916,9,26,121,156,1.2820512820512822,0.045286398422963496,666,I can't bite him.  I'm an Uber driver.
509,1916,10,24,122,156,1.2820512820512822,0.04619059285246492,666,With that global warming I feel like eating salad only.
546,1916,8,28,120,156,1.2820512820512822,0.04436377910170186,666,My nutritionist told me I needed to balance my diet
628,1916,6,32,118,156,1.2820512820512822,0.04245843761029148,666,His toenails are a little sharp.
2161,1916,7,30,119,156,1.2820512820512822,0.043421560430802184,666,"Would you care to share my appetizer""?"
767,1916,8,28,120,156,1.2820512820512822,0.04436377910170186,666,"This one is yours, the last one gave me heartburn."
5343,1916,6,32,118,156,1.2820512820512822,0.04245843761029148,666,I am beginning to rethink this Uber gig.
5816,1916,12,20,124,156,1.2820512820512822,0.047947855425866215,666,Goat yoga is for sissies.
6034,1916,9,26,121,156,1.2820512820512822,0.045286398422963496,666,"I hope you don't mind, we're having take-out tonight."
6067,1916,7,30,119,156,1.2820512820512822,0.043421560430802184,666,He likes a cigarette after we have sex.
2244,1938,10,20,112,142,1.2816901408450705,0.04933500158802065,666,"i try to remind myself: a caldera, the singularity, climate change, antibiotic resistance—something's gonna clip these dumbfucks."
529,1939,8,33,133,174,1.2816091954022988,0.04124223377273099,666,Tell me the truth: have I gained weight?
1016,1940,7,29,117,153,1.2810457516339868,0.043946910637508094,666,I only eat them if they don’t tip.
4297,1940,7,29,117,153,1.2810457516339868,0.043946910637508094,666,"He asked for a ride once, and now it's, like, every day!"
4241,1940,9,25,119,153,1.2810457516339868,0.045862071241845694,666,They're paying me more than scale for Shark Week...
838,1940,8,27,118,153,1.2810457516339868,0.04491469989420642,666,'I thought you said he was supposed to jump'.
3755,1940,9,25,119,153,1.2810457516339868,0.045862071241845694,666,Bet you a fin I can flip him and catch him before you do a full circle.
2556,1940,9,25,119,153,1.2810457516339868,0.045862071241845694,666,"That disguise is not going to fool any of the swimmers, Sal."
534,1940,8,27,118,153,1.2810457516339868,0.04491469989420642,666,Make a wish.
379,1940,11,21,121,153,1.2810457516339868,0.04770040044489289,666,It’s your Uber Eats fresh food delivery!”
3463,1940,10,23,120,153,1.2810457516339868,0.04679026491266783,666,My other option was cataract surgery.
3412,1940,8,27,118,153,1.2810457516339868,0.04491469989420642,666,"Feels like remora, tastes like chicken."
4785,1940,6,31,116,153,1.2810457516339868,0.04295732350339832,666,For once I'd like to see how the other half lives.
6172,1940,6,31,116,153,1.2810457516339868,0.04295732350339832,666,Wait till he finds out where he really is.
96,1940,7,29,117,153,1.2810457516339868,0.043946910637508094,666,You want this half?
2553,1940,5,33,115,153,1.2810457516339868,0.04194439569918863,666,"Wild, fresh caught!  Help yourself!"
2349,1940,8,27,118,153,1.2810457516339868,0.04491469989420642,666,There's nothing better than an ashiatsu massage before dinner.
4845,1940,9,25,119,153,1.2810457516339868,0.045862071241845694,666,I told the sucker I work for Uber. Now hurry home and tell the kids dinner's almost here.
5850,1940,8,27,118,153,1.2810457516339868,0.04491469989420642,666,He' ll teach me to walk I'll teach him to swim.
1072,1940,6,31,116,153,1.2810457516339868,0.04295732350339832,666,I've decided to go back on the Paleo diet.
6072,1958,12,31,153,196,1.280612244897959,0.04078197141291371,666,This idiot thinks I am his surf board.
1102,1959,9,28,127,164,1.2804878048780488,0.04372042339458702,666,Sometimes you  get  exactly what  you  wish  for.
5739,1960,5,34,118,157,1.2802547770700636,0.04124709038031996,666,"Yeah, well, YOU try turning down a contract with the X-Games."
2910,1960,6,32,119,157,1.2802547770700636,0.04222536894060715,666,He thinks I'm a rock.  I'm just holding him here until I get hungry.
4557,1962,10,22,118,150,1.28,0.047411757195425085,666,Saved you the lower half
5744,1962,7,28,115,150,1.28,0.044490654575079204,666,"Yeah, well, you should've seen the one that got away."
4415,1962,9,24,117,150,1.28,0.0464584681381658,666,"You do it your way, I'll do it mine."
6142,1962,12,18,120,150,1.28,0.0492630250551455,666,I heard you are a leg man.
4400,1962,8,26,116,150,1.28,0.04548520422216428,666,I guess I can say good-bye to flaunting my dorsal fin.
2593,1962,4,34,112,150,1.28,0.04136377604474826,666,It was 'all-you-could-eat' night at that little bistro by the sand bar.
2280,1962,8,26,116,150,1.28,0.04548520422216428,666,I'll flip him and then we split  him.
1543,1962,6,30,114,150,1.28,0.04347335834630263,666,And we just ate.
587,1962,6,30,114,150,1.28,0.04347335834630263,666,Don’t laugh if I don’t eat this guy for fifteen minutes I get a second one!
183,1962,6,30,114,150,1.28,0.04347335834630263,666,I call it Farm-to-table.
2321,1972,7,33,128,168,1.2797619047619047,0.04129842573874188,666,Do you want to join me for dinner?
1139,1972,8,31,129,168,1.2797619047619047,0.04215265078174906,666,"And his feet are all slimy and gross, too!"
3341,1974,9,27,125,161,1.279503105590062,0.04424239777857304,666,His chiropractic technique is simply delicious!
1481,1974,7,31,123,161,1.279503105590062,0.04245126921650158,666,I suppose he thinks I'm a dolphin.
2076,1976,6,31,117,154,1.2792207792207793,0.042716470135968757,666,I think the remoras are evolving.
2242,1976,10,23,121,154,1.2792207792207793,0.04652124860933515,666,This guy better give me five stars.
4927,1976,7,29,118,154,1.2792207792207793,0.04369873291870973,666,Hi sweetie. Just wanted to show you that I am not a bottom feeder.
3491,1979,5,32,114,151,1.2781456953642385,0.04219050707426151,666,"I bet if you say, 'Hey look! A phone!"" he'll jump down right away"
301,1980,6,31,118,155,1.2774193548387096,0.042478200003923584,666,I support him for the tax breaks.
6124,1981,6,29,113,148,1.277027027027027,0.04374976263528806,666,"You ordered the veggie lover, hold the sun screen."
5544,1981,6,29,113,148,1.277027027027027,0.04374976263528806,666,May I recommend a nice cabernet sauvignon to go with the gentleman’s entree?
4419,1981,11,19,118,148,1.277027027027027,0.048720478727432695,666,"Dang, I lost mine!"
3115,1981,5,31,112,148,1.277027027027027,0.042686216361804814,666,Play with your own food.
2495,1981,6,29,113,148,1.277027027027027,0.04374976263528806,666,i'm saving half for dessert
1949,1981,8,25,115,148,1.277027027027027,0.045802828049788774,666,"If you order a decoy, spend the extra money for the model that waves its arms and screams Help!"
6231,1981,6,29,113,148,1.277027027027027,0.04374976263528806,666,"Yeah, I know I should eat him, but he promised  me a part in the upcoming ""Sharknado"" sequel."
801,1981,3,35,110,148,1.277027027027027,0.04047537202512589,666,"Did you know an estimated 100 million sharks are wantonly killed every year around the world? I think it is time we doing something about that, starting right here."
3781,1981,8,25,115,148,1.277027027027027,0.045802828049788774,666,8.25 isn't enough to have the customers just walk all over you.
3029,1990,3,43,131,177,1.2768361581920904,0.0364704273719787,666,Last client of the day.
6008,1991,3,38,118,159,1.2767295597484276,0.03880217268209466,666,I ordered Uber eats and got Uber lift instead.
5394,1991,7,30,122,159,1.2767295597484276,0.0427089520879537,666,"Be honest, is the hat too much?"
5354,1991,9,26,124,159,1.2767295597484276,0.04453400476322718,666,It's a perfect meal. Surf & Turf.
3003,1991,3,38,118,159,1.2767295597484276,0.03880217268209466,666,"Yep, another hitchhiker. He thinks I'm taking him to Hawaii. Dinner at 7?""

Sunil Mahtani, Westport, CT
sm@kingfisherinvestors.co"
288,1991,8,28,123,159,1.2767295597484276,0.04363102204110205,666,"Simple. We bet, He won."
56,1991,5,34,120,159,1.2767295597484276,0.0408023479306168,666,It’s an Uber pilot program.
732,1997,6,30,116,152,1.2763157894736843,0.042977950790925666,666,He’s my spotter.
3680,1998,7,26,112,145,1.2758620689655173,0.04536226956476118,666,Should I tell him that he's out of his depth?
3799,1998,7,26,112,145,1.2758620689655173,0.04536226956476118,666,"Well, I couldn't make anything by biting people, so I started being an Uber driver."
3820,1998,7,26,112,145,1.2758620689655173,0.04536226956476118,666,"Emotional support pet for now,snack if it doesn't work out."
3927,1998,5,30,110,145,1.2758620689655173,0.04319912752406008,666,I’m trying a more balanced approach to eating.
4020,1998,7,26,112,145,1.2758620689655173,0.04536226956476118,666,Oh boy Surfer Surprise for dinner tonight!
3627,1998,5,30,110,145,1.2758620689655173,0.04319912752406008,666,"I don't know; something about jumping the shark."""
4072,1998,9,22,114,145,1.2758620689655173,0.04742685295581093,666,"No, he’s not a lawyer. He’s my agent."
4182,1998,8,24,113,145,1.2758620689655173,0.04640604422571574,666,The flavor is improved if they feel well supported
4185,1998,7,26,112,145,1.2758620689655173,0.04536226956476118,666,ONE LAST TIME- I go low you go high
4222,1998,7,26,112,145,1.2758620689655173,0.04536226956476118,666,Humans are a pain in the neck
3984,1998,9,22,114,145,1.2758620689655173,0.04742685295581093,666,Ya. It’s my lawyer! Professional  courtesy...gets me real close to the beach!
3587,1998,6,28,111,145,1.2758620689655173,0.04429390544367285,666,I offered to give him some tips. He's a loan shark.
3304,1998,3,34,108,145,1.2758620689655173,0.04092180027337448,666,"I already ate the top half, so sure you can have the rest..."
4271,1998,9,22,114,145,1.2758620689655173,0.04742685295581093,666,"Lawyer, professional courtesy."
2286,1998,7,26,112,145,1.2758620689655173,0.04536226956476118,666,"I've got to get my Uber driver rating back above 4 stars after last month's ""incident""."
6255,1998,6,28,111,145,1.2758620689655173,0.04429390544367285,666,Grubhub delivery - did you order one whole swimmer and a coke?
2343,1998,9,22,114,145,1.2758620689655173,0.04742685295581093,666,Not my fault. Said he was a chiropractor.
2438,1998,8,24,113,145,1.2758620689655173,0.04640604422571574,666,Saving him for the barbecue on the 4th
2527,1998,6,28,111,145,1.2758620689655173,0.04429390544367285,666,Can you get him off my back?
2589,1998,6,28,111,145,1.2758620689655173,0.04429390544367285,666,"First the massage, then the meal"
2623,1998,10,20,115,145,1.2758620689655173,0.048426148121703205,666,I thought I might as well bring lunch.
3508,1998,8,24,113,145,1.2758620689655173,0.04640604422571574,666,He's outta his depth.
2693,1998,8,24,113,145,1.2758620689655173,0.04640604422571574,666,Stop playing with your food Larry.
2756,1998,6,28,111,145,1.2758620689655173,0.04429390544367285,666,Would you like the other half?
2795,1998,6,28,111,145,1.2758620689655173,0.04429390544367285,666,He told me he'd keep an eye out for Robert Shaw.
2940,1998,5,30,110,145,1.2758620689655173,0.04319912752406008,666,He’s my only link to the outside world..
3040,1998,6,28,111,145,1.2758620689655173,0.04429390544367285,666,"Sharks are the scooters of the sea,” he said"
3142,1998,5,30,110,145,1.2758620689655173,0.04319912752406008,666,I could use a good toothpick in about 30 seconds.
3211,1998,8,24,113,145,1.2758620689655173,0.04640604422571574,666,My therapist says I need to submit more.
3212,1998,10,20,115,145,1.2758620689655173,0.048426148121703205,666,you can't just let him walk all over you!
2716,1998,5,30,110,145,1.2758620689655173,0.04319912752406008,666,Discovery Channel needs to up our pay. These Shark Week bits are getting ridiculous.
4273,1998,5,30,110,145,1.2758620689655173,0.04319912752406008,666,"So when I roll, grab his leg..."
4462,1998,5,30,110,145,1.2758620689655173,0.04319912752406008,666,From the surface we look like surf boards.
6233,1998,7,26,112,145,1.2758620689655173,0.04536226956476118,666,Cool hat Mark.
4467,1998,4,32,109,145,1.2758620689655173,0.042075874063731325,666,"Sorry honey, but it sure beats your fin massages."
4491,1998,6,28,111,145,1.2758620689655173,0.04429390544367285,666,He's for my hard-to-scratch spots.
4529,1998,10,20,115,145,1.2758620689655173,0.048426148121703205,666,I actually never been this close to one before.
2216,1998,8,24,113,145,1.2758620689655173,0.04640604422571574,666,They've really become too comfortable after that Nemo movie.
4569,1998,7,26,112,145,1.2758620689655173,0.04536226956476118,666,What  kind of wine goes with shlump?
4584,1998,7,26,112,145,1.2758620689655173,0.04536226956476118,666,Dinner is served.
4671,1998,5,30,110,145,1.2758620689655173,0.04319912752406008,666,Why don’t you try swimming with people
4694,1998,9,22,114,145,1.2758620689655173,0.04742685295581093,666,"Well, he's a lawyer. And a very good one at that."
4841,1998,9,22,114,145,1.2758620689655173,0.04742685295581093,666,I’ve switched to live bait.
4885,1998,7,26,112,145,1.2758620689655173,0.04536226956476118,666,That’ll be $22.50 plus tip.
4896,1998,6,28,111,145,1.2758620689655173,0.04429390544367285,666,My wife sent me out for food for our daughter's graduation party.
5085,1998,6,28,111,145,1.2758620689655173,0.04429390544367285,666,"Unlike you, I can live with it, Roger."
5088,1998,7,26,112,145,1.2758620689655173,0.04536226956476118,666,I owe the local loan shark a favor.
5204,1998,8,24,113,145,1.2758620689655173,0.04640604422571574,666,I had to pick up a side gig for Uber.
5227,1998,8,24,113,145,1.2758620689655173,0.04640604422571574,666,"I keep telling you,
their carry out is the best”"
5395,1998,3,34,108,145,1.2758620689655173,0.04092180027337448,666,"As you'd guess from the legs, this species is called the Pale White."
4443,1998,6,28,111,145,1.2758620689655173,0.04429390544367285,666,"Being a vegan is easy.  Here, try a little I Can't Believe It's Not Human."
6214,1998,6,28,111,145,1.2758620689655173,0.04429390544367285,666,My plan is to take him six feet under.
4448,1998,6,28,111,145,1.2758620689655173,0.04429390544367285,666,"Its like Uber, but with stronger incentives for good tips"
4349,1998,7,26,112,145,1.2758620689655173,0.04536226956476118,666,You picked the wrong day to go vegetarian.
6180,1998,7,26,112,145,1.2758620689655173,0.04536226956476118,666,I think he's getting ready to jump the shark!
6131,1998,9,22,114,145,1.2758620689655173,0.04742685295581093,666,"I have the answer to, “What’s for dinner tonight?”"
6007,1998,6,28,111,145,1.2758620689655173,0.04429390544367285,666,"Don't ask, he's paying me."
4320,1998,7,26,112,145,1.2758620689655173,0.04536226956476118,666,"It's called aquatic reflexology"""
4368,1998,9,22,114,145,1.2758620689655173,0.04742685295581093,666,This dumb surfer dude thinks I'm a dolphin.  I'm just taking him far enough out to sea that no one will hear his screams.
5717,1998,10,20,115,145,1.2758620689655173,0.048426148121703205,666,"What can I say? My stomach, like my heart, is full."
5633,1998,11,18,116,145,1.2758620689655173,0.04940523517318955,666,Sometimes I really wish I hadn’t gone vegan
5580,1998,7,26,112,145,1.2758620689655173,0.04536226956476118,666,They tell me I'm part of the cutting edge of surfing.
5568,1998,7,26,112,145,1.2758620689655173,0.04536226956476118,666,They call it treading water.
5552,1998,6,28,111,145,1.2758620689655173,0.04429390544367285,666,"Grubhub. I was tired."""
5487,1998,6,28,111,145,1.2758620689655173,0.04429390544367285,666,It started out as a bump on my fin.
6000,1998,5,30,110,145,1.2758620689655173,0.04319912752406008,666,The idiot thinks I am a dolphin!!
2153,1998,7,26,112,145,1.2758620689655173,0.04536226956476118,666,Want to share lunch?
2308,1998,2,36,107,145,1.2758620689655173,0.03973422072975541,666,Then pollution gets worse and worse each year.
2038,1998,5,30,110,145,1.2758620689655173,0.04319912752406008,666,He's auditioning for America's Got Talent.
1094,1998,4,32,109,145,1.2758620689655173,0.042075874063731325,666,It's court-ordered restitution for eating his surfboard
888,1998,11,18,116,145,1.2758620689655173,0.04940523517318955,666,What? I'm celebrating Human Week.
826,1998,8,24,113,145,1.2758620689655173,0.04640604422571574,666,I’m going to miss him after I eat him.
771,1998,6,28,111,145,1.2758620689655173,0.04429390544367285,666,"What, you don’t play with your food?!"
690,1998,7,26,112,145,1.2758620689655173,0.04536226956476118,666,Does this make me look fat?
622,1998,7,26,112,145,1.2758620689655173,0.04536226956476118,666,I just got some takeout
1130,1998,7,26,112,145,1.2758620689655173,0.04536226956476118,666,Pity. He was only a couple feet short of the dolphin tank.
514,1998,6,28,111,145,1.2758620689655173,0.04429390544367285,666,Look! I found a wishbone.
390,1998,6,28,111,145,1.2758620689655173,0.04429390544367285,666,"So, after I swallowed his surfboard..."
344,1998,9,22,114,145,1.2758620689655173,0.04742685295581093,666,You're invading my territory again! This time I brought my lawyer.
155,1998,8,24,113,145,1.2758620689655173,0.04640604422571574,666,We have a kinship. His legs are great and white.
90,1998,3,34,108,145,1.2758620689655173,0.04092180027337448,666,Watch this back flip! then we'll eat.
57,1998,10,20,115,145,1.2758620689655173,0.048426148121703205,666,"Hey Franck, by any chance, have you seen my lunch?"
20,1998,6,28,111,145,1.2758620689655173,0.04429390544367285,666,Lunch is weighing me down again.
446,1998,5,30,110,145,1.2758620689655173,0.04319912752406008,666,The wife didn’t feel like eating out so I picked up some fast food
1145,1998,6,28,111,145,1.2758620689655173,0.04429390544367285,666,"SUP, man?"
574,1998,10,20,115,145,1.2758620689655173,0.048426148121703205,666,I ate his surfboard.
1243,1998,5,30,110,145,1.2758620689655173,0.04319912752406008,666,Can you help me; I'm trying to get this monkey off my back.
2146,1998,8,24,113,145,1.2758620689655173,0.04640604422571574,666,I can’t decide; shiatsu or lunch?
1161,1998,8,24,113,145,1.2758620689655173,0.04640604422571574,666,See if this is all that's left.
1914,1998,6,28,111,145,1.2758620689655173,0.04429390544367285,666,Keep your jaws off him. I'm saving him for dessert.
1895,1998,9,22,114,145,1.2758620689655173,0.04742685295581093,666,It's a new reality show that's a mash up of Shark Tank and Survivor.
1894,1998,9,22,114,145,1.2758620689655173,0.04742685295581093,666,I'm waiting for him to stop peeing.
1885,1998,6,28,111,145,1.2758620689655173,0.04429390544367285,666,I can't get him of my back.
1667,1998,7,26,112,145,1.2758620689655173,0.04536226956476118,666,He’s marinating.
1664,1998,8,24,113,145,1.2758620689655173,0.04640604422571574,666,The fin.  He thinks I'm a rescue porpoise.  Just wait ONE minute!
1999,1998,5,30,110,145,1.2758620689655173,0.04319912752406008,666,"I'm just not in the mood for stalking and attacking tonight, dear, so I decided on carry-out."
1452,1998,8,24,113,145,1.2758620689655173,0.04640604422571574,666,I'm afraid if I eat him it'll affect my star rating.
1429,1998,7,26,112,145,1.2758620689655173,0.04536226956476118,666,I'll stay here while you grab dinner for us both.
1420,1998,5,30,110,145,1.2758620689655173,0.04319912752406008,666,I figure with the current state of politics they’ve got enough going on.
1545,1998,7,26,112,145,1.2758620689655173,0.04536226956476118,666,"Fast talking salesman... you go in for a massage, and come back with an edible periscope."
1253,1998,6,28,111,145,1.2758620689655173,0.04429390544367285,666,"First he called me Shamu, then..."
30,2099,8,27,121,156,1.2756410256410255,0.044157135337534806,666,Can I get back with you? I'm going to lunch.
1064,2099,8,27,121,156,1.2756410256410255,0.044157135337534806,666,"I ate half, and I'm saving the rest for a snack later."
3859,2099,6,31,119,156,1.2756410256410255,0.04224247423316703,666,Bringing lunch from home for a change.
3070,2102,6,24,101,131,1.2748091603053435,0.047303613388792874,666,"Yes. I am relaxing, Master, I am taking slow breathes in and out of both gills...I feel like a peaceful swaying kelp flower..... but I still want to bite something."
2266,2103,5,35,124,164,1.274390243902439,0.03994442824615528,666,"Every time I go on a diet, temptation comes a clompin'."""
1101,2103,5,35,124,164,1.274390243902439,0.03994442824615528,666,"Dude gives me a back massage and I don’t eat him, fair deal?"
5165,2105,5,30,111,146,1.273972602739726,0.0429438098283116,666,It’s like shooting one of us in a barrel.
3027,2105,3,34,109,146,1.273972602739726,0.04068444641372266,666,I ordered my meal “to go.”
5225,2105,8,24,114,146,1.273972602739726,0.04612581420895325,666,My shrink says I keep giving up my power.
4918,2105,6,28,112,146,1.273972602739726,0.04403003649623462,666,He is an instagram influencer. Says he can improve my click bait numbers.
3832,2105,9,22,115,146,1.273972602739726,0.04713877435539064,666,He’s a Trump supporter
3135,2105,11,18,117,146,1.273972602739726,0.04910204344329833,666,"It's called fashion, Carl."
5049,2105,4,32,110,146,1.273972602739726,0.041829385499677504,666,Who him? His name is Fonzi.
4921,2105,7,26,113,146,1.273972602739726,0.04509010340583965,666,"It's great as bait, but the temptation to snack on it is killing me."
5960,2105,7,26,113,146,1.273972602739726,0.04509010340583965,666,So next I flip it up into the air and catch it in my jaws.
5824,2105,4,32,110,146,1.273972602739726,0.041829385499677504,666,"I know, but I felt sorry for the skinny bastard."
2342,2105,5,30,111,146,1.273972602739726,0.0429438098283116,666,I hate lawyers!
2328,2105,6,28,112,146,1.273972602739726,0.04403003649623462,666,Seriously.  What did you do with his surfboard?
343,2105,8,24,114,146,1.273972602739726,0.04612581420895325,666,do i have something on my back?
886,2105,4,32,110,146,1.273972602739726,0.041829385499677504,666,It's just that I'm not that hungry right now.
1489,2105,4,32,110,146,1.273972602739726,0.041829385499677504,666,This model really works! Get ready for a feast when all the rescuers show up.
1223,2105,5,30,111,146,1.273972602739726,0.0429438098283116,666,Should I?
5733,2105,7,26,113,146,1.273972602739726,0.04509010340583965,666,If your father sees you playing with humans again he’s going to bite your head off
2809,2105,5,30,111,146,1.273972602739726,0.0429438098283116,666,It’s similar to a monkey on my back but easier to get off.
1656,2123,7,29,121,157,1.2738853503184713,0.042970184931970835,666,Don’t go near the beach!
4958,2124,8,25,117,150,1.2733333333333334,0.04526498334667862,666,This is as close as he gets to be God and walking on water.
2867,2125,10,24,127,161,1.2732919254658386,0.04491847138326595,666,Don't knock it. It's the best fishing lure I've ever used
773,2126,9,21,113,143,1.2727272727272727,0.047783345654281016,666,Hey look at me!  I’m Carmen Miranda.
3051,2126,3,33,107,143,1.2727272727272727,0.041137449902482845,666,You take the left one and I’ll  take the right.
876,2126,5,29,109,143,1.2727272727272727,0.04346580146458082,666,"I picked it up on my way back from the keys, hopefully it'll go away on its own."
1057,2126,8,23,112,143,1.2727272727272727,0.04674136354105388,666,This gig economy is killing me.
1485,2126,9,21,113,143,1.2727272727272727,0.047783345654281016,666,The weather is getting warm and this is my first swimmer of the season.
1858,2126,6,27,110,143,1.2727272727272727,0.04458440257755946,666,"After biting a chunk out of his surfboard, I thought that I owed him."
1871,2126,8,23,112,143,1.2727272727272727,0.04674136354105388,666,I guess this guy never saw Jaws!
2502,2126,7,25,111,143,1.2727272727272727,0.04567561723105038,666,Everyone takes advantage of vegans.
479,2126,6,27,110,143,1.2727272727272727,0.04458440257755946,666,"I ate his surf board  and he says I owe him."""
820,2126,8,23,112,143,1.2727272727272727,0.04674136354105388,666,We're bringing dessert.
2680,2126,10,19,114,143,1.2727272727272727,0.048803085744203015,666,He's underwater financially and I want to be the lone shark.
3573,2126,10,19,114,143,1.2727272727272727,0.048803085744203015,666,"He's not heavy, I ate his brother!."
5984,2126,7,25,111,143,1.2727272727272727,0.04567561723105038,666,He will soon find out he's not on a sandbar.
5747,2126,4,31,108,143,1.2727272727272727,0.04231764219233889,666,My agent says it might help our image.
5617,2126,6,27,110,143,1.2727272727272727,0.04458440257755946,666,I was catfished.
5129,2126,8,23,112,143,1.2727272727272727,0.04674136354105388,666,Have you seen the wife?
5095,2126,6,27,110,143,1.2727272727272727,0.04458440257755946,666,"Shark surfing, it’s a thing."
2689,2126,6,27,110,143,1.2727272727272727,0.04458440257755946,666,It's my turn to have the top portion.
4852,2126,3,36,115,154,1.2727272727272727,0.03938316438016546,666,"I told you my friend was a ""stand-up"" kind of guy"
5047,2126,9,21,113,143,1.2727272727272727,0.047783345654281016,666,"I pick them up for Uber, but I drop them off for Uber Eats."
4713,2126,5,29,109,143,1.2727272727272727,0.04346580146458082,666,I ordered it this morning on Amazon.
5062,2126,6,27,110,143,1.2727272727272727,0.04458440257755946,666,There's too much news going around that sharks rarely bite humans.
4337,2126,6,27,110,143,1.2727272727272727,0.04458440257755946,666,Damn global warming...
4200,2126,10,19,114,143,1.2727272727272727,0.048803085744203015,666,If I eat him I'll lower my IQ score by 50.
4141,2126,8,23,112,143,1.2727272727272727,0.04674136354105388,666,I just can’t seem to get this monkey off my back.
4059,2126,7,25,111,143,1.2727272727272727,0.04567561723105038,666,I find it causes less of a fuss than the fin.
3778,2126,6,27,110,143,1.2727272727272727,0.04458440257755946,666,I'm willing to go halfsies.
3699,2126,7,25,111,143,1.2727272727272727,0.04567561723105038,666,Get washed up. Dinner's on the table.
4369,2126,4,31,108,143,1.2727272727272727,0.04231764219233889,666,"I'm his balance trainer, heh, heh."
5623,2155,6,34,129,169,1.272189349112426,0.040022926800203196,666,He's soooo worth it when I get an itchy fin.
5517,2156,7,26,114,147,1.272108843537415,0.044821083899732446,666,"It's called Shark Lyft, and no you are not going to bite into my profits."
4435,2156,4,32,111,147,1.272108843537415,0.04158564273400371,666,We have been here for 50 million years and all of a sudden these guys are stepping on us and scream bloody murder if we bite them.
3007,2156,8,24,115,147,1.272108843537415,0.0458488551881332,666,"Yeah, ok, fillet of sole."
2787,2156,9,22,116,147,1.272108843537415,0.04685408714485814,666,"You're right, he's going to owe me one."
944,2156,6,28,113,147,1.272108843537415,0.04376918552853482,666,He’s with me.
1370,2156,9,22,116,147,1.272108843537415,0.04685408714485814,666,It's a living.
1826,2156,6,28,113,147,1.272108843537415,0.04376918552853482,666,Dark or light?
2350,2156,7,26,114,147,1.272108843537415,0.044821083899732446,666,I hate to burst his bubble.
3060,2164,9,30,138,177,1.271186440677966,0.04124065116681124,666,You can start with the drumsticks
2358,2165,13,20,137,170,1.2705882352941176,0.04552854743205527,666,When did you get that 4th gill?
345,2166,10,36,161,207,1.2705314009661837,0.037775686917181965,666,He thinks I'm a sandbar.  Make a wish.
5011,2167,7,29,123,159,1.270440251572327,0.04249740396890623,666,I'd eat him except he has our cell phone.
945,2168,9,20,112,141,1.2695035460992907,0.04814642541302546,666,"You Frank? Good, here's your Scuber Eats delivery."
947,2168,11,16,114,141,1.2695035460992907,0.05020669801171414,666,This vegan diet is for the birds!
4233,2168,7,24,110,141,1.2695035460992907,0.0459939565037037,666,"Don't even ask where I got this, I'm fed up with you always copying my style."
3457,2168,8,22,111,141,1.2695035460992907,0.04708249311005425,666,What do you mean I have food on my face?
1362,2168,8,22,111,141,1.2695035460992907,0.04708249311005425,666,Come on in ... I’m standing up!
1356,2168,8,22,111,141,1.2695035460992907,0.04708249311005425,666,It’s Trump! He can’t swim !
1203,2168,10,18,113,141,1.2695035460992907,0.04918735002666582,666,I prefer mine with ketchup.
1438,2168,7,24,110,141,1.2695035460992907,0.0459939565037037,666,I'm cutting my portions in half.
1802,2168,6,26,109,141,1.2695035460992907,0.04487902530437653,666,My dermatologist tells me it is nothing to be concerned with.
1167,2168,8,22,111,141,1.2695035460992907,0.04708249311005425,666,I joined Lyft. This gig economy is getting me down.
1905,2168,7,24,110,141,1.2695035460992907,0.0459939565037037,666,I can't decide to eat him or keep him as my personal masseuse. I must admit it feels good!
903,2168,9,20,112,141,1.2695035460992907,0.04814642541302546,666,It’s the El Chapo dorsal attachment. Gets a better reaction than the fin.
4086,2168,6,26,109,141,1.2695035460992907,0.04487902530437653,666,I have a feeling 'Jaws 5: Shark Surfer' is going to flop!
1987,2168,10,18,113,141,1.2695035460992907,0.04918735002666582,666,"You know I am a vegan, Jessica."
2041,2168,3,32,106,141,1.2695035460992907,0.04135426875776809,666,Apparently it is a form of extreme surfing. Let's hope it doesn't catch on
2206,2168,10,18,113,141,1.2695035460992907,0.04918735002666582,666,Where's Katy Perry?
1015,2168,7,24,110,141,1.2695035460992907,0.0459939565037037,666,Reparations.
2219,2168,5,28,108,141,1.2695035460992907,0.04373568096734234,666,Dude thinks he's Aqua-man.
2473,2168,7,24,110,141,1.2695035460992907,0.0459939565037037,666,The jerk thinks I'm a coral reef- what the hell could I do??!
2778,2168,8,22,111,141,1.2695035460992907,0.04708249311005425,666,I thought this was a potluck!
2903,2168,8,22,111,141,1.2695035460992907,0.04708249311005425,666,But I like to play with my food!
2996,2168,5,28,108,141,1.2695035460992907,0.04373568096734234,666,"Well, at least we're not at Sea World."
1122,2168,7,24,110,141,1.2695035460992907,0.0459939565037037,666,I mean as if the tagging wasn't bad enough.
3720,2168,8,22,111,141,1.2695035460992907,0.04708249311005425,666,Wanna give him a pedicure?
3646,2168,6,26,109,141,1.2695035460992907,0.04487902530437653,666,It's called 'symbiosis' Jim.
3066,2168,6,26,109,141,1.2695035460992907,0.04487902530437653,666,Well at least he’s no longer skateboarding.
3137,2168,4,30,107,141,1.2695035460992907,0.04256163374546885,666,Ask him to move back and to the right.
3213,2168,5,28,108,141,1.2695035460992907,0.04373568096734234,666,"So, I see yours jumped the shark."
3330,2168,5,28,108,141,1.2695035460992907,0.04373568096734234,666,They gave me honorable mention for the ‘Family Beach Camouflaged Hat’ category.
3334,2168,3,32,106,141,1.2695035460992907,0.04135426875776809,666,They're better marinated.
2465,2168,7,24,110,141,1.2695035460992907,0.0459939565037037,666,They've become a lot more brazen since that cute baby shark song.
748,2168,6,26,109,141,1.2695035460992907,0.04487902530437653,666,Just until my periscope gets back from the repair shop.
4860,2168,6,26,109,141,1.2695035460992907,0.04487902530437653,666,I thought volunteer work would be easy
391,2168,6,26,109,141,1.2695035460992907,0.04487902530437653,666,This attracts more snacks than letting  my fin stick above the water.
6187,2168,5,28,108,141,1.2695035460992907,0.04373568096734234,666,I love getting my weekly shiatsu!
5911,2168,12,14,115,141,1.2695035460992907,0.05120575795585081,666,He came into the Tank promising his “patent pending” online beachwear had amazing sales and growth.  Now I’m literally keeping him afloat.
5881,2168,6,26,109,141,1.2695035460992907,0.04487902530437653,666,"Guess we'll have to go a little deeper for privacy, dear."
5878,2168,4,30,107,141,1.2695035460992907,0.04256163374546885,666,I know! I know! I lost a bet!
5566,2168,7,24,110,141,1.2695035460992907,0.0459939565037037,666,It's the latest; UBER du Mer. I set my own work schedule. After training I received a discount card for seal sushi and if the client is overly abusive I can eat the them.
5560,2168,5,28,108,141,1.2695035460992907,0.04373568096734234,666,My therapist thinks I should strengthen my collaborative spirit.
5536,2168,10,18,113,141,1.2695035460992907,0.04918735002666582,666,Which half do you want?
5518,2168,5,28,108,141,1.2695035460992907,0.04373568096734234,666,"I always get mine ""to go."""
5444,2168,7,24,110,141,1.2695035460992907,0.0459939565037037,666,"No, he can’t hang ten."
5391,2168,7,24,110,141,1.2695035460992907,0.0459939565037037,666,"I ordered carry out, and they  served me the counter man."
5188,2168,6,26,109,141,1.2695035460992907,0.04487902530437653,666,How about we split 50-50?
5093,2168,9,20,112,141,1.2695035460992907,0.04814642541302546,666,You're so late that I decided to start lunch without you.
637,2168,7,24,110,141,1.2695035460992907,0.0459939565037037,666,Soon he'll not have a leg to stand on.
5031,2168,2,34,105,141,1.2695035460992907,0.04011057743159522,666,Damn millennials.
3628,2168,6,26,109,141,1.2695035460992907,0.04487902530437653,666,I am a stand in for Shark Week
4924,2168,2,34,105,141,1.2695035460992907,0.04011057743159522,666,I'm having a lot of trouble adjusting to this new balanced diet.
4910,2168,3,32,106,141,1.2695035460992907,0.04135426875776809,666,"Just let it go, Josh. The poor bastard is up there screaming 'California Dreaming' at the top of his lungs."
3532,2168,8,22,111,141,1.2695035460992907,0.04708249311005425,666,Unfortunately we do not have a leg to stand on.
4386,2168,8,22,111,141,1.2695035460992907,0.04708249311005425,666,I told you going vegan was a bad idea.
4445,2168,5,28,108,141,1.2695035460992907,0.04373568096734234,666,He said we could switch after 5 minutes. Its been 20
4741,2168,5,28,108,141,1.2695035460992907,0.04373568096734234,666,My wife wants me to save money. I'm taking my lunch to work.
4617,2168,6,26,109,141,1.2695035460992907,0.04487902530437653,666,I'm keeping an eye on that undertoe.
4933,2168,6,26,109,141,1.2695035460992907,0.04487902530437653,666,He’s worse than a lamprey!
4660,2168,6,26,109,141,1.2695035460992907,0.04487902530437653,666,This is what it takes to be a Superhost.
409,2226,6,30,120,156,1.2692307692307692,0.04201909236197543,666,You can Venmo me for your half.
3259,2227,10,19,116,145,1.2689655172413794,0.048200543324739664,666,"Jaw, paper, fin?"""
2181,2227,7,25,113,145,1.2689655172413794,0.04512134810664488,666,"They just don't fear us anymore ever since those ""Sharknado"" movies came out."
921,2227,5,29,111,145,1.2689655172413794,0.04294607285579174,666,It's a potluck
5961,2227,6,27,112,145,1.2689655172413794,0.04404714081921775,666,He's an intern in my law firm's summer program.
4174,2227,6,27,112,145,1.2689655172413794,0.04404714081921775,666,He's in training to jump the shark.
4381,2232,4,25,94,123,1.2682926829268293,0.04628425799209876,666,And then they blame us for going after their legs...
1991,2233,7,24,111,142,1.267605633802817,0.04570832658874256,666,People give me a headache
4456,2234,10,22,125,157,1.267515923566879,0.04552680875727029,666,The dolphin said this was the best way to get more subscribers on YouTube.
3286,2234,8,26,123,157,1.267515923566879,0.04369635775399191,666,It's called  Ashiatsu and don't you dare ruin this for me !
3343,2236,9,21,116,146,1.2671232876712328,0.046908282342565076,666,I'm a total magnet for humans.
3712,2237,6,29,119,154,1.2662337662337662,0.042262440707957816,666,Do me a favor and bite his leg.
244,2238,6,25,108,139,1.2661870503597121,0.045177784061393216,666,I can set my own hours and don't need a medallion.
1291,2238,7,23,109,139,1.2661870503597121,0.04631734650488074,666,Hurry and take a pic for my Instagram page!
1549,2238,7,23,109,139,1.2661870503597121,0.04631734650488074,666,He's a dentist. Can he fix my bite?
1880,2238,8,21,110,139,1.2661870503597121,0.047429537229541886,666,"Well, at least I'm employed."
2303,2238,4,29,106,139,1.2661870503597121,0.04280774863955415,666,That's the last time I'll make a wager with Jimmy Buffett.
3114,2238,3,31,105,139,1.2661870503597121,0.04157209315192029,666,"He said his Grandfather was on the Indianapolis, that's why."
4307,2238,10,17,112,139,1.2661870503597121,0.04957912696810145,666,He's ours. You bring the avocado and I'll bring the cilantro.
6054,2238,8,21,110,139,1.2661870503597121,0.047429537229541886,666,"I lost a bet with him, sucks, embarrassing."
563,2238,8,21,110,139,1.2661870503597121,0.047429537229541886,666,I love posing as a sandbar before dinner.
890,2238,2,33,104,139,1.2661870503597121,0.040298567151657215,666,This new diet is crushing me with everything I can't eat
4387,2248,4,25,95,124,1.2661290322580645,0.045960437164890795,666,He just had to prove he was on top of the food chain.
3537,2249,6,26,111,143,1.2657342657342658,0.04432876928557099,666,"They said 'Nice board shorts,' but he heard 'nice bored sharks.'"
4750,2250,4,28,104,136,1.2647058823529411,0.04332993214109077,666,His wife said to surprise him.
5730,2250,7,22,107,136,1.2647058823529411,0.04694976469560254,666,"He ain’t heavy, he’s my chum"
5648,2250,6,24,106,136,1.2647058823529411,0.04577497070560295,666,I see this as a glass half empty/glass half full dilemma.
5353,2250,7,22,107,136,1.2647058823529411,0.04694976469560254,666,"Grown up shark, doo doo doo doo doo doo doo …"
2575,2250,5,26,105,136,1.2647058823529411,0.04456922123197992,666,He's head and shoulders above the rest.
1076,2250,3,30,103,136,1.2647058823529411,0.04205413841083768,666,Maybe I was a dolphin in my past life!
14,2250,6,24,106,136,1.2647058823529411,0.04577497070560295,666,"The waters getting warmer, and I actually hope it’s climate change"
305,2250,6,24,106,136,1.2647058823529411,0.04577497070560295,666,Didn’t your mother ever tell you not to play with your food?
963,2250,5,26,105,136,1.2647058823529411,0.04456922123197992,666,"'Extreme surfing,  it's going to be the next big thing.'"
3353,2250,6,24,106,136,1.2647058823529411,0.04577497070560295,666,It's Michael Ovitz...I'm helping him with his comeback
3590,2250,7,22,107,136,1.2647058823529411,0.04694976469560254,666,"Actually, I'm waiting until dinner time."
5028,2261,5,31,119,155,1.264516129032258,0.041015001654154525,666,"Great Meal Aboard"""
2351,2262,6,13,76,95,1.263157894736842,0.05836619601004484,666,I must be stressed. I'm feeling more weight on my shoulders than ever before.
3845,2262,7,26,119,152,1.263157894736842,0.04352140984370994,666,He took me for a ride!
1788,2264,7,22,108,137,1.2627737226277371,0.04664583979511086,666,"I brought it home, you get it ready for dinner."
6033,2264,6,24,107,137,1.2627737226277371,0.045480679010271745,666,White meat or dark meat?
2186,2264,4,28,105,137,1.2627737226277371,0.0430558677687934,666,"I know, I know, but I like the way his toes tickle my back."
5076,2264,4,28,105,137,1.2627737226277371,0.0430558677687934,666,I'm so sorry honey. I couldn't find a chubby one this week.
2193,2264,5,26,106,137,1.2627737226277371,0.044284872770276734,666,"He said he's got an idea to get us on ""Shark Tank."""
2290,2264,7,22,108,137,1.2627737226277371,0.04664583979511086,666,This second job as an Uber driver is really breaking my back.
2336,2264,7,22,108,137,1.2627737226277371,0.04664583979511086,666,I'm giving him a leg up before I take it.
2905,2264,3,30,104,137,1.2627737226277371,0.041790735125958815,666,Surfers!
3107,2264,7,22,108,137,1.2627737226277371,0.04664583979511086,666,I like a bit of ashiatsu massage before dinner.
3429,2264,6,24,107,137,1.2627737226277371,0.045480679010271745,666,"If I flip him, I get first dibs."
3501,2264,5,26,106,137,1.2627737226277371,0.044284872770276734,666,Kiss me and I will Share.
3732,2264,7,22,108,137,1.2627737226277371,0.04664583979511086,666,Get paid to advertise on your head”
4190,2264,7,22,108,137,1.2627737226277371,0.04664583979511086,666,White meat - again!
1898,2264,4,28,105,137,1.2627737226277371,0.0430558677687934,666,You should see the other half.
4207,2264,7,22,108,137,1.2627737226277371,0.04664583979511086,666,"Just wait, he won't have a leg to stand on."
4472,2264,3,30,104,137,1.2627737226277371,0.041790735125958815,666,He promised that I  would star in the remake of “Jaws”.
1623,2264,3,30,104,137,1.2627737226277371,0.041790735125958815,666,He thinks he’s in the shallows.
5962,2264,5,26,106,137,1.2627737226277371,0.044284872770276734,666,"Uber shark, my ass."
5763,2264,7,22,108,137,1.2627737226277371,0.04664583979511086,666,I cannot say he won’t be eaten.
5641,2264,4,28,105,137,1.2627737226277371,0.0430558677687934,666,He thinks he's on solid footing... watch this.
5324,2264,4,28,105,137,1.2627737226277371,0.0430558677687934,666,Let's see how they like it when we take one of their Finns
5232,2264,4,28,105,137,1.2627737226277371,0.0430558677687934,666,"Yes, I am STILL working on it!"
5109,2264,6,24,107,137,1.2627737226277371,0.045480679010271745,666,"So, now I'm a loan shark."
5082,2264,9,18,110,137,1.2627737226277371,0.04889293184196156,666,"I'm a rebel, Ma. I'll play with my food."
4255,2264,11,14,112,137,1.2627737226277371,0.05104119118921744,666,This vegan diet is driving me crazy.
1225,2264,6,24,107,137,1.2627737226277371,0.045480679010271745,666,But my back was killing me.
306,2264,7,22,108,137,1.2627737226277371,0.04664583979511086,666,I’d eat his foot but it smells bad.
661,2264,5,26,106,137,1.2627737226277371,0.044284872770276734,666,He didn’t get the memo - it’s JUMP the shark idiot!
609,2264,5,26,106,137,1.2627737226277371,0.044284872770276734,666,This will be his last selfie
1006,2264,5,26,106,137,1.2627737226277371,0.044284872770276734,666,Do you think he can surf with one leg?
1111,2294,7,23,111,141,1.2624113475177305,0.04573545142240031,666,It pays the bills.
3005,2294,3,31,107,141,1.2624113475177305,0.041066568233002684,666,We’re not allowed to bite until he learns to tread water.
5399,2296,9,26,133,168,1.2619047619047619,0.04241606821417886,666,Haven't you ever heard of a symbiotic ashiatsu relationship?
3633,2297,6,11,71,88,1.2613636363636365,0.06153368597245653,666,So I was just swimming around flossing my jaws with a trash sign that read “Rides for food” when his idiot just hopped on me. You wanna do lunch?
2999,2298,6,23,105,134,1.2611940298507462,0.04608948042903473,666,It worked! Here comes his buddy!
4585,2298,4,27,103,134,1.2611940298507462,0.043586678067389806,666,If my daddy could see me now.
4539,2298,7,21,106,134,1.2611940298507462,0.04729123657563231,666,'Dolphin gigs pay.'
4450,2298,3,29,102,134,1.2611940298507462,0.04227975466244136,666,"I  gave him a choice. Be my periscope, or be my lunch."
4260,2298,5,25,104,134,1.2611940298507462,0.04485553873920508,666,This is what I get for eating his board.
4220,2298,6,23,105,134,1.2611940298507462,0.04608948042903473,666,He’ll attract the tastier ones
4016,2298,7,21,106,134,1.2611940298507462,0.04729123657563231,666,I know... I know it's unbecoming....  but the dude has a wicked Oriental foot massage technique.
3861,2298,3,29,102,134,1.2611940298507462,0.04227975466244136,666,"Just be honest with me, how bad does it look?"
3833,2298,6,23,105,134,1.2611940298507462,0.04608948042903473,666,The best I could manage is a visual decoy.  We are still working on a human call.
3789,2298,6,23,105,134,1.2611940298507462,0.04608948042903473,666,"Scram! After he takes the selfie, he's my lunch."
3740,2298,5,25,104,134,1.2611940298507462,0.04485553873920508,666,Lyft wasn't kidding about inclusion!
3678,2298,5,25,104,134,1.2611940298507462,0.04485553873920508,666,"Well, how do you carry “take-out”?"
3664,2298,6,23,105,134,1.2611940298507462,0.04608948042903473,666,Here's betting he never saw Jaws
3580,2298,7,21,106,134,1.2611940298507462,0.04729123657563231,666,His feet tickle
3478,2298,5,25,104,134,1.2611940298507462,0.04485553873920508,666,I’m in anger management therapy.
3224,2298,7,21,106,134,1.2611940298507462,0.04729123657563231,666,This seal mistook me for a surfboard.
3202,2298,4,27,103,134,1.2611940298507462,0.043586678067389806,666,I think it’s time for a remake of jaws.
3073,2298,6,23,105,134,1.2611940298507462,0.04608948042903473,666,Ugh . . . what fresh hell is this?
3008,2298,4,27,103,134,1.2611940298507462,0.043586678067389806,666,Sorry I can't fish with you today; he doesn't know how to swim.
2816,2298,6,23,105,134,1.2611940298507462,0.04608948042903473,666,Love your morsel fin
2989,2298,5,25,104,134,1.2611940298507462,0.04485553873920508,666,He asked if he could just stick around to so show his girlfriend”
3641,2298,8,19,107,134,1.2611940298507462,0.04846320158106015,666,"‘’This is when my psychology degree comes in handy,let him think he’s the one in control  and his friends will want to join him.’’"
4684,2298,4,27,103,134,1.2611940298507462,0.043586678067389806,666,"Whadd ya mean , 'four squid is TOO much for a skinny one'? You do the shopping next time."
2720,2298,8,19,107,134,1.2611940298507462,0.04846320158106015,666,Incredible balance and breathe control.
6169,2298,4,27,103,134,1.2611940298507462,0.043586678067389806,666,"Technically, I caught him first !!"
6151,2298,4,27,103,134,1.2611940298507462,0.043586678067389806,666,Can you feel bone spurs
6145,2298,7,21,106,134,1.2611940298507462,0.04729123657563231,666,"No Bob, it’s called ashiatsu massage."
5899,2298,7,21,106,134,1.2611940298507462,0.04729123657563231,666,"If they take a selfie and don’t tag me, I eat them."
5833,2298,7,21,106,134,1.2611940298507462,0.04729123657563231,666,Do you want the legs? I'm not a fan of dark meat.
5819,2298,9,17,108,134,1.2611940298507462,0.04960748691599403,666,I like working for Uber Eats.
5716,2298,8,19,107,134,1.2611940298507462,0.04846320158106015,666,Uber is thinking of expanding into new markets
5631,2298,4,27,103,134,1.2611940298507462,0.043586678067389806,666,Dinner's on the table.
5530,2298,7,21,106,134,1.2611940298507462,0.04729123657563231,666,I wasn’t that hungry so I’ll finish it later.
5449,2298,6,23,105,134,1.2611940298507462,0.04608948042903473,666,The doctor says it’s just a cyst.
5435,2298,6,23,105,134,1.2611940298507462,0.04608948042903473,666,Hang Ten?  How about Eat One
5272,2298,6,23,105,134,1.2611940298507462,0.04608948042903473,666,Pilot fish are so passé
5270,2298,6,23,105,134,1.2611940298507462,0.04608948042903473,666,I could eat. All I had today was a bagel.
5250,2298,4,27,103,134,1.2611940298507462,0.043586678067389806,666,You're right.  It is a bit like shiatsu.
5135,2298,8,19,107,134,1.2611940298507462,0.04846320158106015,666,He’s from Sea World
5134,2298,3,29,102,134,1.2611940298507462,0.04227975466244136,666,I took him to Key West and now he wants to go to Mara Lago
5111,2298,5,25,104,134,1.2611940298507462,0.04485553873920508,666,He's just a chum.
5094,2298,5,25,104,134,1.2611940298507462,0.04485553873920508,666,My job is to catch the guys who don't get the metaphor.
4965,2298,6,23,105,134,1.2611940298507462,0.04608948042903473,666,"Yes, Uber is hiring."
4911,2298,5,25,104,134,1.2611940298507462,0.04485553873920508,666,It’s professional courtesy- he’s a lawyer who got in over his head.
4722,2298,8,19,107,134,1.2611940298507462,0.04846320158106015,666,He thinks he's riding the crest of success.
4592,2298,3,29,102,134,1.2611940298507462,0.04227975466244136,666,I felt guilty for taking a bite out of his surfboard
2713,2298,3,29,102,134,1.2611940298507462,0.04227975466244136,666,I decided to try the new take-out spot everybody’s been raving about.
4196,2298,5,25,104,134,1.2611940298507462,0.04485553873920508,666,"Thanks to global warming, Sharq is the new Lyft."
633,2298,8,19,107,134,1.2611940298507462,0.04846320158106015,666,"About 80,000 calories, wanna split it?"
470,2298,7,21,106,134,1.2611940298507462,0.04729123657563231,666,"It's totally copasetic. I get the surfers, he gets their boards."
76,2298,4,27,103,134,1.2611940298507462,0.043586678067389806,666,I think he needs glasses.
991,2298,1,33,100,134,1.2611940298507462,0.03953651417421795,666,Don't tell me you thought he really walked on water
1317,2298,6,23,105,134,1.2611940298507462,0.04608948042903473,666,Would you trim a little off the top?
1319,2298,7,21,106,134,1.2611940298507462,0.04729123657563231,666,"Please, Doc! You gotta help me get this monkey off my back!"
73,2298,8,19,107,134,1.2611940298507462,0.04846320158106015,666,"Ashiatsu, followed by a protein snack, usually uplifts me from the slough of despond."
1358,2298,6,23,105,134,1.2611940298507462,0.04608948042903473,666,Did you tell him we charge for rides?
1363,2298,5,25,104,134,1.2611940298507462,0.04485553873920508,666,I’ve already had my day’s limit. Any interest?
1389,2298,5,25,104,134,1.2611940298507462,0.04485553873920508,666,"I make chum change, but it’s a steady gig."
106,2298,4,27,103,134,1.2611940298507462,0.043586678067389806,666,The worst part is being taken for granted.
1432,2298,7,21,106,134,1.2611940298507462,0.04729123657563231,666,Hor d'oeuvres at 5:00 PM OK?
1555,2298,2,31,101,134,1.2611940298507462,0.04093112267800853,666,I never leave without a packed lunch on my back.
2489,2298,7,21,106,134,1.2611940298507462,0.04729123657563231,666,I didn’t know what having a monkey on my back really meant...
1657,2298,5,25,104,134,1.2611940298507462,0.04485553873920508,666,It is called Ride Sharing.
1961,2298,9,17,108,134,1.2611940298507462,0.04960748691599403,666,"I like mine semi-dry, shaken, not stirred."
2039,2298,3,29,102,134,1.2611940298507462,0.04227975466244136,666,"Your turn, I need to go down"
2106,2298,7,21,106,134,1.2611940298507462,0.04729123657563231,666,"Professional courtesy, he’s an attorney."
2226,2298,7,21,106,134,1.2611940298507462,0.04729123657563231,666,He'd better not start peeing...
1450,2298,4,27,103,134,1.2611940298507462,0.043586678067389806,666,Thought he could jump the shark!
447,2298,6,23,105,134,1.2611940298507462,0.04608948042903473,666,Get Spielberg on the line. He needs to make another one
4378,2367,6,23,106,135,1.2592592592592593,0.04578769832807442,666,"As soon as this guy gets off my back, we'll have that duel."
2519,2368,7,23,113,143,1.2587412587412588,0.0451676312546647,666,He seems so comfortable I can’t bear to disturb him by rolling over and eating him yet.
4615,2369,5,30,120,155,1.2580645161290323,0.04077044946829279,666,He’s starting to piss me off.
811,2369,8,16,100,124,1.2580645161290323,0.051045928602577964,666,Should've voted for Beto.
3758,2371,8,18,106,132,1.2575757575757576,0.04883705637680049,666,Fishing. Can you believe it?
2911,2371,5,24,103,132,1.2575757575757576,0.04514506409940063,666,"Don't laugh, that itch was driving me crazy."
3842,2371,5,24,103,132,1.2575757575757576,0.04514506409940063,666,I would have eaten fewer of them had I known how good it feels to have them walk on my back.
3856,2371,5,24,103,132,1.2575757575757576,0.04514506409940063,666,Jeez Bob. The boss has been on my back all week!
3504,2371,5,24,103,132,1.2575757575757576,0.04514506409940063,666,Is there something on me?
3475,2371,7,20,105,132,1.2575757575757576,0.047638195332599,666,I am regretting being a pescatarian...
3905,2371,5,24,103,132,1.2575757575757576,0.04514506409940063,666,The stand-up paddleboard craze has brought me a lot of new clients.
3381,2371,6,22,104,132,1.2575757575757576,0.046408374605699396,666,"People are friends, not food."
3975,2371,6,22,104,132,1.2575757575757576,0.046408374605699396,666,"Support sharks are allowed now."""
3276,2371,6,22,104,132,1.2575757575757576,0.046408374605699396,666,"He's not heavy, he's my brother."
2991,2371,5,24,103,132,1.2575757575757576,0.04514506409940063,666,He thinks this is the shallow end and I don't have the heart to tell him.
2990,2371,5,24,103,132,1.2575757575757576,0.04514506409940063,666,I just don't have the heart to move. He thinks I'm a sandbar.
2919,2371,4,26,102,132,1.2575757575757576,0.04384536910022607,666,He has no idea !
2913,2371,5,24,103,132,1.2575757575757576,0.04514506409940063,666,"You know, I've heard of white privilege but this is ridiculous."
4706,2371,4,26,102,132,1.2575757575757576,0.04384536910022607,666,He gave up standing on principle long ago.
2200,2371,6,22,104,132,1.2575757575757576,0.046408374605699396,666,He's an apex predator. What else am I supposed to do?
2752,2371,6,22,104,132,1.2575757575757576,0.046408374605699396,666,It's Mueller. He's riding it out.
1852,2371,5,24,103,132,1.2575757575757576,0.04514506409940063,666,"Ok, I'm trying to get with the new ""Kindness PR"" thing for sharks, but this is way too irritating!"
1928,2371,8,18,106,132,1.2575757575757576,0.04883705637680049,666,Better than that shiatsu chair I bought.
1955,2371,4,26,102,132,1.2575757575757576,0.04384536910022607,666,Let me finish rehearsing for my audition at Sea World first.
1959,2371,6,22,104,132,1.2575757575757576,0.046408374605699396,666,"And then when back feels better,  you eat it!"
1969,2371,3,28,101,132,1.2575757575757576,0.04250595217767891,666,"Seriously?""  ""I know... I just didn't have the heart to tell him..."
2075,2371,7,20,105,132,1.2575757575757576,0.047638195332599,666,He keeps calling me “Flipper” too.
2131,2371,7,20,105,132,1.2575757575757576,0.047638195332599,666,He aint heavy. He's my brother.
2143,2371,7,20,105,132,1.2575757575757576,0.047638195332599,666,"Would you like to invite him for dinner, or shall I?"
2196,2371,3,28,101,132,1.2575757575757576,0.04250595217767891,666,I've never recovered from life at Sea World.
4023,2371,5,24,103,132,1.2575757575757576,0.04514506409940063,666,Our dining experience just isn't the same. He hasn't looked up from his phone once.
2274,2371,5,24,103,132,1.2575757575757576,0.04514506409940063,666,"Sorry, I’ve gone keto."
2524,2371,6,22,104,132,1.2575757575757576,0.046408374605699396,666,I believe I was a surfboard in a previous life.
2548,2371,4,26,102,132,1.2575757575757576,0.04384536910022607,666,"In my previous life as a dog, I learned to balance treats on my nose."
2588,2371,6,22,104,132,1.2575757575757576,0.046408374605699396,666,They ran out of doggie bags.
2646,2371,6,22,104,132,1.2575757575757576,0.046408374605699396,666,He feeds me.
2656,2371,6,22,104,132,1.2575757575757576,0.046408374605699396,666,This politically correct thing is starting to grate
2710,2371,5,24,103,132,1.2575757575757576,0.04514506409940063,666,I thought this kind of stuff ended when Steve Irwin died.
2854,2371,5,24,103,132,1.2575757575757576,0.04514506409940063,666,I’ve always wanted to be a dolphin.
4125,2371,5,24,103,132,1.2575757575757576,0.04514506409940063,666,"Yes it's stylish, but the screaming is starting to bother me."
6099,2371,6,22,104,132,1.2575757575757576,0.046408374605699396,666,These Shark Week photographers are getting pretty bold.
4214,2371,7,20,105,132,1.2575757575757576,0.047638195332599,666,"After we eat him, we can
 break the wishbone."
5440,2371,6,22,104,132,1.2575757575757576,0.046408374605699396,666,"It may look demeaning, but I'm told it's called 'rideshare'."
5307,2371,7,20,105,132,1.2575757575757576,0.047638195332599,666,"I said, ""Okay, sure you can swim with the sharks, but who the hell gave them permission to stand on us?"""
5259,2371,6,22,104,132,1.2575757575757576,0.046408374605699396,666,"Well, there are benefits for me too."
4613,2371,4,26,102,132,1.2575757575757576,0.04384536910022607,666,He's all yours. I'll be the dolphin this time.
5200,2371,9,16,107,132,1.2575757575757576,0.05000718444938409,666,He got 'Standing on the shoulder of giants' all wrong.
5160,2371,6,22,104,132,1.2575757575757576,0.046408374605699396,666,They are calling it Scuber.
5122,2371,7,20,105,132,1.2575757575757576,0.047638195332599,666,Let's grab lunch.
5053,2371,6,22,104,132,1.2575757575757576,0.046408374605699396,666,I saw him first!
4901,2371,8,18,106,132,1.2575757575757576,0.04883705637680049,666,"I can’t seem to get this monkey off my back,Stan."
4832,2371,3,28,101,132,1.2575757575757576,0.04250595217767891,666,"I don't like this job either, bit it pays the rent."
1837,2371,5,24,103,132,1.2575757575757576,0.04514506409940063,666,"It’s simple: you take one, I take the other, and each of us makes a wish."
4776,2371,6,22,104,132,1.2575757575757576,0.046408374605699396,666,"Uber and Lyft pay better, but maybe he’ll hang ten"
4658,2371,8,18,106,132,1.2575757575757576,0.04883705637680049,666,I’m full. I thought I’d  leave the rest for you.
4676,2371,4,26,102,132,1.2575757575757576,0.04384536910022607,666,Soon he'll have to change his name to Bob.
4748,2371,5,24,103,132,1.2575757575757576,0.04514506409940063,666,His Thai massage is to die for!
5490,2371,6,22,104,132,1.2575757575757576,0.046408374605699396,666,The joke’s wearing fin.
4167,2371,3,28,101,132,1.2575757575757576,0.04250595217767891,666,No cafeteria for me - I brought my lunch.
5658,2371,7,20,105,132,1.2575757575757576,0.047638195332599,666,Let him post a few selfies first.
5712,2371,3,28,101,132,1.2575757575757576,0.04250595217767891,666,I'll play along for now
4230,2371,7,20,105,132,1.2575757575757576,0.047638195332599,666,Let's split it...one leg each.
4261,2371,8,18,106,132,1.2575757575757576,0.04883705637680049,666,I think that's President Trump looking for his golf ball.
4262,2371,6,22,104,132,1.2575757575757576,0.046408374605699396,666,Stopped smoking weeks ago but there is still a monkey on my back.
4371,2371,7,20,105,132,1.2575757575757576,0.047638195332599,666,This guy must have gills of steel. I've been trying to drown him for hours.
4412,2371,7,20,105,132,1.2575757575757576,0.047638195332599,666,Just when you thought it was safe to go back into the water.
4414,2371,4,26,102,132,1.2575757575757576,0.04384536910022607,666,"I'm tired of dining on all of these free loaders."""
6289,2371,4,26,102,132,1.2575757575757576,0.04384536910022607,666,"So, I launched into my Clint Eastwood as Dirty Harry impersonation.  I said 'you've got to ask yourself one question: Do I feel lucky? Well, do ya, punk?'  Epic non reaction. Zip, zero, nada."""
6232,2371,5,24,103,132,1.2575757575757576,0.04514506409940063,666,He started with with praise and small fishes just like he did with the Orcas.
6094,2371,11,12,109,132,1.2575757575757576,0.05226891369219937,666,"Don't tell the guys, but I volunteer at You-Can-Swim on Fridays."
6093,2371,7,20,105,132,1.2575757575757576,0.047638195332599,666,"It's the latest new spa package - Thai massage, then lunch."
6027,2371,7,20,105,132,1.2575757575757576,0.047638195332599,666,He’s my midnight snack.
4537,2371,5,24,103,132,1.2575757575757576,0.04514506409940063,666,"He says it’s symbiotic, but I feel like he’s walking all over me."
5925,2371,5,24,103,132,1.2575757575757576,0.04514506409940063,666,Have you seen the guy with the tasty looking legs?
5807,2371,4,26,102,132,1.2575757575757576,0.04384536910022607,666,"He's an ""ocean half full"" kinda guy."
5761,2371,5,24,103,132,1.2575757575757576,0.04514506409940063,666,"I'm not exactly getting paid for the shoot, but I'll get a vignette in the special features."
5663,2371,2,30,100,132,1.2575757575757576,0.041122932161109266,666,"Jaws"" Guilt..."
1799,2371,6,22,104,132,1.2575757575757576,0.046408374605699396,666,Wait'll he decides to step off!
3929,2371,5,24,103,132,1.2575757575757576,0.04514506409940063,666,"Humans are friends, not food Jim."
1752,2371,11,12,109,132,1.2575757575757576,0.05226891369219937,666,Here’s your meat order!
815,2371,6,22,104,132,1.2575757575757576,0.046408374605699396,666,"It's like Uber, for sharks."
738,2371,6,22,104,132,1.2575757575757576,0.046408374605699396,666,"Because then I'd have to find a new chiropractor, genius."
603,2371,6,22,104,132,1.2575757575757576,0.046408374605699396,666,"We'll have leftovers for dinner, is that O K with you?"
575,2371,3,28,101,132,1.2575757575757576,0.04250595217767891,666,He just made partner.
526,2371,5,24,103,132,1.2575757575757576,0.04514506409940063,666,"I'm stuffed after that last swimmer, but please, feel free to help yourself."
494,2371,6,22,104,132,1.2575757575757576,0.046408374605699396,666,Well it’s better than being shark fin soup.
488,2371,6,22,104,132,1.2575757575757576,0.046408374605699396,666,Damn. Always when I’m meditating. Can you get this one?
451,2371,4,26,102,132,1.2575757575757576,0.04384536910022607,666,I blame hoverboards.
435,2371,5,24,103,132,1.2575757575757576,0.04514506409940063,666,I packed a lunch today.  You?
382,2371,4,26,102,132,1.2575757575757576,0.04384536910022607,666,"Well, it's a living..."
355,2371,7,20,105,132,1.2575757575757576,0.047638195332599,666,Apparently the 'live surfboard' - thing is a trend now.
333,2371,7,20,105,132,1.2575757575757576,0.047638195332599,666,"This is why I'm always humming ""Duh-dumb, duh-dumb"" before I eat these things."
328,2371,7,20,105,132,1.2575757575757576,0.047638195332599,666,Jaws is finally out of syndication.
259,2371,4,26,102,132,1.2575757575757576,0.04384536910022607,666,I can raise the average IQ in this ocean during lunch.
146,2371,7,20,105,132,1.2575757575757576,0.047638195332599,666,I'm saving this half for later.
145,2371,5,24,103,132,1.2575757575757576,0.04514506409940063,666,I call it a periscope.
83,2371,5,24,103,132,1.2575757575757576,0.04514506409940063,666,I work as a tourist trap.
51,2371,8,18,106,132,1.2575757575757576,0.04883705637680049,666,I'm just really full right now.
48,2371,6,22,104,132,1.2575757575757576,0.046408374605699396,666,Jaws wouldn't let this stand.
5,2371,5,24,103,132,1.2575757575757576,0.04514506409940063,666,It's called 'yoga'.  I hear the humans do it with goats in Portland.
1781,2371,8,18,106,132,1.2575757575757576,0.04883705637680049,666,"I know, I know. ""Don't play with your food."""
875,2371,7,20,105,132,1.2575757575757576,0.047638195332599,666,It's not my taste but I got it half off.
1000,2371,7,20,105,132,1.2575757575757576,0.047638195332599,666,New hood ornament.
68,2371,4,26,102,132,1.2575757575757576,0.04384536910022607,666,Did anyone order Scuba Eats?
1061,2371,5,24,103,132,1.2575757575757576,0.04514506409940063,666,Where's baby shark?
1609,2371,5,24,103,132,1.2575757575757576,0.04514506409940063,666,"Well sure, it's embarrassing, but if Clara found out I've eaten between meals I'd never hear the end of it."
1541,2371,9,16,107,132,1.2575757575757576,0.05000718444938409,666,"Enough of this, Are you ready to make a trade?"
1540,2371,6,22,104,132,1.2575757575757576,0.046408374605699396,666,Apparently this is the new tracking tag system.
1392,2371,4,26,102,132,1.2575757575757576,0.04384536910022607,666,"White man’s always keepin’ me down, man."
1619,2371,8,18,106,132,1.2575757575757576,0.04883705637680049,666,I haven't the heart to let him know I'm not a rock.
1355,2371,4,26,102,132,1.2575757575757576,0.04384536910022607,666,I like to marinate my meat first.
1559,2371,7,20,105,132,1.2575757575757576,0.047638195332599,666,"So, okay, Mom, I turned Vegan - you gonna tell Dad?"
1670,2371,4,26,102,132,1.2575757575757576,0.04384536910022607,666,They always taste better without a struggle.
1175,2371,6,22,104,132,1.2575757575757576,0.046408374605699396,666,"If only this guy knew how ""in over his head"" he really is."
1678,2371,8,18,106,132,1.2575757575757576,0.04883705637680049,666,Do I have a parasite on my back?
1127,2371,7,20,105,132,1.2575757575757576,0.047638195332599,666,I'm scared - he's a loan shark!
1707,2371,5,24,103,132,1.2575757575757576,0.04514506409940063,666,It’s a new anti man-eating intervention program.
1092,2371,6,22,104,132,1.2575757575757576,0.046408374605699396,666,I think it's a wishbone. Make a wish and on the count of three ...
1059,2371,6,22,104,132,1.2575757575757576,0.046408374605699396,666,"Bad timing  for us starting that vegetarian diet, Marshall."
1237,2371,4,26,102,132,1.2575757575757576,0.04384536910022607,666,He raised me from birth.
1591,2371,6,22,104,132,1.2575757575757576,0.046408374605699396,666,I'll give this guy 10 seconds to get off my back!
4647,2488,3,29,104,136,1.2573529411764706,0.04174348934847243,666,It beats trying to use my fin for the itch on my back.
3638,2489,8,20,112,140,1.2571428571428571,0.04686626637671682,666,We call the service “Unter.”
4702,2490,7,28,129,164,1.2560975609756098,0.04114000142387433,666,"If I move, do you think he’ll yell SHARK?"
3749,2490,7,28,129,164,1.2560975609756098,0.04114000142387433,666,They’re endangered
3735,2492,5,23,101,129,1.255813953488372,0.04574833966710416,666,The feet feel really nice but I’m conflicted about the nature vs nurture thing.
16,2493,7,21,109,137,1.2554744525547445,0.04636785759716212,666,Why do I always get stuck with the drumsticks?
3987,2493,6,23,108,137,1.2554744525547445,0.04519553087634805,666,As soon as I get hungry he won't have a leg to stand on.
5445,2495,4,29,112,145,1.2551724137931035,0.04126740935865803,666,It's a new Olympic Water Sport. . Shark Attack.
2997,2496,6,28,123,157,1.2547770700636942,0.04131638680094925,666,I did the damn music!
1372,2497,6,29,126,161,1.2546583850931676,0.040646467672910316,666,I eat anyone who gives me less than four stars.
818,2498,6,21,103,130,1.2538461538461538,0.046731625028052344,666,This is why I'm hoping a Jaws reboot gets greenlit
817,2498,5,23,102,130,1.2538461538461538,0.04543769573146975,666,It's not deep.....
6161,2498,5,23,102,130,1.2538461538461538,0.04543769573146975,666,"What do you mean, what’s in it for you?"
5009,2498,7,19,104,130,1.2538461538461538,0.04799067995079202,666,"They're calling it ""sharking."""
629,2498,6,21,103,130,1.2538461538461538,0.046731625028052344,666,Lunch? No! It's Seaworld's first rodeo.
829,2498,5,23,102,130,1.2538461538461538,0.04543769573146975,666,"Trust me, it's better than my last job."
2493,2498,8,17,105,130,1.2538461538461538,0.0492175369814075,666,"I can’t believe you DON’T have one, Trevor. It’s the latest fashion."
3389,2498,5,23,102,130,1.2538461538461538,0.04543769573146975,666,We'll attack after he posts his selfie.
118,2506,4,26,104,134,1.2537313432835822,0.043273326210569375,666,"Here, you can have the bottom half."
2376,2507,3,25,95,123,1.2520325203252032,0.04410239732049511,666,I haven't been eating between meals.
1162,2508,5,22,100,127,1.2519685039370079,0.046052121475448175,666,It's a new fad with a huge downside
1640,2508,3,26,98,127,1.2519685039370079,0.043253082415981324,666,"Yeah, I know. Humans and their last wishes"
1587,2508,9,14,104,127,1.2519685039370079,0.05119311868016011,666,"He won the Shark Tank, and I lost."
925,2508,3,26,98,127,1.2519685039370079,0.043253082415981324,666,"When I volunteered to be a ""support"" animal, I thought it meant emotional support."
1105,2508,7,18,102,127,1.2519685039370079,0.048690519059619776,666,"Get out of the way, I need five stars for this ride."
1574,2508,6,20,101,127,1.2519685039370079,0.047389685263170035,666,Of course I'm hesitating--I was a broker in my previous life.
1466,2508,4,24,99,127,1.2519685039370079,0.04467452870973071,666,"False sense of security, and then breakfast."
1275,2508,7,18,102,127,1.2519685039370079,0.048690519059619776,666,The kids wanted takeout.
1706,2508,7,18,102,127,1.2519685039370079,0.048690519059619776,666,He thinks he’s walking on water.
1407,2508,6,20,101,127,1.2519685039370079,0.047389685263170035,666,What are you looking at? Human bait is the new cologne.
2792,2508,7,18,102,127,1.2519685039370079,0.048690519059619776,666,And we look nothing like surfboards.
1832,2508,7,18,102,127,1.2519685039370079,0.048690519059619776,666,I'm just giving him a false sense of security.
4611,2508,4,24,99,127,1.2519685039370079,0.04467452870973071,666,"'Super Glue."""
4577,2508,9,14,104,127,1.2519685039370079,0.05119311868016011,666,Human interaction really weighs me down.
4628,2508,4,24,99,127,1.2519685039370079,0.04467452870973071,666,"I'm going to give him a few more minutes,  then it's lunch time."
4814,2508,3,26,98,127,1.2519685039370079,0.043253082415981324,666,It’s almost too easy nowadays.
4882,2508,4,24,99,127,1.2519685039370079,0.04467452870973071,666,He pays $500 a month in rent.
4561,2508,5,22,100,127,1.2519685039370079,0.046052121475448175,666,I like a balanced diet.
4551,2508,4,24,99,127,1.2519685039370079,0.04467452870973071,666,We gotta start targeting these millennials.
4969,2508,2,28,97,127,1.2519685039370079,0.041783307211502446,666,"Swimming with dolphins was one thing, but surfing with sharks...?"
4430,2508,5,22,100,127,1.2519685039370079,0.046052121475448175,666,He hasn’t  seen the movie yet!
787,2508,5,22,100,127,1.2519685039370079,0.046052121475448175,666,I'm sick of this topping.
1755,2508,4,24,99,127,1.2519685039370079,0.04467452870973071,666,Pet humans suck!
5879,2508,8,16,103,127,1.2519685039370079,0.04995749216331898,666,I don't think I can tolerate this guys white privilege much longer.
4166,2508,3,26,98,127,1.2519685039370079,0.043253082415981324,666,I don't know what it is got into me made me discover my compassionate nature somehow...
3818,2508,8,16,103,127,1.2519685039370079,0.04995749216331898,666,I'm going to be late tonight. ...my boss has been on my back all week.
3797,2508,6,20,101,127,1.2519685039370079,0.047389685263170035,666,I just can't bring myself to do it. It feels soooo good.
3629,2508,4,24,99,127,1.2519685039370079,0.04467452870973071,666,It was funnier in the conception than the execution.
3124,2508,6,20,101,127,1.2519685039370079,0.047389685263170035,666,"The top half was tasty, but the bottom is stuck on my fin"
3015,2508,6,20,101,127,1.2519685039370079,0.047389685263170035,666,They really are atop of the food chain?
2826,2508,8,16,103,127,1.2519685039370079,0.04995749216331898,666,"Yes, but I’m a lot more tempted when he hangs ten."
2736,2508,6,20,101,127,1.2519685039370079,0.047389685263170035,666,"It's my lawyer, he's like family."
2102,2508,4,24,99,127,1.2519685039370079,0.04467452870973071,666,"If you can't eat 'em, buoy 'em."
1964,2508,6,20,101,127,1.2519685039370079,0.047389685263170035,666,Ever heard of the Marshmallow Test?
4192,2508,6,20,101,127,1.2519685039370079,0.047389685263170035,666,It sucks being vegan.
258,2508,6,20,101,127,1.2519685039370079,0.047389685263170035,666,"If he shouts ""Cowabunga!"" one more time he's an appetizer."
2439,2508,6,20,101,127,1.2519685039370079,0.047389685263170035,666,"Yeah, but the pay is good."
122,2508,7,18,102,127,1.2519685039370079,0.048690519059619776,666,"Lighten up, it's casual Friday."
133,2508,4,24,99,127,1.2519685039370079,0.04467452870973071,666,"I can't eat him he owes me money, so I'm forced to carry him for awhile."
85,2508,2,28,97,127,1.2519685039370079,0.041783307211502446,666,Mine's to go.
2737,2548,6,21,104,131,1.251908396946565,0.046413990756227416,666,"It's a little demeaning, but my small business is thriving."
2636,2548,4,25,102,131,1.251908396946565,0.043810716882134705,666,I caught this one off the coast oF Long Island
2573,2548,6,21,104,131,1.251908396946565,0.046413990756227416,666,He has a long-running television show that’s about to make no sense.
2436,2548,6,21,104,131,1.251908396946565,0.046413990756227416,666,"Once you deliver them to their destinations, you get to eat 25%."
2100,2548,6,21,104,131,1.251908396946565,0.046413990756227416,666,ewwwmooommmmm! getitoffgetitoffgeitofffffff!!!
2069,2548,5,23,103,131,1.251908396946565,0.0451311281248637,666,"He thinks I’m Flipper, lol"
2066,2548,5,23,103,131,1.251908396946565,0.0451311281248637,666,Take-out for lunch
2019,2548,5,23,103,131,1.251908396946565,0.0451311281248637,666,I knew I shouldn't have become a vegetarian...
1960,2548,5,23,103,131,1.251908396946565,0.0451311281248637,666,I’ll split him with you if you get him off my back
1823,2548,2,29,100,131,1.251908396946565,0.04104265207724717,666,Do we really want to attack the last member of the species that doesn't believe in global warming?
1817,2548,7,19,105,131,1.251908396946565,0.047662336808170294,666,Did you eat the top half?
1782,2548,4,25,102,131,1.251908396946565,0.043810716882134705,666,A stand in for JAWS
1424,2548,6,21,104,131,1.251908396946565,0.046413990756227416,666,My therapist said to keep calm but...he's really pushing my limits here
1379,2548,7,19,105,131,1.251908396946565,0.047662336808170294,666,You ordered Jake tartare?
1213,2548,7,19,105,131,1.251908396946565,0.047662336808170294,666,Did you order the human?
911,2548,7,19,105,131,1.251908396946565,0.047662336808170294,666,"Welcome to Long Island, where they used to fear us"
795,2548,7,19,105,131,1.251908396946565,0.047662336808170294,666,I'm training him to attract bait.
2812,2548,6,21,104,131,1.251908396946565,0.046413990756227416,666,Harvard Law. I'm stuck with him for the next twelve weeks.
2865,2548,7,19,105,131,1.251908396946565,0.047662336808170294,666,I’m packing a lunch.
2901,2548,7,19,105,131,1.251908396946565,0.047662336808170294,666,Just download the app: It’s “sharx” with an “x”
2912,2548,5,23,103,131,1.251908396946565,0.0451311281248637,666,"So I started driving for SCUBER  .
I mean I’m back and forth anyway."
6220,2548,6,21,104,131,1.251908396946565,0.046413990756227416,666,Slim pickens this season.
6167,2548,5,23,103,131,1.251908396946565,0.0451311281248637,666,First they came for the whales...
6107,2548,5,23,103,131,1.251908396946565,0.0451311281248637,666,I ate his surf board and this is what the judge came up with.  It's only on the weekends until i can come up with the cash.  But you can eat him if you want...
4975,2548,5,23,103,131,1.251908396946565,0.0451311281248637,666,"The last time I ate legs like that,I became a vegetarian."
4522,2548,6,21,104,131,1.251908396946565,0.046413990756227416,666,"Adjusts my cartilage, then he's a snack. What's better than that!"
4431,2548,5,23,103,131,1.251908396946565,0.0451311281248637,666,"Are you a Nurse Shark?
He's gonna need you"
4355,2548,5,23,103,131,1.251908396946565,0.0451311281248637,666,Wanna' see something funny?
4221,2548,5,23,103,131,1.251908396946565,0.0451311281248637,666,It's a steady gig until they get the L train fixed...
741,2548,4,25,102,131,1.251908396946565,0.043810716882134705,666,Our relation is somelike long distance relation but more itimate.
4130,2548,4,25,102,131,1.251908396946565,0.043810716882134705,666,"The invitation said ""Bring you own food""."
3796,2548,4,25,102,131,1.251908396946565,0.043810716882134705,666,They would call it chum.
3523,2548,8,17,106,131,1.251908396946565,0.048878810972769846,666,He thinks he is on his surfboard!
3506,2548,8,17,106,131,1.251908396946565,0.048878810972769846,666,Watch me do a 180 and end this stand up paddle boarding craze forever.
3444,2548,7,19,105,131,1.251908396946565,0.047662336808170294,666,What he can't see can't hurt him.
3400,2548,7,19,105,131,1.251908396946565,0.047662336808170294,666,The hard part was finding a taxidermist for this trophy.
3203,2548,6,21,104,131,1.251908396946565,0.046413990756227416,666,"Next time I`ll go for the deep tissue, instead of the Thai massage."
3122,2548,8,17,106,131,1.251908396946565,0.048878810972769846,666,He thinks he can still touch here. At this point I don’t know how to leave.
2963,2548,4,25,102,131,1.251908396946565,0.043810716882134705,666,"it's like their marshmallow test, Dear... just eat him right now and risk the beach closing down...or wait 15minutes and feast when all his idiot buddies join!"
3885,2548,10,13,108,131,1.251908396946565,0.051225167508797534,666,You smell something fishy?
506,2548,6,21,104,131,1.251908396946565,0.046413990756227416,666,At least with Scuber I get to set my own hours.
2786,2548,5,23,103,131,1.251908396946565,0.0451311281248637,666,Too lean for me. Wanna try a bite?
371,2548,5,23,103,131,1.251908396946565,0.0451311281248637,666,I rented myself out as a floatation device. Imagine his surprise when he gets the bill.
312,2548,6,21,104,131,1.251908396946565,0.046413990756227416,666,Just bringing some leftovers to a potluck.
307,2548,7,19,105,131,1.251908396946565,0.047662336808170294,666,Where's the respect.
207,2548,6,21,104,131,1.251908396946565,0.046413990756227416,666,Too easy.
97,2548,6,21,104,131,1.251908396946565,0.046413990756227416,666,Thought I’d get a foot massage before dinner.
427,2548,4,25,102,131,1.251908396946565,0.043810716882134705,666,"Professional courtesy to lawyers
Frank Buckley Andover, MA"
3751,2596,9,21,125,155,1.2516129032258065,0.04446163400948276,666,I could only eat half of it. Just wasn’t that hungry.
5698,2597,8,15,101,124,1.25,0.050729015290999296,666,"I’ll admit, Uber Surfing is a niche market, but lunch is free."
5579,2597,6,21,105,132,1.25,0.046100544855210326,666,He wants one last selfie.
5370,2597,7,17,100,124,1.25,0.04941965852606572,666,"I don't want to drive Uber forever, but it pays the bills for now."
5341,2597,6,19,99,124,1.25,0.04807465345971242,666,It's not what you think!
3738,2597,4,23,97,124,1.25,0.04526490492808352,666,"Dude, make him hang five"
6080,2597,5,29,122,156,1.25,0.0402894818662241,666,Take out is always best the day after.
3592,2597,6,19,99,124,1.25,0.04807465345971242,666,He took a thorn out of my paw.
3554,2597,5,21,98,124,1.25,0.04669091947809488,666,I've got a bite.
2794,2597,4,23,97,124,1.25,0.04526490492808352,666,"Listen, I’m sick of this Circue de Soleil stuff. It’s your turn!"
3161,2597,4,23,97,124,1.25,0.04526490492808352,666,Well this can't make my scoliosis any better.
6263,2597,6,19,99,124,1.25,0.04807465345971242,666,I can't talk now.  My food is burning.
2391,2597,7,18,103,128,1.25,0.04834871689297298,666,"Yes I know, for 400 million years we were the undisputed apex predators, but pasty-leggs here is a cutthroat big Pharma lobbyist!"
1923,2597,8,15,101,124,1.25,0.050729015290999296,666,"Hazel stared in stony silence. Once again George brought home the dark meat, having selfishly eaten all the white meat on the way home."
1310,2597,7,17,100,124,1.25,0.04941965852606572,666,Vegan sucks.
988,2597,6,19,99,124,1.25,0.04807465345971242,666,"If this is what he thought they meant by 'swimming with the sharks', I'm going to show him what it means to put 'foot in mouth'."
797,2597,5,21,98,124,1.25,0.04669091947809488,666,The hardest part is giving up human.
408,2597,5,21,98,124,1.25,0.04669091947809488,666,Lay off Killer. Our PR has been terrible since Jaws.
5995,2597,9,15,108,132,1.25,0.049721640147515817,666,"Just wait ‘til he tries 
to hang-ten."
3668,2597,6,29,129,164,1.25,0.039990085558669106,666,I have to replace the board I damaged
766,2597,5,21,98,124,1.25,0.04669091947809488,666,The polls say it makes me less threatening.
1835,2597,7,19,106,132,1.25,0.0473383634798584,666,There's a new sushi takeout sandbar – off the west end of the pier.
1908,2597,5,23,104,132,1.25,0.04482856025954131,666,"Great for your back, though"
2579,2597,4,25,103,132,1.25,0.04351941398892446,666,He requested one last selfie.
860,2597,7,19,106,132,1.25,0.0473383634798584,666,What ever happened to the thrill of the hunt?
696,2597,5,21,98,124,1.25,0.04669091947809488,666,I wish they’d cut their toenails.
1978,2622,4,24,101,129,1.248062015503876,0.044065182174039035,666,"Why do you think he keeps saying, ""I am proud to stand on the shoulders of those who came before me!""?"
3185,2623,1,29,95,125,1.248,0.040410793831159975,666,"Sure, take it.  But the upper half gave me gas."
1948,2623,3,25,97,125,1.248,0.043486742510718705,666,I'm using him as bait for something meatier
1975,2623,8,15,102,125,1.248,0.05036127544568475,666,"HE THOUGHT THEY SAID BAREFOOT IN THE PARK, NOT SHARK"
1983,2623,3,25,97,125,1.248,0.043486742510718705,666,That's it. I'm so done entertaining people at SeaWorld.
2017,2623,7,17,101,125,1.248,0.04906348750804017,666,You want a Piece of this?
2121,2623,5,21,99,125,1.248,0.04635904755624927,666,"He just said come on in the water's fine. Tell the kids dinner will be ready in two minutes."""
2319,2623,4,23,98,125,1.248,0.04494584555059639,666,They tell me it will improve my sex life.
2494,2623,3,25,97,125,1.248,0.043486742510718705,666,This is my final test in my weight loss management course.
2544,2623,5,21,99,125,1.248,0.04635904755624927,666,I have no qualms about eating something that stupid.
2674,2623,4,23,98,125,1.248,0.04494584555059639,666,"Sorry, I forgot the milk."
2734,2623,7,17,101,125,1.248,0.04906348750804017,666,This new yoga is all the rage...humans climb on your back.
2803,2623,4,23,98,125,1.248,0.04494584555059639,666,"Yeah, I know how it looks, but Dolphin World was the only one hiring."
2871,2623,5,21,99,125,1.248,0.04635904755624927,666,"Seriously, how did we manage before Instagram?"
2937,2623,4,23,98,125,1.248,0.04494584555059639,666,What... like you don't have any fetishes?
2942,2623,6,19,100,125,1.248,0.04773042581401404,666,I told you I'd get a leg up on you.
3002,2623,6,19,100,125,1.248,0.04773042581401404,666,"I thought it looked nice... But if you really hate it that much, I’ll return it."
3225,2623,5,21,99,125,1.248,0.04635904755624927,666,Where would you like to have dinner tonight?
3024,2623,6,19,100,125,1.248,0.04773042581401404,666,I'm his Uber Pool.
2543,2623,8,15,102,125,1.248,0.05036127544568475,666,The stupid ones taste terrible!
3047,2623,2,27,96,125,1.248,0.04197695220152403,666,"Don’t say a word...he was dog paddling and got tired, what was I suppose to do?"
6092,2623,6,19,100,125,1.248,0.04773042581401404,666,Is this a good wishbone or what?
4188,2623,5,21,99,125,1.248,0.04635904755624927,666,He won’t swim with us. He says wading is safer.
4991,2623,4,23,98,125,1.248,0.04494584555059639,666,Its not my fault it you didn't pack a lunch
3896,2623,7,17,101,125,1.248,0.04906348750804017,666,"Karl, don't play with your food."
4208,2623,5,21,99,125,1.248,0.04635904755624927,666,Amuse-bouche?
4925,2623,5,21,99,125,1.248,0.04635904755624927,666,In five minutes time he won't have a leg to stand on
4768,2623,6,19,100,125,1.248,0.04773042581401404,666,"Go ahead and laugh, I'm trying out a 'Stand Up' comedy routine"
4248,2623,3,25,97,125,1.248,0.043486742510718705,666,I've had this persistent headache since shark surfing became a trend.
5052,2623,3,25,97,125,1.248,0.043486742510718705,666,That's what happens when you go vegan.
3938,2623,7,17,101,125,1.248,0.04906348750804017,666,Ocean Uber Eats
4596,2623,5,21,99,125,1.248,0.04635904755624927,666,Wait!  He says his older brother will be bigger and tastier than he is.
4055,2623,7,17,101,125,1.248,0.04906348750804017,666,But I do kinda admire his chutzpah
4380,2623,6,19,100,125,1.248,0.04773042581401404,666,Just let them think you're a dolphin. We'll catch more that way.
4583,2623,4,23,98,125,1.248,0.04494584555059639,666,His fearless naivety was so endearing I couldn't eat him.
4552,2623,5,21,99,125,1.248,0.04635904755624927,666,"It's called a Watsu massage, it was developed by some hippie in California."
4187,2623,1,29,95,125,1.248,0.040410793831159975,666,I'll do dinner tonight.
1751,2623,8,15,102,125,1.248,0.05036127544568475,666,I hear this all started with goat yoga.
5206,2623,5,21,99,125,1.248,0.04635904755624927,666,"I just can’t shake the addiction ! They’re so delicious, but a bitch to clean !"
5212,2623,3,25,97,125,1.248,0.043486742510718705,666,I'm just waiting for it to marinate.
5264,2623,3,25,97,125,1.248,0.043486742510718705,666,You're late! Dinner's getting cold
6216,2623,6,19,100,125,1.248,0.04773042581401404,666,Let's just say he's my wingman.
3576,2623,8,15,102,125,1.248,0.05036127544568475,666,"Don't laugh, it keeps the dorsal fin from showing. I can get super close before they realize I'm about to attack."
6019,2623,6,19,100,125,1.248,0.04773042581401404,666,I bit his surfboard in half and this is part of the settlement.
3765,2623,3,25,97,125,1.248,0.043486742510718705,666,I prefer the pilot fish cleaning
5973,2623,8,15,102,125,1.248,0.05036127544568475,666,"I'm trying.  I'm really trying."""
5774,2623,7,17,101,125,1.248,0.04906348750804017,666,One Man's Uber is another Shark's Grubhub.
5694,2623,5,21,99,125,1.248,0.04635904755624927,666,He’s holding my phone.
3768,2623,8,15,102,125,1.248,0.05036127544568475,666,"So I figured, what the hell, why not moonlight as a Segway?"
3862,2623,7,17,101,125,1.248,0.04906348750804017,666,This one is a slam-dunk. I dunk him. You slam him.
4193,2623,5,21,99,125,1.248,0.04635904755624927,666,I’m working PR for Animal Planet
5620,2623,8,15,102,125,1.248,0.05036127544568475,666,"Yeah, he wants to settle down but you know me. I have to keep moving."
5593,2623,3,25,97,125,1.248,0.043486742510718705,666,"Obviously he hasn't seen Jaws""..."
5557,2623,7,17,101,125,1.248,0.04906348750804017,666,... and they think they are at the top of the food chain.
5481,2623,5,21,99,125,1.248,0.04635904755624927,666,The hindquarters are not kosher.
5326,2623,5,21,99,125,1.248,0.04635904755624927,666,"I just ate, so I'm keeping him for tomorrow."
3431,2623,4,23,98,125,1.248,0.04494584555059639,666,I brought my lunch today.
1701,2623,4,23,98,125,1.248,0.04494584555059639,666,"Life at the aquatic park sure isn’t Jaws, is it?”

Robert Van Brocklin, Portland, Ore"
1236,2623,4,23,98,125,1.248,0.04494584555059639,666,It's part of the corporate training they're making us do called Being the Master of Your Impulses or some such b.s. like that.
1239,2623,3,25,97,125,1.248,0.043486742510718705,666,He used to keep a lookout perched on someone else's gigantic tail.
1495,2623,7,17,101,125,1.248,0.04906348750804017,666,Of course I could eat him. But you forgot I’m a vegan.
69,2623,6,19,100,125,1.248,0.04773042581401404,666,"How about this, he thinks he can get a free ride."
179,2623,4,23,98,125,1.248,0.04494584555059639,666,Stupid humans - in over their head and they never know it!
241,2623,6,19,100,125,1.248,0.04773042581401404,666,It's community service
308,2623,3,25,97,125,1.248,0.043486742510718705,666,"I know it's unconventional, but it really helps loosen up my back."
361,2623,5,21,99,125,1.248,0.04635904755624927,666,"It's called symbiosis, Barry. I get a back massage and he gets to not be lunch."
384,2623,4,23,98,125,1.248,0.04494584555059639,666,This is the next step after swimming with dolphins. It's also the last step.
421,2623,4,23,98,125,1.248,0.04494584555059639,666,My doctor said I need to have a more balanced diet.
569,2623,5,21,99,125,1.248,0.04635904755624927,666,Humans...it's like they're trying to get eaten
577,2623,6,19,100,125,1.248,0.04773042581401404,666,He said he’s a fascinator.
297,2623,4,23,98,125,1.248,0.04494584555059639,666,He followed me home; can I keep him?
832,2623,4,23,98,125,1.248,0.04494584555059639,666,"Okay, but I only sold out to A man, not THE man."
834,2623,5,21,99,125,1.248,0.04635904755624927,666,"Its an experiment, see if we can develop a symbiotic relationship."
916,2623,5,21,99,125,1.248,0.04635904755624927,666,I deal with this every year during Shark Week
939,2623,4,23,98,125,1.248,0.04494584555059639,666,Supposedly the adjustments will help with my lower fin issues. We'll see.
952,2623,2,27,96,125,1.248,0.04197695220152403,666,I am planning on a light lunch.
981,2623,5,21,99,125,1.248,0.04635904755624927,666,I keep telling him he's going to need a bigger shark.
1154,2623,7,17,101,125,1.248,0.04906348750804017,666,He will be de-feeted!
1195,2623,9,13,103,125,1.248,0.051626449835144056,666,He says he's The Fonz and he's going to ruin television forever.
1222,2623,5,21,99,125,1.248,0.04635904755624927,666,This joker is about to get a food chain lesson he'll never forget.
709,2623,6,19,100,125,1.248,0.04773042581401404,666,"He's outside my HMO coverage,but what he does for my dorsal pain is worth it's weight in seal."
5675,2703,5,12,72,89,1.247191011235955,0.05823611478692686,666,Stay calm. They can smell your fear of extinction within their personal bubble.
4567,2704,5,20,97,122,1.2459016393442623,0.04700986675286886,666,You’re acting like you’ve never seen a Hammertoe shark before.
4530,2704,4,22,96,122,1.2459016393442623,0.04554607090890052,666,My Anger Management class suggests de-escalation but maybe submerging would be better.
3673,2704,5,20,97,122,1.2459016393442623,0.04700986675286886,666,"For dramatic effect I have him make the “dunn dun, dunn dun” noise as I approach the shore."
3525,2704,3,24,95,122,1.2459016393442623,0.04403364143873072,666,I thought I'd pack a lunch for the beach.
3117,2704,7,16,99,122,1.2459016393442623,0.04980856920139613,666,My overbite is the problem.
956,2704,3,24,95,122,1.2459016393442623,0.04403364143873072,666,I signed up for Lyft and Uber.
2317,2704,5,20,97,122,1.2459016393442623,0.04700986675286886,666,Don't look at me that way. Lyft is expanding and it's a job with a 401(k) plan.
1784,2704,3,24,95,122,1.2459016393442623,0.04403364143873072,666,Do I tell him?
1676,2704,4,22,96,122,1.2459016393442623,0.04554607090890052,666,Best bobbing-head doll I’ve ever had!
1505,2704,6,18,98,122,1.2459016393442623,0.048429439073835824,666,Never fails. These inflatable humans always manage to scare the baby sharks.
5737,2704,7,16,99,122,1.2459016393442623,0.04980856920139613,666,He won’t be able to keep his head above water in this economy.
3038,2704,6,18,98,122,1.2459016393442623,0.048429439073835824,666,What? You've never had chicken legs before?
4247,2716,5,12,73,90,1.2444444444444445,0.057650873789708366,666,It helps with the cravings.
3671,2717,5,22,104,131,1.2442748091603053,0.044802172391748794,666,Did you call UberEats?
2091,2717,5,22,104,131,1.2442748091603053,0.044802172391748794,666,Yeah! They’re not even as meaty  as the chicken wings down at  The Ocean Club.
5946,2717,6,20,105,131,1.2442748091603053,0.046094191207963264,666,"I hate when they don’t bring the food all at once, please, go ahead...."
6245,2720,4,23,100,127,1.2440944881889764,0.04432066548417608,666,I was raised in Seaworld.
2289,2721,3,24,96,123,1.2439024390243902,0.043719910220988874,666,What about this is supposed to be relaxing?
2154,2721,5,20,98,123,1.2439024390243902,0.04666894676742699,666,Do you think he's gluten-free?
2035,2721,3,24,96,123,1.2439024390243902,0.043719910220988874,666,I like them sunburnt!!
2020,2721,5,20,98,123,1.2439024390243902,0.04666894676742699,666,We’ll both die if I stop moving.
1994,2721,1,28,94,123,1.2439024390243902,0.040557003181715984,666,I've heard they taste better with a squeeze of lemon.
2427,2721,4,22,97,123,1.2439024390243902,0.045218475992188534,666,"Take over for me,  Will you? I’ve just got to get a bite to eat."
2743,2721,4,22,97,123,1.2439024390243902,0.045218475992188534,666,I just feel bad for the ones who can't even swim.
1901,2721,4,22,97,123,1.2439024390243902,0.045218475992188534,666,It was this or becoming shark-skinned shoes.
1829,2721,4,22,97,123,1.2439024390243902,0.045218475992188534,666,He thinks he's standing on the sand. Should we tell him?
1712,2721,5,20,98,123,1.2439024390243902,0.04666894676742699,666,"I’m letting him rest for a moment, they say it makes the meat more tender."
2535,2721,7,16,100,123,1.2439024390243902,0.04944239714081975,666,i left you half.
2293,2721,4,22,97,123,1.2439024390243902,0.045218475992188534,666,I'm using him a bait.
2877,2721,7,16,100,123,1.2439024390243902,0.04944239714081975,666,Jesus is up to his old tricks again.
4367,2721,5,20,98,123,1.2439024390243902,0.04666894676742699,666,And heʻs singing the Baby Shark song
3260,2721,8,14,101,123,1.2439024390243902,0.050772341450393485,666,"He keeps telling me he’s Brian Wilson, so..."
5945,2721,1,28,94,123,1.2439024390243902,0.040557003181715984,666,Did you bring the Old Bay and butter?
5829,2721,7,16,100,123,1.2439024390243902,0.04944239714081975,666,It's a shame he didn't come with more legs.
5804,2721,4,22,97,123,1.2439024390243902,0.045218475992188534,666,"What, you've gone vegan now too?"
5630,2721,6,18,99,123,1.2439024390243902,0.04807567590482465,666,I’ll eat him right after he’s done with my massage!
5521,2721,5,20,98,123,1.2439024390243902,0.04666894676742699,666,I thought they said to pack a lunch???
5476,2721,7,16,100,123,1.2439024390243902,0.04944239714081975,666,How do I tell him?
5446,2721,2,26,95,123,1.2439024390243902,0.04216812218259812,666,keepin' him alive and fresh until I'm hungry
5346,2721,4,22,97,123,1.2439024390243902,0.045218475992188534,666,He’s taking a stand because I ate his uncle last month.
5284,2721,4,22,97,123,1.2439024390243902,0.045218475992188534,666,I just feel a need to make some kind of amends.
5116,2721,3,24,96,123,1.2439024390243902,0.043719910220988874,666,"Then why do I feel like I’m at the bottom-of-the-foot chain, Gary?"
5024,2721,4,22,97,123,1.2439024390243902,0.045218475992188534,666,I've been trying to save money by bringing my lunch to work.
4906,2721,6,18,99,123,1.2439024390243902,0.04807567590482465,666,"I wanted to have it removed, but insurance wouldn’t cover it."
3093,2721,3,24,96,123,1.2439024390243902,0.043719910220988874,666,"When I ate his surfboard, I didn't know he was a lawyer."
4895,2721,3,24,96,123,1.2439024390243902,0.043719910220988874,666,I am saving him -- for Lunch.
4428,2721,5,20,98,123,1.2439024390243902,0.04666894676742699,666,Because he lost his flippers.
1626,2721,4,22,97,123,1.2439024390243902,0.045218475992188534,666,I hate working at Sea World.
4258,2721,3,24,96,123,1.2439024390243902,0.043719910220988874,666,Your order is ready.
3949,2721,2,26,95,123,1.2439024390243902,0.04216812218259812,666,"It’s my periscope.
The seals never see me coming."
3794,2721,4,22,97,123,1.2439024390243902,0.045218475992188534,666,"I don’t care what they say, this vegan diet really messes with the ecosystem."
3685,2721,5,20,98,123,1.2439024390243902,0.04666894676742699,666,"I don’t care what he looks like.
He’s my son."
3631,2721,3,24,96,123,1.2439024390243902,0.043719910220988874,666,You look different...did you do something with you fin?
3547,2721,7,16,100,123,1.2439024390243902,0.04944239714081975,666,I'm conflicted...Am I Uber Ride Share or Uber food delivery ...?
3526,2721,7,16,100,123,1.2439024390243902,0.04944239714081975,666,"yeah,crazy huh? he mentioned something about a scorpion and a frog..."
3317,2721,2,26,95,123,1.2439024390243902,0.04216812218259812,666,My therapist told me it would help with developing patience
3295,2721,3,24,96,123,1.2439024390243902,0.043719910220988874,666,"He was a surfer, I missed."
3277,2721,5,20,98,123,1.2439024390243902,0.04666894676742699,666,"But,I saw him first !"
4525,2721,6,18,99,123,1.2439024390243902,0.04807567590482465,666,"Hey, George, can you help me out?  Is this a pimple on my forehead?"
1458,2721,5,20,98,123,1.2439024390243902,0.04666894676742699,666,What did you do with the other half?
1603,2721,4,22,97,123,1.2439024390243902,0.045218475992188534,666,We're hoping to go viral.
186,2721,3,24,96,123,1.2439024390243902,0.043719910220988874,666,"My favorite, swimmer surprise!"
1118,2721,5,20,98,123,1.2439024390243902,0.04666894676742699,666,Should I tell him I ate his paddle board?
1091,2721,5,20,98,123,1.2439024390243902,0.04666894676742699,666,"I don't think he understands the whole ""jumping the shark"" thing."
1046,2721,3,24,96,123,1.2439024390243902,0.043719910220988874,666,I am so loosing teeth over this new ride-share app.
946,2721,4,22,97,123,1.2439024390243902,0.045218475992188534,666,"Yeah, but have you seen the hair on his back?"
843,2721,8,14,101,123,1.2439024390243902,0.050772341450393485,666,"Well, he's a lawyer so its a professional courtesy thing."
520,2721,4,22,97,123,1.2439024390243902,0.045218475992188534,666,This is EXACTLY what it looks like.
326,2721,3,24,96,123,1.2439024390243902,0.043719910220988874,666,"Yeah, but if I get hungry, I just dive."
225,2721,4,22,97,123,1.2439024390243902,0.045218475992188534,666,I never go anywhere without a snack.
1149,2721,2,26,95,123,1.2439024390243902,0.04216812218259812,666,I picked the wrong time to be a vegetarian
6,2721,3,24,96,123,1.2439024390243902,0.043719910220988874,666,What? I can't get a massage once in a while?
1967,2776,5,22,105,132,1.2424242424242424,0.044499961820624365,666,"Uber Boat may pay the bills, but nothing beats Uber Eats."
1369,2776,4,24,104,132,1.2424242424242424,0.04318085433421962,666,So he doesn't realise he's standing on shaky ground.  Are you going to tell him?
159,2776,7,18,107,132,1.2424242424242424,0.04702730530282264,666,Now do you believe I used to work at Sea World?
4000,2776,5,22,105,132,1.2424242424242424,0.044499961820624365,666,Got any ketchup?
303,2780,6,18,100,124,1.2419354838709677,0.047726941741491634,666,Are you ready to make a wish?
3571,2781,4,21,95,120,1.2416666666666667,0.04582855844748356,666,You take the bottom half
3907,2781,5,19,96,120,1.2416666666666667,0.04733194261577883,666,"Sure I want to eat him, but I have to maintain my 4.8 rating."
3653,2781,3,23,94,120,1.2416666666666667,0.04427415439017953,666,I get the legs
3615,2781,6,17,97,120,1.2416666666666667,0.04878902350111492,666,"They taste too un-fishy. Besides, where else can you get a massage?"
2522,2781,3,23,94,120,1.2416666666666667,0.04427415439017953,666,I don't want to bite him. YOU bite him.
3958,2781,5,19,96,120,1.2416666666666667,0.04733194261577883,666,Well... haven’t you tried Noom?
4012,2781,5,19,96,120,1.2416666666666667,0.04733194261577883,666,And I thought remoras were annoying.
4070,2781,5,19,96,120,1.2416666666666667,0.04733194261577883,666,He promised to convince the swim class kids that it wasn’t that deep
3545,2781,8,13,99,120,1.2416666666666667,0.05157984935040302,666,What an idiot
4203,2781,3,23,94,120,1.2416666666666667,0.04427415439017953,666,I'm trying a more balanced diet.
4206,2781,4,21,95,120,1.2416666666666667,0.04582855844748356,666,My back hasn't felt so good in years.
3921,2781,6,17,97,120,1.2416666666666667,0.04878902350111492,666,What can I do? He is a lawyer.
4156,2781,3,23,94,120,1.2416666666666667,0.04427415439017953,666,It's a scab.  My pilot fish are on strike.
3102,2781,0,29,91,120,1.2416666666666667,0.03924325011691262,666,I thought 'getting then off your back' was just a manner of speaking!
6314,2781,4,21,95,120,1.2416666666666667,0.04582855844748356,666,"Hey, gotta take advantage of the rising sea level.  I call it Süber."
2542,2781,6,17,97,120,1.2416666666666667,0.04878902350111492,666,I'm going to wait until he eats the snack box on the beach.
2568,2781,3,23,94,120,1.2416666666666667,0.04427415439017953,666,Hold my beer
2574,2781,2,25,93,120,1.2416666666666667,0.04266315417964886,666,Invitation said we're all supposed to wear party hats.
2615,2781,6,17,97,120,1.2416666666666667,0.04878902350111492,666,The minute I go plant-based...
2637,2781,7,15,98,120,1.2416666666666667,0.0502038328875526,666,"I was typecast as “Jaws,” my career dried up and now I’m doing this."
2747,2781,8,13,99,120,1.2416666666666667,0.05157984935040302,666,I'm saving the bottom half for dessert.
2750,2781,6,17,97,120,1.2416666666666667,0.04878902350111492,666,"I'm totally addicted to home delivery; the food is always warm, too."
2796,2781,5,19,96,120,1.2416666666666667,0.04733194261577883,666,This guy is very lucky that I'm not ticklish.
2837,2781,3,23,94,120,1.2416666666666667,0.04427415439017953,666,Perhaps a low I.Q. individual?
2924,2781,4,21,95,120,1.2416666666666667,0.04582855844748356,666,I needed a lift.
2931,2781,2,25,93,120,1.2416666666666667,0.04266315417964886,666,"I find when I'm using a teenage bait I can land those lifeguards 1,2,3."
2941,2781,6,17,97,120,1.2416666666666667,0.04878902350111492,666,"Its ""Mr. Wonderful""  showing how to win in business."
3014,2781,3,23,94,120,1.2416666666666667,0.04427415439017953,666,After the massage I'll share a leg with you.
4292,2781,5,19,96,120,1.2416666666666667,0.04733194261577883,666,"Just my luck, his feet stink to high heaven."
3298,2781,5,19,96,120,1.2416666666666667,0.04733194261577883,666,Water taxi is my side hustle
3327,2781,4,21,95,120,1.2416666666666667,0.04582855844748356,666,You ordered the legs?
3402,2781,3,23,94,120,1.2416666666666667,0.04427415439017953,666,"If he takes another step or two, he's saltimbocca."
3474,2781,4,21,95,120,1.2416666666666667,0.04582855844748356,666,It's somewhat annoying but they taste way better when caught fresh.
4327,2781,6,17,97,120,1.2416666666666667,0.04878902350111492,666,Do you really think a mosquito could kill more humans than a shark! No one should even care about bug spray in summer!
6196,2781,3,23,94,120,1.2416666666666667,0.04427415439017953,666,I thought I had tops.
4411,2781,4,21,95,120,1.2416666666666667,0.04582855844748356,666,I guess goat yoga is passé.
5313,2781,6,17,97,120,1.2416666666666667,0.04878902350111492,666,He’s a lawyer. It’s professional courtesy.
5265,2781,3,23,94,120,1.2416666666666667,0.04427415439017953,666,Do you have any hot sauce?
5130,2781,4,21,95,120,1.2416666666666667,0.04582855844748356,666,It's your turn to float around with him before we go to lunch.
5102,2781,7,15,98,120,1.2416666666666667,0.0502038328875526,666,My client ignored the advice not to take the stand.
5066,2781,4,21,95,120,1.2416666666666667,0.04582855844748356,666,"One, two, three, flip."
5050,2781,4,21,95,120,1.2416666666666667,0.04582855844748356,666,"Unfortunately, this is meatless Friday."
5351,2781,5,19,96,120,1.2416666666666667,0.04733194261577883,666,How long do you think until he realizes he's not on his paddle board anymore?
5015,2781,6,17,97,120,1.2416666666666667,0.04878902350111492,666,I threw him up and he's back.  Now what?
4899,2781,6,17,97,120,1.2416666666666667,0.04878902350111492,666,They taste much better semi-dried
4884,2781,5,19,96,120,1.2416666666666667,0.04733194261577883,666,"Tell me again why we are doing this"""
4879,2781,5,19,96,120,1.2416666666666667,0.04733194261577883,666,You familiar with The Marshmallow Test?
4827,2781,5,19,96,120,1.2416666666666667,0.04733194261577883,666,I hate to be a stereotype but will you bite him?
4788,2781,3,23,94,120,1.2416666666666667,0.04427415439017953,666,"I would eat this guy, but he's on my L3 and L5,  and dude, does that feel good or what!?"
4772,2781,7,15,98,120,1.2416666666666667,0.0502038328875526,666,He’s really not getting my drift.
4980,2781,8,13,99,120,1.2416666666666667,0.05157984935040302,666,"Before I rectify this situation, doesn’t it remind you of the old shark-lawyer-professional courtesy joke?"
4353,2781,3,23,94,120,1.2416666666666667,0.04427415439017953,666,There’s not enough meat on those legs.
5368,2781,4,21,95,120,1.2416666666666667,0.04582855844748356,666,I really miss our fridge.
5845,2781,6,17,97,120,1.2416666666666667,0.04878902350111492,666,Hey - find your own elasmobranchii craniosacral shiatsu practitioner.
4483,2781,4,21,95,120,1.2416666666666667,0.04582855844748356,666,It's called a side hustle.
4582,2781,2,25,93,120,1.2416666666666667,0.04266315417964886,666,He’s my first passenger. It’s an app called Grouper.
6296,2781,4,21,95,120,1.2416666666666667,0.04582855844748356,666,Why am I giving him a joy ride? He gets relaxed and the meat will be tender!
6288,2781,2,25,93,120,1.2416666666666667,0.04266315417964886,666,I thought only elephants had trunks.
6224,2781,3,23,94,120,1.2416666666666667,0.04427415439017953,666,Not for just anyone. He's a good chum.
6184,2781,7,15,98,120,1.2416666666666667,0.0502038328875526,666,Go for it—I'm more of a breast shark.
5798,2781,4,21,95,120,1.2416666666666667,0.04582855844748356,666,"It's great, I make extra money on my schedule and if you eat them at the end they can't give you a bad rating."
6116,2781,4,21,95,120,1.2416666666666667,0.04582855844748356,666,I like to give them a false sense of confidence.
4623,2781,7,15,98,120,1.2416666666666667,0.0502038328875526,666,"I made a deal. He’s on seal patrol.

Dan Barrett, Chatham, MA"
6006,2781,3,23,94,120,1.2416666666666667,0.04427415439017953,666,"Your wife has you doing Meatless Mondays too, huh?"
5860,2781,6,17,97,120,1.2416666666666667,0.04878902350111492,666,I guess one sandy surface feels like any other.
4638,2781,5,19,96,120,1.2416666666666667,0.04733194261577883,666,And they say their higher on the food chain?
4659,2781,6,17,97,120,1.2416666666666667,0.04878902350111492,666,On weekends I make extra money with my ride-sharing app.
4693,2781,5,19,96,120,1.2416666666666667,0.04733194261577883,666,"As soon as I finish with this massage, maybe we can stop for a bite."
6113,2781,8,13,99,120,1.2416666666666667,0.05157984935040302,666,It's funny. He said he was drowning in student debt. Now he calls me his loan shark.
2441,2781,6,17,97,120,1.2416666666666667,0.04878902350111492,666,"And if you stop moving, they'll give you a crappy review."
3410,2781,2,25,93,120,1.2416666666666667,0.04266315417964886,666,Cheapest periscope on the market and likely tasty too
711,2781,4,21,95,120,1.2416666666666667,0.04582855844748356,666,I’m pretty sure it was Francine that gave him to me. Anyway I gotta be more careful when I’m drinking.
1024,2781,3,23,94,120,1.2416666666666667,0.04427415439017953,666,Who's left shark now!?
997,2781,3,23,94,120,1.2416666666666667,0.04427415439017953,666,"Your wish has come true, that is Mark Cuban."
990,2781,4,21,95,120,1.2416666666666667,0.04582855844748356,666,What?  He said he'd lure in some other swimmers if I didn't eat him.
938,2781,4,21,95,120,1.2416666666666667,0.04582855844748356,666,It beats getting punched in the nose.
844,2781,4,21,95,120,1.2416666666666667,0.04582855844748356,666,I can’t believe you didn’t get the Aquaman 2 callback too.
785,2781,6,17,97,120,1.2416666666666667,0.04878902350111492,666,"If it's smaller than a 10 wide, I throw it back."""
769,2781,4,21,95,120,1.2416666666666667,0.04582855844748356,666,Don't you dare!
583,2781,2,25,93,120,1.2416666666666667,0.04266315417964886,666,"Be still, he is calling for his friends to swim over this way."
554,2781,2,25,93,120,1.2416666666666667,0.04266315417964886,666,Don’t even.
523,2781,5,19,96,120,1.2416666666666667,0.04733194261577883,666,"Body surfing, on my body."
366,2781,3,23,94,120,1.2416666666666667,0.04427415439017953,666,I’m full of climate changers. You do it.
280,2781,4,21,95,120,1.2416666666666667,0.04582855844748356,666,He said this is more environmental than the traditional surfboard.
255,2781,4,21,95,120,1.2416666666666667,0.04582855844748356,666,I know what Charles Addams would have done.
169,2781,3,23,94,120,1.2416666666666667,0.04427415439017953,666,"I'm a vegan."""
167,2781,6,17,97,120,1.2416666666666667,0.04878902350111492,666,Does this hat make my fin look fat?
136,2781,3,23,94,120,1.2416666666666667,0.04427415439017953,666,"I'm keeping this one really fresh, perfect for a nice quiet lunch instead of the usual frenzy."
124,2781,4,21,95,120,1.2416666666666667,0.04582855844748356,666,They're from the gifted youth program
1056,2781,3,23,94,120,1.2416666666666667,0.04427415439017953,666,I'll eat him after the water polo championships
1103,2781,5,19,96,120,1.2416666666666667,0.04733194261577883,666,Does this human make me look fat?
2238,2781,4,21,95,120,1.2416666666666667,0.04582855844748356,666,How are we handling walk-ups?
1151,2781,0,29,91,120,1.2416666666666667,0.03924325011691262,666,"I know, but it feels so good on my bad back."
1119,2781,3,23,94,120,1.2416666666666667,0.04427415439017953,666,yeah I bought it on Amazon!  Best lure ever!  Fake a drowning and a whole bunch more come for dinner!
2188,2781,5,19,96,120,1.2416666666666667,0.04733194261577883,666,This is not what I meant when I said I needed a breather.
2109,2781,5,19,96,120,1.2416666666666667,0.04733194261577883,666,And you call me spineless.
2103,2781,5,19,96,120,1.2416666666666667,0.04733194261577883,666,I brought a little snack. Would you like a bite?
2049,2781,4,21,95,120,1.2416666666666667,0.04582855844748356,666,"Now, it’s clear how Jesus performed the miracle of walking on water."
1979,2781,5,19,96,120,1.2416666666666667,0.04733194261577883,666,"Making up for the one I ate"""
1940,2781,6,17,97,120,1.2416666666666667,0.04878902350111492,666,Of all the days to decide to become a vegetarian...
1855,2781,2,25,93,120,1.2416666666666667,0.04266315417964886,666,No more messing with me—finally got my sea legs!
1693,2781,5,19,96,120,1.2416666666666667,0.04733194261577883,666,I'm running him over to Martha's Vineyard and he promised to give me a toe.
2005,2781,4,21,95,120,1.2416666666666667,0.04582855844748356,666,Do you want the leftovers?
1156,2781,4,21,95,120,1.2416666666666667,0.04582855844748356,666,Any idea what they mean by extreme surfing?
1634,2781,6,17,97,120,1.2416666666666667,0.04878902350111492,666,200 hours of Community Service.
1477,2781,5,19,96,120,1.2416666666666667,0.04733194261577883,666,"Bite this jerk for me, will you Sid?"
1354,2781,8,13,99,120,1.2416666666666667,0.05157984935040302,666,Welcome to the REAL Shark Tank!
1277,2781,4,21,95,120,1.2416666666666667,0.04582855844748356,666,"They call it Unter, and, you know, it's a living."
1266,2781,5,19,96,120,1.2416666666666667,0.04733194261577883,666,"It's the latest thing. It's called a ""to go"" snack."
1168,2781,4,21,95,120,1.2416666666666667,0.04582855844748356,666,"He likes to do his own stunts, okay?"
1668,2781,5,19,96,120,1.2416666666666667,0.04733194261577883,666,I am just carrying a snack with me.
219,2892,6,23,116,145,1.2413793103448276,0.04296913940808907,666,Going vegan has been harder than expected.
692,2892,3,29,113,145,1.2413793103448276,0.03948405525820154,666,Brining 101
2682,2892,5,25,115,145,1.2413793103448276,0.04183971200735931,666,It's Barnacle Bill again.
1944,2895,5,24,112,141,1.2411347517730495,0.04258695047244958,666,"Animal, vegetable, or mineral?"
2830,2896,4,18,86,108,1.2407407407407407,0.048995394649344264,666,"Tell me the truth, does this dad hat scream hipster?"
5705,2897,6,20,107,133,1.2406015037593985,0.04547210134179587,666,Periscope up!
464,2898,2,24,91,117,1.2393162393162394,0.04317486608247565,666,He got on at Coney Island !
465,2898,2,24,91,117,1.2393162393162394,0.04317486608247565,666,We're shooting 'The Sponge Bob Jaws Movie.
2702,2898,5,18,94,117,1.2393162393162394,0.04802245006476562,666,It’s a symbiotic relationship so back off.
2836,2898,4,20,93,117,1.2393162393162394,0.046462818402408325,666,"He's on thin ice, well, was on thin ice."
5070,2898,5,18,94,117,1.2393162393162394,0.04802245006476562,666,I’m helping out with the shark watch.”
3955,2898,3,22,92,117,1.2393162393162394,0.04484898301597752,666,"If the rest is anything like the legs, he’s all yours."
4157,2898,3,22,92,117,1.2393162393162394,0.04484898301597752,666,Apparently jumping the shark is now passe.
4265,2898,3,22,92,117,1.2393162393162394,0.04484898301597752,666,This guy thinks I am one of those new powered surfboards.
4513,2898,3,22,92,117,1.2393162393162394,0.04484898301597752,666,"I know, I know. I'm too aggressive-passive."
4920,2898,6,16,95,117,1.2393162393162394,0.04953299836019056,666,It’s a new X-Game sport... sharkboarding.
3688,2898,5,18,94,117,1.2393162393162394,0.04802245006476562,666,I've been working for Green Surfboard for a year now.
41,2898,7,14,96,117,1.2393162393162394,0.050998824916642684,666,I'm a surfboard.  This is my life now.
3123,2910,3,26,105,134,1.2388059701492538,0.04127241229127147,666,That does it! I'm moving outta his wifi range.
1625,2910,4,24,106,134,1.2388059701492538,0.042610243685934766,666,He thinks he's having a fabulous ride on his surfboard
1947,2912,4,21,97,122,1.2377049180327868,0.045160417509692276,666,"I know, I know, but he promised me lots of krill."
3743,2913,4,20,94,118,1.2372881355932204,0.04611200470995581,666,I can't. Just started paleo.
6241,2913,3,22,93,118,1.2372881355932204,0.04451350836236989,666,I’d eat him but he’s a vegan
6123,2913,6,16,96,118,1.2372881355932204,0.04915329166657521,666,I'd say he's a foot and a half from disaster--maybe two feet.
6018,2913,6,16,96,118,1.2372881355932204,0.04915329166657521,666,I’m trying shiatsu for my migraines.
5458,2913,5,18,95,118,1.2372881355932204,0.04765691481847308,666,"Says he's a TV writer and needs to learn fast, how to 'jump the shark'."
701,2913,4,20,94,118,1.2372881355932204,0.04611200470995581,666,Standing room only at the Jaws Fest.
5235,2913,4,20,94,118,1.2372881355932204,0.04611200470995581,666,"I'm not that hungry, do you want to split it?"
4735,2913,4,20,94,118,1.2372881355932204,0.04611200470995581,666,"Hey Sal, go up and see how fast this one can swim."
4716,2913,7,14,97,118,1.2372881355932204,0.050605440748042345,666,Who let this guy into their PhD program?
4603,2913,4,20,94,118,1.2372881355932204,0.04611200470995581,666,"The trick is not to rush.  Soon, more will come."
4521,2913,3,22,93,118,1.2372881355932204,0.04451350836236989,666,Do you prefer a leg or a thigh?
4465,2913,3,22,93,118,1.2372881355932204,0.04451350836236989,666,"Well, what's YOUR side gig?"
958,2913,6,16,96,118,1.2372881355932204,0.04915329166657521,666,We have a symbiotic relationship - he claims to be eco-friendly not needing a boat and I get human prey easily
3624,2913,2,24,92,118,1.2372881355932204,0.042855429936970196,666,It pays the rent...
4160,2913,3,22,93,118,1.2372881355932204,0.04451350836236989,666,They call it fish boarding; I call it trolling.
1158,2913,2,24,92,118,1.2372881355932204,0.042855429936970196,666,It’s the opposite of stepping on a Lego
1214,2913,6,16,96,118,1.2372881355932204,0.04915329166657521,666,My lawyer's pulling rank.
1381,2913,1,26,91,118,1.2372881355932204,0.041130564346217625,666,"When you asked me if I would be your stand in, I didn’t think it meant this."
1399,2913,4,20,94,118,1.2372881355932204,0.04611200470995581,666,"I accidentally ate his surf board. I was either this, or ... do you know how expensive those things are?"
1743,2913,4,20,94,118,1.2372881355932204,0.04611200470995581,666,I can’t get that Baby Shark song out of my head.
2243,2913,5,18,95,118,1.2372881355932204,0.04765691481847308,666,"Mom, I’m a dolphin"
2479,2913,6,16,96,118,1.2372881355932204,0.04915329166657521,666,I liked it more when they were in the cages.
2609,2913,5,18,95,118,1.2372881355932204,0.04765691481847308,666,the bottom half never tastes as good as the top half
2840,2913,3,22,93,118,1.2372881355932204,0.04451350836236989,666,"I’m not hungry, but this is too good of an opportunity to pass by."
2856,2913,4,20,94,118,1.2372881355932204,0.04611200470995581,666,"Correct me if I’m wrong, but wasn’t it your idea to order in tonight?"
3893,2913,4,20,94,118,1.2372881355932204,0.04611200470995581,666,He's a real pain in the back.
3374,2913,2,24,92,118,1.2372881355932204,0.042855429936970196,666,I get my dinner to go.
1020,2913,6,16,96,118,1.2372881355932204,0.04915329166657521,666,I decided to have my lunch to go today.
505,2913,5,18,95,118,1.2372881355932204,0.04765691481847308,666,Wait till he discovers he”s not standing in the shallows.
3726,2913,4,20,94,118,1.2372881355932204,0.04611200470995581,666,"I'm carrying my food on my back............he's my ""Snack Pak""!!"
130,2913,4,20,94,118,1.2372881355932204,0.04611200470995581,666,I’m making human leg soup.
208,2913,6,16,96,118,1.2372881355932204,0.04915329166657521,666,Let's share.
2690,2945,4,23,104,131,1.2366412213740459,0.04311976666223454,666,The flailing is more inspired when they're well rested.
2868,2946,6,14,90,110,1.2363636363636363,0.05154376219029219,666,How was I supposed to know he was Neptune’s nephew?
4573,2947,6,17,100,123,1.2357723577235773,0.04771368919516814,666,I just ate breakfast at the 'Ride a Dolphin' attraction and picked us up some take-out.
4517,2947,5,19,99,123,1.2357723577235773,0.04629596219205625,666,Don't even think about it. It's called Thai massage and I've paid 20 bucks.
5602,2949,7,17,108,132,1.2348484848484849,0.04670479649701895,666,"Show a little professional courtesy to a lawyer, then what?"
3432,2950,4,19,92,115,1.2347826086956522,0.046756644404553516,666,"He kept humming this strange tune and saying he needed a bigger boat, do I decided what the heck, go all in."""
3466,2950,8,11,96,115,1.2347826086956522,0.05288104576462862,666,He's a stand-up type of guy.
3684,2950,7,13,95,115,1.2347826086956522,0.0514183790085221,666,"Cause, he's Republican like me."
3517,2950,2,23,90,115,1.2347826086956522,0.04337134069152608,666,"Honey, you hungry? I brought home the leftover drumsticks."
3549,2950,6,15,94,115,1.2347826086956522,0.04991286806593372,666,Back off! Get your own surfwich!
3621,2950,9,9,97,115,1.2347826086956522,0.05430433042085563,666,Go away. We're a lone shark.
3674,2950,4,19,92,115,1.2347826086956522,0.046756644404553516,666,"I wasn't very hungry, so I got half my lunch to go."
3676,2950,3,21,91,115,1.2347826086956522,0.045095770252620654,666,"If I can't get a seal, he's my Plan B ..."
3446,2950,4,19,92,115,1.2347826086956522,0.046756644404553516,666,"Yes, I’m now employed  by Uber."
3700,2950,6,15,94,115,1.2347826086956522,0.04991286806593372,666,And I though remoras were a pain.
3723,2950,5,17,93,115,1.2347826086956522,0.048360511755673,666,"I've changed a lot since my evil days as ""Jaws""."
3421,2950,2,23,90,115,1.2347826086956522,0.04337134069152608,666,I'm waiting to see if the top-half is any more appetizing.
3784,2950,7,13,95,115,1.2347826086956522,0.0514183790085221,666,He doesn't understand who the frog and who the scorpion is in this scenario
3792,2950,6,15,94,115,1.2347826086956522,0.04991286806593372,666,"When it stops itching, then we'll eat."
3868,2950,4,19,92,115,1.2347826086956522,0.046756644404553516,666,"Honey,I can’t get dinner off my mind."
3888,2950,6,15,94,115,1.2347826086956522,0.04991286806593372,666,It started a few months ago as a small bump on my back!
3902,2950,3,21,91,115,1.2347826086956522,0.045095770252620654,666,"Hey Sushi, ready for lunch?"
3925,2950,6,15,94,115,1.2347826086956522,0.04991286806593372,666,It’s the latest thing at my yoga studio.
3947,2950,4,19,92,115,1.2347826086956522,0.046756644404553516,666,Would sir like some lemon with his legs?
4066,2950,5,17,93,115,1.2347826086956522,0.048360511755673,666,You gotta let them think they're in charge.
4204,2950,4,19,92,115,1.2347826086956522,0.046756644404553516,666,"It's my new side hustle, Uber Surf."
4218,2950,4,19,92,115,1.2347826086956522,0.046756644404553516,666,Don’t judge.
4231,2950,6,15,94,115,1.2347826086956522,0.04991286806593372,666,ShUber. Don't judge me.
4240,2950,0,27,88,115,1.2347826086956522,0.039698395317531235,666,The doctor says it’ll clear up if I swim in colder waters.
4270,2950,5,17,93,115,1.2347826086956522,0.048360511755673,666,It's for later.
3704,2950,5,17,93,115,1.2347826086956522,0.048360511755673,666,He was screaming and crying.  Then he gave up and started taunting me.  And I  lost my appetite.
3387,2950,4,19,92,115,1.2347826086956522,0.046756644404553516,666,This dude thinks he’s windsurfing...
3346,2950,4,19,92,115,1.2347826086956522,0.046756644404553516,666,My guess is this moron never watched the movie Jaws!
3357,2950,4,19,92,115,1.2347826086956522,0.046756644404553516,666,It’s worth it for the massage.
4276,2950,1,25,89,115,1.2347826086956522,0.04157544818860893,666,The guy says he never read the Gingerbread Man.
3326,2950,3,21,91,115,1.2347826086956522,0.045095770252620654,666,"Welcome to Shark Tank, Mr. Johnson."
3311,2950,2,23,90,115,1.2347826086956522,0.04337134069152608,666,I'm just waiting 'til lunchtime....
3271,2950,6,15,94,115,1.2347826086956522,0.04991286806593372,666,I like to play with my food first . . . you?
3217,2950,6,15,94,115,1.2347826086956522,0.04991286806593372,666,We met on Tinder. He thinks I'm of a plankton-eating variety.
3209,2950,2,23,90,115,1.2347826086956522,0.04337134069152608,666,They say it's good for your posture.
3196,2950,4,19,92,115,1.2347826086956522,0.046756644404553516,666,It's the new LIFT service.
3193,2950,4,19,92,115,1.2347826086956522,0.046756644404553516,666,You like it? I picked it up on vacation.
3182,2950,3,21,91,115,1.2347826086956522,0.045095770252620654,666,I'm thinking about the roll and snap maneuver.
3175,2950,1,25,89,115,1.2347826086956522,0.04157544818860893,666,Would you like to share lunch?
3166,2950,4,19,92,115,1.2347826086956522,0.046756644404553516,666,I'm a level 5 vegan.
3159,2950,7,13,95,115,1.2347826086956522,0.0514183790085221,666,"Don't touch, I'm working.  How else did you think these dumb humans participate in Synchronized Swimming."""
3148,2950,4,19,92,115,1.2347826086956522,0.046756644404553516,666,Once I land my Netflix special I'll quit UberEats.
3140,2950,2,23,90,115,1.2347826086956522,0.04337134069152608,666,"Don’t do it, Sid. Remember what Mom said. Those things’ll cause splinters in your throat."
3090,2950,5,17,93,115,1.2347826086956522,0.048360511755673,666,I had to take a 2nd job as a lyft driver.
3079,2950,5,17,93,115,1.2347826086956522,0.048360511755673,666,I’m saving it for an afternoon snack.
3077,2950,4,19,92,115,1.2347826086956522,0.046756644404553516,666,This actually helps relieve a lot of tension on my dorsal.
3056,2950,3,21,91,115,1.2347826086956522,0.045095770252620654,666,Best bait ever for Long Island Sound.
3021,2950,5,17,93,115,1.2347826086956522,0.048360511755673,666,It's amazing what you can pick up body surfing the net these days...
3018,2950,5,17,93,115,1.2347826086956522,0.048360511755673,666,Another twenty seconds and I get to scratch his.
2829,2950,3,21,91,115,1.2347826086956522,0.045095770252620654,666,It is such a hassle bringing your own food to the beach.
2825,2950,6,15,94,115,1.2347826086956522,0.04991286806593372,666,"Yeah, just until the end of August, then I start work with a big carporation."
3344,2950,5,17,93,115,1.2347826086956522,0.048360511755673,666,And I'm not even hungry now.
2824,2950,7,13,95,115,1.2347826086956522,0.0514183790085221,666,"I’d eat him, but he’s scratching an itch."
2808,2950,5,17,93,115,1.2347826086956522,0.048360511755673,666,"I never though massage therapy was this good,Bob"
3370,2950,3,21,91,115,1.2347826086956522,0.045095770252620654,666,In about 2 seconds: the 'sandbar' strikes back.
4304,2950,5,17,93,115,1.2347826086956522,0.048360511755673,666,I am bringing him home for dinner.
5587,2950,3,21,91,115,1.2347826086956522,0.045095770252620654,666,He thinks we're friends. I'm waiting until he shows me off to the kids to strike.
4376,2950,5,17,93,115,1.2347826086956522,0.048360511755673,666,It's take out dinner.
5463,2950,3,21,91,115,1.2347826086956522,0.045095770252620654,666,I need to find a new job.
5468,2950,2,23,90,115,1.2347826086956522,0.04337134069152608,666,He didn't want me to be a lone shark.
5679,2950,3,21,91,115,1.2347826086956522,0.045095770252620654,666,Timing is everything.
5718,2950,3,21,91,115,1.2347826086956522,0.045095770252620654,666,You can  take his better half
5723,2950,6,15,94,115,1.2347826086956522,0.04991286806593372,666,Fresh and convenient
5760,2950,3,21,91,115,1.2347826086956522,0.045095770252620654,666,I’m working for Uber. A bucket of chum gets them a trip to the island.
5802,2950,5,17,93,115,1.2347826086956522,0.048360511755673,666,He thinks I'm a dolphin rescuing him.
5477,2950,3,21,91,115,1.2347826086956522,0.045095770252620654,666,He said he was looking for Crocs.
5851,2950,2,23,90,115,1.2347826086956522,0.04337134069152608,666,This is getting too easy
5896,2950,5,17,93,115,1.2347826086956522,0.048360511755673,666,He feels like jail bait
5948,2950,3,21,91,115,1.2347826086956522,0.045095770252620654,666,"No thanks, I brought my lunch from home today."""
5956,2950,5,17,93,115,1.2347826086956522,0.048360511755673,666,"A little to the left...aaaaahhhhh, that's it!"
5967,2950,7,13,95,115,1.2347826086956522,0.0514183790085221,666,It's Japanese. It's called shiatsu.
5981,2950,5,17,93,115,1.2347826086956522,0.048360511755673,666,"I'll take him out past the surf-line,and we can all have a bite."
5486,2950,4,19,92,115,1.2347826086956522,0.046756644404553516,666,"Oh I know, I'm saving it for later."
5992,2950,3,21,91,115,1.2347826086956522,0.045095770252620654,666,He says he's a lawyer and wants professional courtesy.
2782,2950,3,21,91,115,1.2347826086956522,0.045095770252620654,666,I’m waiting until dinnertime.
6300,2950,2,23,90,115,1.2347826086956522,0.04337134069152608,666,"The script clearly says ‘Fonzie JUMPS the shark’, Karl... I don’t get paid enough for this crap."
6254,2950,4,19,92,115,1.2347826086956522,0.046756644404553516,666,"I usually don’t kiss and tell, but..."
5525,2950,5,17,93,115,1.2347826086956522,0.048360511755673,666,Aqua-Uber
6038,2950,4,19,92,115,1.2347826086956522,0.046756644404553516,666,This new rideshare gig is a pain in the neck.
6178,2950,2,23,90,115,1.2347826086956522,0.04337134069152608,666,Do you want him or not?
6084,2950,5,17,93,115,1.2347826086956522,0.048360511755673,666,You want him? I gave up meat for lent.
5629,2950,2,23,90,115,1.2347826086956522,0.04337134069152608,666,"I am interviewing for Sea World,will you be a reference?"
5590,2950,6,15,94,115,1.2347826086956522,0.04991286806593372,666,He's pushing my vegan commitment to the limits.
5402,2950,4,19,92,115,1.2347826086956522,0.046756644404553516,666,Are you okay with take-out?
5357,2950,5,17,93,115,1.2347826086956522,0.048360511755673,666,I'm taking him home to meet my parents.
5318,2950,2,23,90,115,1.2347826086956522,0.04337134069152608,666,he's pitching a shark repellant on Shark Tank
5263,2950,6,15,94,115,1.2347826086956522,0.04991286806593372,666,"He gives great massages, and is cheaper and neater than a pygmy goat."
4379,2950,5,17,93,115,1.2347826086956522,0.048360511755673,666,He thinks I'm his paddle board.
4395,2950,2,23,90,115,1.2347826086956522,0.04337134069152608,666,It's my sinuses. Feels like something is sitting on my face.
4429,2950,2,23,90,115,1.2347826086956522,0.04337134069152608,666,You want the other half? I'm full.
4481,2950,5,17,93,115,1.2347826086956522,0.048360511755673,666,What? Patience is a virtue.
4482,2950,3,21,91,115,1.2347826086956522,0.045095770252620654,666,"I drive for Uber.  The money's not so good, but meals are free."
4484,2950,4,19,92,115,1.2347826086956522,0.046756644404553516,666,He says he has my back.
4498,2950,3,21,91,115,1.2347826086956522,0.045095770252620654,666,"What was I to do? I ate his mother, and he needed a ride home."
4574,2950,5,17,93,115,1.2347826086956522,0.048360511755673,666,I think you’re right. This is an  unanticipated shift in the service economy.
4674,2950,6,15,94,115,1.2347826086956522,0.04991286806593372,666,You just download the app.
4689,2950,2,23,90,115,1.2347826086956522,0.04337134069152608,666,Do you want the legs or the chest?
4730,2950,6,15,94,115,1.2347826086956522,0.04991286806593372,666,We can't bite him. Ecotourism is where the money's at.
4734,2950,4,19,92,115,1.2347826086956522,0.046756644404553516,666,He's lucky I've gone vegan.
4354,2950,4,19,92,115,1.2347826086956522,0.046756644404553516,666,I get no respect.
4775,2950,3,21,91,115,1.2347826086956522,0.045095770252620654,666,He has 5 seconds to get off my fin!
4828,2950,3,21,91,115,1.2347826086956522,0.045095770252620654,666,"You can have him, he's gluten free."
4849,2950,6,15,94,115,1.2347826086956522,0.04991286806593372,666,It feels so good on my back I am not even hungry.
4865,2950,4,19,92,115,1.2347826086956522,0.046756644404553516,666,He thinks he's one of us - but he's just a flippin' lawer!
4919,2950,7,13,95,115,1.2347826086956522,0.0514183790085221,666,It is called Uber and it pays quite well
4964,2950,1,25,89,115,1.2347826086956522,0.04157544818860893,666,Don’t. It’s not worth the publicity.
5010,2950,3,21,91,115,1.2347826086956522,0.045095770252620654,666,Give me a break.  I owe him one.  I ate his mother.
5041,2950,8,11,96,115,1.2347826086956522,0.05288104576462862,666,It's take out.
5055,2950,5,17,93,115,1.2347826086956522,0.048360511755673,666,The chiropractor says two more weeks
5058,2950,4,19,92,115,1.2347826086956522,0.046756644404553516,666,I've felt so disrespected since the end of Shark Week.
5077,2950,6,15,94,115,1.2347826086956522,0.04991286806593372,666,He doesn’t know my favorite story is “The Gingerbread Man”!
5126,2950,7,13,95,115,1.2347826086956522,0.0514183790085221,666,el stupido here thinks he's jumped the shark!
5153,2950,6,15,94,115,1.2347826086956522,0.04991286806593372,666,I  just don’t think the free fish are worth it.
4794,2950,6,15,94,115,1.2347826086956522,0.04991286806593372,666,But you said you couldn't 'stand' humans.
2729,2950,6,15,94,115,1.2347826086956522,0.04991286806593372,666,Ya wanna come over for some leftovers?
5163,2950,3,21,91,115,1.2347826086956522,0.045095770252620654,666,Your choice:  Chicken or bumpercars?
2714,2950,5,17,93,115,1.2347826086956522,0.048360511755673,666,"Nobody fears us since ""Baby Shark Doo Doo"" came out."
786,2950,4,19,92,115,1.2347826086956522,0.046756644404553516,666,Humiliating work but they cover dental.
796,2950,4,19,92,115,1.2347826086956522,0.046756644404553516,666,The store was fresh out of periscopes.
835,2950,4,19,92,115,1.2347826086956522,0.046756644404553516,666,I hate being a support animal.
847,2950,3,21,91,115,1.2347826086956522,0.045095770252620654,666,"Gerald, Stop playing with your food!"
858,2950,4,19,92,115,1.2347826086956522,0.046756644404553516,666,I have this kink in my cartilage.
1012,2950,6,15,94,115,1.2347826086956522,0.04991286806593372,666,My internist recommended daily back-walking spinal manipulations to release stress-related dorsal fin tension.
1019,2950,7,13,95,115,1.2347826086956522,0.0514183790085221,666,"It's an investment, he is posting on Instagram."
1031,2950,7,13,95,115,1.2347826086956522,0.0514183790085221,666,"Actually, George, I'm swimming for a peer-to-peer ridesharing app called SurfSerfs."
1043,2950,5,17,93,115,1.2347826086956522,0.048360511755673,666,Perhaps Darwin was right.  This guy claims he is my Uncle Bill.
1047,2950,4,19,92,115,1.2347826086956522,0.046756644404553516,666,It's this damn great white guilt.
1052,2950,4,19,92,115,1.2347826086956522,0.046756644404553516,666,I'm trying to eat smarter.
1077,2950,5,17,93,115,1.2347826086956522,0.048360511755673,666,It's that cocky Roy Scheider!
1081,2950,1,25,89,115,1.2347826086956522,0.04157544818860893,666,It's cheaper than a chiropractor.
1084,2950,3,21,91,115,1.2347826086956522,0.045095770252620654,666,"Here's your delivery, thanks for using UberEats."
1097,2950,3,21,91,115,1.2347826086956522,0.045095770252620654,666,It's supposed to help with headaches.
1113,2950,2,23,90,115,1.2347826086956522,0.04337134069152608,666,My kind of restaurant. Standing room only.
1148,2950,6,15,94,115,1.2347826086956522,0.04991286806593372,666,Growth? What growth?
1179,2950,4,19,92,115,1.2347826086956522,0.046756644404553516,666,They're better when you marinate them.
1192,2950,3,21,91,115,1.2347826086956522,0.045095770252620654,666,I had not choice -- they were out of the small size hood ornament
667,2950,3,21,91,115,1.2347826086956522,0.045095770252620654,666,He also wears a pair of Crocs.
655,2950,3,21,91,115,1.2347826086956522,0.045095770252620654,666,He needs work on his sea legs.
651,2950,3,21,91,115,1.2347826086956522,0.045095770252620654,666,His tattoo says “Babe Magnet” so I have an idea...
625,2950,6,15,94,115,1.2347826086956522,0.04991286806593372,666,You should consider getting a human masseuse too. This back-walking is really aligning my chakras.
17,2950,7,13,95,115,1.2347826086956522,0.0514183790085221,666,I get a good back rub AND lunch.
33,2950,4,19,92,115,1.2347826086956522,0.046756644404553516,666,Whadda think of my new hat?
47,2950,6,15,94,115,1.2347826086956522,0.04991286806593372,666,I’m part of a new Uber service
50,2950,5,17,93,115,1.2347826086956522,0.048360511755673,666,"Hey, I don’t see you having any luck finding a job"
60,2950,4,19,92,115,1.2347826086956522,0.046756644404553516,666,"Wait until you see him, he's scarier than my dorsal fin could ever be."
2718,2950,2,23,90,115,1.2347826086956522,0.04337134069152608,666,I have the profile of a surfboard.
95,2950,3,21,91,115,1.2347826086956522,0.045095770252620654,666,There's really nothing as satisfying as Ashiatsu barefoot back massage.
212,2950,4,19,92,115,1.2347826086956522,0.046756644404553516,666,It’s a great bait
232,2950,2,23,90,115,1.2347826086956522,0.04337134069152608,666,I wish it was a lamprey.
1228,2950,5,17,93,115,1.2347826086956522,0.048360511755673,666,When he jumped onboard he kept calling me Uber.
245,2950,2,23,90,115,1.2347826086956522,0.04337134069152608,666,Take out.
300,2950,5,17,93,115,1.2347826086956522,0.048360511755673,666,I told him I was a dolphin in disguise.
316,2950,4,19,92,115,1.2347826086956522,0.046756644404553516,666,You can't let people walk all over you.
349,2950,2,23,90,115,1.2347826086956522,0.04337134069152608,666,"I know this sounds crazy, but I feel like if I say something, that makes me the rude one."
354,2950,6,15,94,115,1.2347826086956522,0.04991286806593372,666,"On the other hand, if I do dispose of him, I'll never get rid of those pesky remoras."
375,2950,4,19,92,115,1.2347826086956522,0.046756644404553516,666,How long is a water polo match?
519,2950,4,19,92,115,1.2347826086956522,0.046756644404553516,666,He double-dared me not to eat him.
598,2950,6,15,94,115,1.2347826086956522,0.04991286806593372,666,UberOcean
617,2950,5,17,93,115,1.2347826086956522,0.048360511755673,666,Harry. Get it. Get it. It's 'surfing turf!'
623,2950,4,19,92,115,1.2347826086956522,0.046756644404553516,666,It’s my new start up. I call it ‘Under Eats’.  You think it has fins?
263,2950,4,19,92,115,1.2347826086956522,0.046756644404553516,666,I'm teaching him how to jump the shark
1254,2950,4,19,92,115,1.2347826086956522,0.046756644404553516,666,"No thanks, I don't need to go out for lunch.  I brought mine."
957,2950,7,13,95,115,1.2347826086956522,0.0514183790085221,666,"The ""Coral Seas"" now has take-out."
1281,2950,4,19,92,115,1.2347826086956522,0.046756644404553516,666,"This 'Vegan Shark' ploy is brilliant, Bruce.  Just two more days..."""
2037,2950,5,17,93,115,1.2347826086956522,0.048360511755673,666,"INFESTED with humans, more like."
2070,2950,6,15,94,115,1.2347826086956522,0.04991286806593372,666,They're too stupid to eat.
2116,2950,3,21,91,115,1.2347826086956522,0.045095770252620654,666,"Hi, honey--I brought dinner."
2129,2950,3,21,91,115,1.2347826086956522,0.045095770252620654,666,"Well, I get great back massages and luckily for him, it curbs my appetite."
2137,2950,2,23,90,115,1.2347826086956522,0.04337134069152608,666,They're actually worth more alive than dead.
2141,2950,6,15,94,115,1.2347826086956522,0.04991286806593372,666,Just a Big Pharma exec who needed a professional courtesy
2234,2950,4,19,92,115,1.2347826086956522,0.046756644404553516,666,"I'm trying to be dolphin-like, but I should just be myself."
2250,2950,5,17,93,115,1.2347826086956522,0.048360511755673,666,I order them for take-out.
2323,2950,6,15,94,115,1.2347826086956522,0.04991286806593372,666,Are you going to help me fish for lifeguards or what?
2333,2950,4,19,92,115,1.2347826086956522,0.046756644404553516,666,Brought some lunch.
2352,2950,2,23,90,115,1.2347826086956522,0.04337134069152608,666,Lunch is so easy this time of year
1268,2950,5,17,93,115,1.2347826086956522,0.048360511755673,666,"He said ""professional courtesy"". I want to bite him."
2471,2950,5,17,93,115,1.2347826086956522,0.048360511755673,666,Don't eat him - this back massage is doing wonders for neck pain.
2516,2950,3,21,91,115,1.2347826086956522,0.045095770252620654,666,He gets a ride for free and I get another set of eyes.
2654,2950,2,23,90,115,1.2347826086956522,0.04337134069152608,666,Apparently shark surfing is the new trend.
2663,2950,3,21,91,115,1.2347826086956522,0.045095770252620654,666,Meh. They taste like chicken.
2671,2950,5,17,93,115,1.2347826086956522,0.048360511755673,666,He thought he was appearing ON Shark Tank! Heh
2026,2950,3,21,91,115,1.2347826086956522,0.045095770252620654,666,I don't have the heart to tell him that he won't have a leg to stand on.
2014,2950,5,17,93,115,1.2347826086956522,0.048360511755673,666,And I'm telling you: It's my turn now. He's been doing you for nearly an hour.
2123,2950,4,19,92,115,1.2347826086956522,0.046756644404553516,666,It's a great gig.  Uber Waterways lets us join the labor pool.
1655,2950,4,19,92,115,1.2347826086956522,0.046756644404553516,666,Parasite Laws are Horrible!
1331,2950,4,19,92,115,1.2347826086956522,0.046756644404553516,666,Do I look like a pig to you?
1553,2950,5,17,93,115,1.2347826086956522,0.048360511755673,666,"After synchronized swimming, I'm having him for dinner."
1604,2950,6,15,94,115,1.2347826086956522,0.04991286806593372,666,He's looking for Spielberg. He works for me.
1617,2950,4,19,92,115,1.2347826086956522,0.046756644404553516,666,He thinks he’s in surfing school.
1897,2950,5,17,93,115,1.2347826086956522,0.048360511755673,666,If I let you take a bite it will ruin my rating.
1708,2950,3,21,91,115,1.2347826086956522,0.045095770252620654,666,Another whale watcher.
1744,2950,5,17,93,115,1.2347826086956522,0.048360511755673,666,"Have you seen the movie, Jaws?"
1746,2950,2,23,90,115,1.2347826086956522,0.04337134069152608,666,Go look -- it feels like a set-up.
1748,2950,4,19,92,115,1.2347826086956522,0.046756644404553516,666,Let's wait until he's finished texting.
1359,2950,3,21,91,115,1.2347826086956522,0.045095770252620654,666,"He tried to jump the shark, but missed"
1461,2950,5,17,93,115,1.2347826086956522,0.048360511755673,666,Do you know what it's like to be stuck with Richard Dreyfuss
1809,2950,6,15,94,115,1.2347826086956522,0.04991286806593372,666,My wife said we’re going vegan.
1834,2950,5,17,93,115,1.2347826086956522,0.048360511755673,666,It’s called “Sea Uber”. I’m taking this one to Montauk.
1844,2950,4,19,92,115,1.2347826086956522,0.046756644404553516,666,"Migrate early, they said."
1874,2950,4,19,92,115,1.2347826086956522,0.046756644404553516,666,It’s my side hustle.
1753,2950,3,21,91,115,1.2347826086956522,0.045095770252620654,666,I told the wife I'd bring home dinner.
356,3151,4,18,89,111,1.2342342342342343,0.0478102908111374,666,Don't look at me like that! YOU had a monitoring device attached just last year!
3016,3152,5,23,113,141,1.2340425531914894,0.042273651224804754,666,It's a Finn.
5288,3153,4,20,96,120,1.2333333333333334,0.0454256762579498,666,Oh yeah right there. This guy really gets the kinks outta my dorsal.
6143,3153,3,22,95,120,1.2333333333333334,0.0438569953494662,666,I'm having it removed next week.
3204,3155,3,21,92,116,1.2327586206896552,0.04475111687849267,666,My driver rating is 4.95. People love not being eaten.
3227,3155,5,17,94,116,1.2327586206896552,0.04798450309042525,666,This massage promises a happy ending - the question is whose?
3493,3155,5,17,94,116,1.2327586206896552,0.04798450309042525,666,The doctor said it would help with my lower fin
2971,3155,3,21,92,116,1.2327586206896552,0.04475111687849267,666,"No, it’s not a symbiotic relationship."
3697,3155,3,21,92,116,1.2327586206896552,0.04475111687849267,666,Want to split a dessert?
3881,3155,3,21,92,116,1.2327586206896552,0.04475111687849267,666,Each year it gets easier and easier.
1614,3155,4,19,93,116,1.2327586206896552,0.04639598581077646,666,"Junior, I brought your supper"
2287,3155,4,19,93,116,1.2327586206896552,0.04639598581077646,666,I was burned out.  I am trying something meaningful.
2264,3155,2,23,91,116,1.2327586206896552,0.04304343648445431,666,I'm not falling for it again.
2159,3155,6,15,95,116,1.2327586206896552,0.04952209178050024,666,"It's okay, he's The Fonz."
2025,3155,4,19,93,116,1.2327586206896552,0.04639598581077646,666,How long do we need to support this guy !
1395,3155,3,21,92,116,1.2327586206896552,0.04475111687849267,666,"Sure I like a challenge, but sometimes I’m just hungry."
3917,3155,5,17,94,116,1.2327586206896552,0.04798450309042525,666,It's been like this for an hour.
1962,3155,5,17,94,116,1.2327586206896552,0.04798450309042525,666,I just wish the lifeguard would get off my back.
1679,3155,5,17,94,116,1.2327586206896552,0.04798450309042525,666,"I asked ""Scorpion?"" ""Frog?"" He just smiled, so I told him to climb on..."
1114,3155,4,19,93,116,1.2327586206896552,0.04639598581077646,666,It was you who suggested we try reiki
798,3155,4,19,93,116,1.2327586206896552,0.04639598581077646,666,I thought I would bring a snack for the trip.
2582,3155,4,19,93,116,1.2327586206896552,0.04639598581077646,666,"Relax, there's no top part."""
4352,3155,3,21,92,116,1.2327586206896552,0.04475111687849267,666,"I would bite him, but I don't want to hurt his self-esteem."""
1274,3155,6,15,95,116,1.2327586206896552,0.04952209178050024,666,He wants us to join his firm
4665,3155,2,23,91,116,1.2327586206896552,0.04304343648445431,666,Would you like to join me for lunch?
4819,3155,2,23,91,116,1.2327586206896552,0.04304343648445431,666,"Now, watch while I flip this up and catch it in my mouth."
4822,3155,2,23,91,116,1.2327586206896552,0.04304343648445431,666,Just a little snack for later.
6225,3155,4,19,93,116,1.2327586206896552,0.04639598581077646,666,"ok, the coast is clear.  It is your turn to go fish!"
5156,3155,3,21,92,116,1.2327586206896552,0.04475111687849267,666,He says he likes living on the edge.
5158,3155,5,17,94,116,1.2327586206896552,0.04798450309042525,666,"Really, I guess it comes down to your definition of ""apex""."
5783,3155,3,21,92,116,1.2327586206896552,0.04475111687849267,666,I'm delaying gratification.
1229,3155,3,21,92,116,1.2327586206896552,0.04475111687849267,666,Your Uber Eats order is ready.
6281,3155,5,17,94,116,1.2327586206896552,0.04798450309042525,666,"""Yeah, but the sciatica relief is unparalleled."
4404,3155,2,23,91,116,1.2327586206896552,0.04304343648445431,666,Have you seen his top half?
5308,3155,2,23,91,116,1.2327586206896552,0.04304343648445431,666,I get the feeling I've been stood up.
5469,3155,5,17,94,116,1.2327586206896552,0.04798450309042525,666,"So, how shall I convince him that he doesn't have a leg to stand on?"
5496,3155,4,19,93,116,1.2327586206896552,0.04639598581077646,666,"I figure, use some bait."
3265,3188,3,23,99,125,1.232,0.04270831300812524,666,"I always thought that ""headstand"" was something different!"
4990,3189,6,19,109,134,1.2313432835820894,0.044836864492459355,666,"It's that damned ""Baby Shark"" song I blame for ruining our reputation"
1224,3190,2,23,92,117,1.2307692307692308,0.04272030397180561,666,They had to evolve....
1884,3191,5,16,92,113,1.2300884955752212,0.048701290225684514,666,He's my lookout for fin hunters.
1771,3191,7,12,94,113,1.2300884955752212,0.051844684350823206,666,Work-life balance — you should try it sometime.
1704,3191,3,20,90,113,1.2300884955752212,0.04534049011486548,666,I’m working Uber and Uber Eats part-time — can’t recall which one this is.
1702,3191,5,16,92,113,1.2300884955752212,0.048701290225684514,666,Look dear what I brought home for dinner!
2048,3191,4,18,91,113,1.2300884955752212,0.047050907076817174,666,He's lucky we've gone vegan last week.
2007,3191,3,20,90,113,1.2300884955752212,0.04534049011486548,666,My dorsal was itchy.
1851,3191,4,18,91,113,1.2300884955752212,0.047050907076817174,666,"I'm a loan shark, he'll pay for this!"
4824,3191,4,18,91,113,1.2300884955752212,0.047050907076817174,666,"He told me about a new kind of yoga, and I said: ""Sure, my Dorsal's been killing me!"""
2214,3191,0,26,87,113,1.2300884955752212,0.039770298027183626,666,Do these skinny legs make me look fat?
4657,3191,4,18,91,113,1.2300884955752212,0.047050907076817174,666,"So Greg, you're saying the dumb ones don't taste as good?"
4811,3191,3,20,90,113,1.2300884955752212,0.04534049011486548,666,"Apparently it's a killer core workout."""
1635,3191,2,22,89,113,1.2300884955752212,0.043562968573791494,666,Would you like to buy a human periscope?
4838,3191,5,16,92,113,1.2300884955752212,0.048701290225684514,666,I just feel weighted down.
5167,3191,3,20,90,113,1.2300884955752212,0.04534049011486548,666,It's what they call a foot massage.
5223,3191,3,20,90,113,1.2300884955752212,0.04534049011486548,666,"When his swimming lesson starts, I get first dibs."
5301,3191,3,20,90,113,1.2300884955752212,0.04534049011486548,666,"Honey, there's something that's been weighing on my shoulders."
5374,3191,3,20,90,113,1.2300884955752212,0.04534049011486548,666,This one needs to cook a little longer.
5722,3191,5,16,92,113,1.2300884955752212,0.048701290225684514,666,"Say, aren't the chum portions getting larger?"
5731,3191,3,20,90,113,1.2300884955752212,0.04534049011486548,666,"We make less than even Uber drivers, so we take a bite of the customer."
5861,3191,1,24,88,113,1.2300884955752212,0.04170976406150094,666,He does wonders for my sciatica
5897,3191,3,20,90,113,1.2300884955752212,0.04534049011486548,666,I can’t eat him until I cash out of his hedge fund.
5917,3191,2,22,89,113,1.2300884955752212,0.043562968573791494,666,"Brining and sun drying: salt, fat, acid, heat.  Don't you read?"
6138,3191,2,22,89,113,1.2300884955752212,0.043562968573791494,666,Here's your Uber Eats order.
6304,3191,2,22,89,113,1.2300884955752212,0.043562968573791494,666,If this edible hat thing catches on I'll eat my hat
4473,3191,2,22,89,113,1.2300884955752212,0.043562968573791494,666,You didn't know I work for Lyft?
4401,3191,4,18,91,113,1.2300884955752212,0.047050907076817174,666,"I know it's embarrassing, but times are tough and this Uber Scuber gig helps  a lot."
4333,3191,5,16,92,113,1.2300884955752212,0.048701290225684514,666,I just ate.  Do you want this son of a beach?
4172,3191,4,18,91,113,1.2300884955752212,0.047050907076817174,666,Boston Harbor. Says I’m too expensive. Want him?
2224,3191,4,18,91,113,1.2300884955752212,0.047050907076817174,666,"I try not to cause panics, but they really make it hard."
2398,3191,5,16,92,113,1.2300884955752212,0.048701290225684514,666,"Why?  Because supposedly surfers taste gnarly and bitter, that's why."
2597,3191,3,20,90,113,1.2300884955752212,0.04534049011486548,666,I’m saving him for my afternoon snack.
2698,3191,5,16,92,113,1.2300884955752212,0.048701290225684514,666,The food chain is a bit screwed up.
2927,3191,5,16,92,113,1.2300884955752212,0.048701290225684514,666,Where can I get a pair of those Bermuda shorts?
2946,3191,1,24,88,113,1.2300884955752212,0.04170976406150094,666,I'm trying to improve our image.
3121,3191,2,22,89,113,1.2300884955752212,0.043562968573791494,666,The ad said ‘stable employment’...I shoulda known...
2050,3191,3,20,90,113,1.2300884955752212,0.04534049011486548,666,Guess who just joined the sharing economy?
3164,3191,3,20,90,113,1.2300884955752212,0.04534049011486548,666,"He said he needed a leg up; actually, he meant “two.”"
3355,3191,2,22,89,113,1.2300884955752212,0.043562968573791494,666,I could eat.
3404,3191,3,20,90,113,1.2300884955752212,0.04534049011486548,666,Forget it! You don't stand a chance.
3672,3191,4,18,91,113,1.2300884955752212,0.047050907076817174,666,Hanging ten is no longer an option I’m afraid.
3762,3191,4,18,91,113,1.2300884955752212,0.047050907076817174,666,I  had no idea this was what pool shark meant.
3898,3191,3,20,90,113,1.2300884955752212,0.04534049011486548,666,He's ordering me the two for one tuna special in trade for a ride home.
4031,3191,5,16,92,113,1.2300884955752212,0.048701290225684514,666,"I've got mine, you get yours"
4112,3191,5,16,92,113,1.2300884955752212,0.048701290225684514,666,The Swedish was getting old. I decided to try Thai.
3244,3191,4,18,91,113,1.2300884955752212,0.047050907076817174,666,He's happy keeping his head above water but I'm taking him for a ride!
1605,3191,4,18,91,113,1.2300884955752212,0.047050907076817174,666,"I'm still top of the food chain, Frank. Yes, they call for a ride on the app, but I get to decide if I want to accept it."
206,3191,4,18,91,113,1.2300884955752212,0.047050907076817174,666,"""I'm giving him a lift to Amity."
1396,3191,2,22,89,113,1.2300884955752212,0.043562968573791494,666,I just didn't have the heart.
1347,3191,6,14,93,113,1.2300884955752212,0.050297549468551875,666,"What, I signed up to be a UBER driver."
969,3191,6,14,93,113,1.2300884955752212,0.050297549468551875,666,"We have a ""You scratch my back, I'll remove your calluses"" type of relationship."
607,3191,6,14,93,113,1.2300884955752212,0.050297549468551875,666,I'm saving half for tomorrow's lunch.
310,3191,5,16,92,113,1.2300884955752212,0.048701290225684514,666,"Should we eat him now, or let him scream more?"
1509,3191,1,24,88,113,1.2300884955752212,0.04170976406150094,666,I don’t want to hear a word out of you.
58,3191,5,16,92,113,1.2300884955752212,0.048701290225684514,666,Why do I always have to be your wing man?
15,3191,3,20,90,113,1.2300884955752212,0.04534049011486548,666,I'm saving this half for a mid-day snack.
3827,3246,4,22,105,131,1.2290076335877862,0.04275438255865931,666,Uber went under.
3054,3247,4,18,92,114,1.2280701754385965,0.04668000738510451,666,"Morally, I’m against the lifestyle.
But my back has never felt better."
2851,3247,2,22,90,114,1.2280701754385965,0.04322629175887577,666,Don’t say that I never gave you anything”
2457,3247,2,22,90,114,1.2280701754385965,0.04322629175887577,666,"It turns out, I really like surfing."
2270,3247,2,22,90,114,1.2280701754385965,0.04322629175887577,666,You want him head first or feet first?
1117,3247,6,14,94,114,1.2280701754385965,0.0498952290276673,666,It's not that deep; I can still touch bottom!
1190,3247,3,20,91,114,1.2280701754385965,0.04498630563125218,666,Dinner tonight? I've got too much for just me.
3513,3247,6,14,94,114,1.2280701754385965,0.0498952290276673,666,He says it will rehabilitate our image and I get a week's engagement at SeaWorld.
493,3247,1,24,89,114,1.2280701754385965,0.04139150763258655,666,"I've hated the beach since I first saw ""Feet""."
1644,3247,2,22,90,114,1.2280701754385965,0.04322629175887577,666,I can barely pay the fish monger with the cash this UBER Stand Up Board gig brings in.
3772,3247,2,22,90,114,1.2280701754385965,0.04322629175887577,666,Working for Uber as a side gig is helping me pay off my student loans.
4120,3247,3,20,91,114,1.2280701754385965,0.04498630563125218,666,There are some downsides to the gig economy but at least my schedule is flexible.
4478,3247,1,24,89,114,1.2280701754385965,0.04139150763258655,666,Is it leg day?
4673,3247,3,20,91,114,1.2280701754385965,0.04498630563125218,666,I brought him to share
5890,3247,5,16,93,114,1.2280701754385965,0.04831437140849907,666,"Take him, I'm vegetarian!"
3830,3247,3,20,91,114,1.2280701754385965,0.04498630563125218,666,You’ll get your sea legs someday.
5148,3262,5,18,100,123,1.2276422764227641,0.0459081480870937,666,But Uber takes most of the fare. I keep almost nothing.
2892,3263,4,17,89,110,1.2272727272727273,0.04773273331484981,666,He want  me to pick up another.  Invite the family over for dinner.
1711,3263,4,17,89,110,1.2272727272727273,0.04773273331484981,666,This growth ruins my chances with the seals
2003,3263,5,15,90,110,1.2272727272727273,0.0494491607724479,666,Upper or lower?
5924,3263,5,15,90,110,1.2272727272727273,0.0494491607724479,666,It's just my side-hustle.
1575,3267,5,26,128,159,1.2264150943396226,0.03881507448550428,666,"Okay, flip him. Heads he’s mine, tails he’s yours"
5056,3268,5,21,111,137,1.2262773722627738,0.042708711037555025,666,It's this new thing called Uber Shark. You should sign up.
2460,3269,3,20,92,115,1.2260869565217392,0.04463748303521268,666,"no, you can't have the legs again."
3058,3269,7,12,96,115,1.2260869565217392,0.05101691971205024,666,Oh yeah? Let's see YOU swallow a surfboard in one bite!
1913,3269,3,20,92,115,1.2260869565217392,0.04463748303521268,666,Split him now and nosh later?
2631,3269,4,18,93,115,1.2260869565217392,0.04631479453711978,666,"I don’t care if he is a big shot attorney, this professional courtesy thing has gotten out of hand."
1624,3269,5,16,94,115,1.2260869565217392,0.04793344859607266,666,"Apparently, his name is ""superego""...but who knows!"
2950,3269,5,16,94,115,1.2260869565217392,0.04793344859607266,666,He's annoying me but I just ate.  Have you eaten yet?
4326,3269,4,18,93,115,1.2260869565217392,0.04631479453711978,666,We have an arrangement. He runs a cruise line.
2015,3269,5,16,94,115,1.2260869565217392,0.04793344859607266,666,I brought a snack.
5018,3269,5,16,94,115,1.2260869565217392,0.04793344859607266,666,Wanna play 'wishbone'?
5889,3269,7,12,96,115,1.2260869565217392,0.05101691971205024,666,I'll split him with you if you eat the pants.
6036,3269,5,16,94,115,1.2260869565217392,0.04793344859607266,666,Did you order dinner delivered?
3876,3280,4,17,90,111,1.2252252252252251,0.04734504824060214,666,"He’s not as irritating as a ramora, and getting into The Hamptons is a snap."
3616,3280,3,19,89,111,1.2252252252252251,0.04558238068711177,666,"It’s Jimmy Buffet, you imbecile!"
5855,3280,3,19,89,111,1.2252252252252251,0.04558238068711177,666,Aquaman forgot where he parked again.
6087,3280,5,15,91,111,1.2252252252252251,0.04904440596750161,666,Vegetarian Shark Week sucks.
6158,3280,3,19,89,111,1.2252252252252251,0.04558238068711177,666,He can’t swim; plus he paid me lots of money to promise not to tell anyone.
6160,3280,5,15,91,111,1.2252252252252251,0.04904440596750161,666,He's my fish finder.
6234,3280,1,23,87,111,1.2252252252252251,0.041834831199664864,666,It's much more fun once you go vegan!
3550,3280,5,15,91,111,1.2252252252252251,0.04904440596750161,666,"Look what we have to constantly put up with.  And if I bite the kid, all of shark nation will be accused of inappropriate aggression.
David Fleischer, New York, NY"
3492,3280,2,21,88,111,1.2252252252252251,0.04374875158566946,666,"That's not what I meant when I said get a backbone, Bob."
3488,3280,4,17,90,111,1.2252252252252251,0.04734504824060214,666,"I agree... Ever since Aquaman went vegan, he's been acting like such a wimp."
3415,3280,4,17,90,111,1.2252252252252251,0.04734504824060214,666,It's for an instagram post. When he stops filming I'm going to eat him.
3349,3280,3,19,89,111,1.2252252252252251,0.04558238068711177,666,In my other life I was a surfboard.
3188,3280,3,19,89,111,1.2252252252252251,0.04558238068711177,666,I just ate. I'm saving him for later.
3048,3280,3,19,89,111,1.2252252252252251,0.04558238068711177,666,"This is not what I had in mind for a ""movable feast''!"
6248,3280,2,21,88,111,1.2252252252252251,0.04374875158566946,666,"Was it tasty?"" 
""Not half."
2563,3280,3,19,89,111,1.2252252252252251,0.04558238068711177,666,I don’t know what he’s doing but he’s been up there for hours.
2533,3280,4,17,90,111,1.2252252252252251,0.04734504824060214,666,"Yeah,now he's got my back,but later I get his."
2147,3280,4,17,90,111,1.2252252252252251,0.04734504824060214,666,Noticed squirrels store acorns.
3438,3280,4,17,90,111,1.2252252252252251,0.04734504824060214,666,"Who does he think I am, Uber?"
3744,3280,6,13,92,111,1.2252252252252251,0.05068682196099171,666,MSGA - Make Sharks Great Again!
5689,3280,3,19,89,111,1.2252252252252251,0.04558238068711177,666,It actually relieves my back pain.
3877,3280,4,17,90,111,1.2252252252252251,0.04734504824060214,666,"Nah, they’re too bony."
4034,3280,2,21,88,111,1.2252252252252251,0.04374875158566946,666,Sometimes I can really identify with Rodney Dangerfield.  No respect.
2096,3280,4,17,90,111,1.2252252252252251,0.04734504824060214,666,"Mom told me about parasites,  but this is rediculous."
3819,3280,4,17,90,111,1.2252252252252251,0.04734504824060214,666,Can you imagine how many likes I'd get?
4061,3280,2,21,88,111,1.2252252252252251,0.04374875158566946,666,"Yes, Uber has hit the open seas. I figured I'd try it for a while as I'm always just cruising around anyway."
4133,3280,5,15,91,111,1.2252252252252251,0.04904440596750161,666,He’s part of my new balanced diet.
3807,3280,5,15,91,111,1.2252252252252251,0.04904440596750161,666,They really need to re-release Jaws on the big screen.
4168,3280,5,15,91,111,1.2252252252252251,0.04904440596750161,666,It's Damien Hirst. Do you know anything about Formaldehyde?
4426,3280,4,17,90,111,1.2252252252252251,0.04734504824060214,666,"Why, it's ashiatsu massage, of course!"
4444,3280,1,23,87,111,1.2252252252252251,0.041834831199664864,666,He said if I hold him up he can tell me what the weather's like.
4604,3280,5,15,91,111,1.2252252252252251,0.04904440596750161,666,She got the house and half of everything I have.
4687,3280,3,19,89,111,1.2252252252252251,0.04558238068711177,666,He says he's a remora.
4732,3280,7,11,93,111,1.2252252252252251,0.052277663340144,666,Going vegan is a delicate balancing act.
4807,3280,4,17,90,111,1.2252252252252251,0.04734504824060214,666,At least I have something to sink my teeth into!
4979,3280,6,13,92,111,1.2252252252252251,0.05068682196099171,666,I'm waiting for just the right moment
4999,3280,1,23,87,111,1.2252252252252251,0.041834831199664864,666,Nothing beats a neck massage before dinner.
5061,3280,6,13,92,111,1.2252252252252251,0.05068682196099171,666,"Not yet, I’m waiting till he turns 18."
5425,3280,4,17,90,111,1.2252252252252251,0.04734504824060214,666,"I can't hurt him until he sees that he's in danger. You know, like in the old cartoons. Trust me, it'll be hilarious when he finally looks down here and I can eat him."
5482,3280,4,17,90,111,1.2252252252252251,0.04734504824060214,666,Dinner cruise ...
5540,3280,4,17,90,111,1.2252252252252251,0.04734504824060214,666,I don't know how much longer I can wait here until I have lunch.
5839,3280,3,19,89,111,1.2252252252252251,0.04558238068711177,666,I thought I’d better bring my own lunch today.
2054,3280,2,21,88,111,1.2252252252252251,0.04374875158566946,666,Just when you thought it was safe to go onto the sand bar...
1302,3280,7,11,93,111,1.2252252252252251,0.052277663340144,666,It causes way less chaos than a dorsal fin.
1933,3280,1,23,87,111,1.2252252252252251,0.041834831199664864,666,"First it was sushi, now Ahiatsu massage, what's next?!"
1973,3280,1,23,87,111,1.2252252252252251,0.041834831199664864,666,Do you want it over easy?
5083,3280,4,17,90,111,1.2252252252252251,0.04734504824060214,666,Haven't you heard of the new gig economy?
4,3280,7,11,93,111,1.2252252252252251,0.052277663340144,666,You told me you liked legs over easy!
334,3280,3,19,89,111,1.2252252252252251,0.04558238068711177,666,Is it lunch time yet?
481,3280,2,21,88,111,1.2252252252252251,0.04374875158566946,666,"Disgusting.. it's a literal Jaws remake titled 'No Guts, No Glory.'"
492,3280,5,15,91,111,1.2252252252252251,0.04904440596750161,666,Do you want to pants him or should I?
484,3280,5,15,91,111,1.2252252252252251,0.04904440596750161,666,"In Amity they say ""shak."""
755,3280,3,19,89,111,1.2252252252252251,0.04558238068711177,666,"It's been a long day, so I just ordered some takeout."
892,3280,3,19,89,111,1.2252252252252251,0.04558238068711177,666,I'm sick of acting kind.
1367,3280,4,17,90,111,1.2252252252252251,0.04734504824060214,666,"I know it's not much of role but ""Companion Shark"" was all they had for me today."
1595,3280,3,19,89,111,1.2252252252252251,0.04558238068711177,666,What did you do with rest of him?
1698,3280,5,15,91,111,1.2252252252252251,0.04904440596750161,666,I get nervous if I don't keep a little snack on me.
656,3280,4,17,90,111,1.2252252252252251,0.04734504824060214,666,I kind of think of him as a sharknerdo.
2282,3338,7,13,100,120,1.225,0.04945430508374905,666,"Okay, you're right. Americans are delusional. Let's eat"
542,3339,8,17,122,147,1.2244897959183674,0.04402191739784427,666,I was fine with it till he started with the theme music.
3104,3340,7,16,111,134,1.2238805970149254,0.04573836079689509,666,You can eat him after he’s done giving me a back rub.
1350,3340,2,26,106,134,1.2238805970149254,0.0391266328121487,666,"Your turn for ""William Tell"""
3152,3342,3,17,83,103,1.2233009708737863,0.047659955080602695,666,I'm just here to support people.
5189,3343,2,21,89,112,1.2232142857142858,0.04340298844712003,666,A little bit higher.... ahhhh!
1415,3343,5,15,92,112,1.2232142857142858,0.04864611894865116,666,I ate the top part.
3012,3345,3,18,87,108,1.2222222222222223,0.046201009590497714,666,...it pays well
2467,3345,2,20,86,108,1.2222222222222223,0.04428840729415601,666,I'm practicing willpower for my summer body.
4488,3345,4,16,88,108,1.2222222222222223,0.048037522351901875,666,Marge said I needed to take my lunch to go.
4164,3345,4,16,88,108,1.2222222222222223,0.048037522351901875,666,Global warming!!!
2567,3345,4,16,88,108,1.2222222222222223,0.048037522351901875,666,"For fifty bucks, you can ride a shark.
For another fifty, you can be eaten by a shark."
2610,3345,2,20,86,108,1.2222222222222223,0.04428840729415601,666,Ya I can play rough. But a little footsie is nice too.
2620,3345,5,14,89,108,1.2222222222222223,0.04980636325046914,666,I’ve had a wicked headache for the last hour! Maybe I’m just hungry. Anything around here to eat?”
2638,3345,4,16,88,108,1.2222222222222223,0.048037522351901875,666,These humans are literally giving me a headache!
4147,3345,4,16,88,108,1.2222222222222223,0.048037522351901875,666,This isn't what I meant when I said I wanted a human for my birthday.
4089,3345,4,16,88,108,1.2222222222222223,0.048037522351901875,666,It's just until he gets his swimming legs.
3970,3345,3,18,87,108,1.2222222222222223,0.046201009590497714,666,"Yeah, it's my side-hustle.  They call it ""Shoga."""
3962,3345,3,18,87,108,1.2222222222222223,0.046201009590497714,666,I don't have a fork.
3791,3345,4,16,88,108,1.2222222222222223,0.048037522351901875,666,"Doing Uber is ok, but you need a phone that works underwater."
3714,3345,4,16,88,108,1.2222222222222223,0.048037522351901875,666,Screw the friendly fish campaign. I wanna eat this guy.
3578,3345,3,18,87,108,1.2222222222222223,0.046201009590497714,666,He said he was hiding from a lone shark.
3433,3345,5,14,89,108,1.2222222222222223,0.04980636325046914,666,Don't blame me.  It started as a pimple on my back.
3287,3345,3,18,87,108,1.2222222222222223,0.046201009590497714,666,"Honestly, he's done wonders for my back"
3284,3345,3,18,87,108,1.2222222222222223,0.046201009590497714,666,"Yeah, I know the money isn't great, but at least working for Uber I get to set my own hours."
3133,3345,5,14,89,108,1.2222222222222223,0.04980636325046914,666,He found out it's Shark International Vegetarian Week
2695,3345,3,18,87,108,1.2222222222222223,0.046201009590497714,666,Ever get tired of carry-out?
3045,3345,5,14,89,108,1.2222222222222223,0.04980636325046914,666,"I'm trying to ignore it. If I bite it, they cull at least 200 of us."
3020,3345,1,22,85,108,1.2222222222222223,0.042289392926889366,666,"Doug, you need to stop letting people walk all over you."
2775,3345,4,16,88,108,1.2222222222222223,0.048037522351901875,666,It's only fair.  I ate his surfboard.
3062,3345,2,20,86,108,1.2222222222222223,0.04428840729415601,666,Wait until this kink in my neck gets worked out.
4977,3345,0,24,84,108,1.2222222222222223,0.04019107472557346,666,Top half was chewy.
4905,3345,3,18,87,108,1.2222222222222223,0.046201009590497714,666,I don't know how it happened but I can't stay still any longer.
4619,3345,2,20,86,108,1.2222222222222223,0.04428840729415601,666,"Watch out, I’m running late for Ubersea"
4629,3345,4,16,88,108,1.2222222222222223,0.048037522351901875,666,You seen this guys wife?
6222,3345,4,16,88,108,1.2222222222222223,0.048037522351901875,666,I’m beginning to think our new vegan diet is overrated.
6106,3345,4,16,88,108,1.2222222222222223,0.048037522351901875,666,It's this new thing called Uber.
4553,3345,4,16,88,108,1.2222222222222223,0.048037522351901875,666,He promised his kids if he can find them
5943,3345,2,20,86,108,1.2222222222222223,0.04428840729415601,666,You can't say I never bring you a tasty dinner
5872,3345,3,18,87,108,1.2222222222222223,0.046201009590497714,666,"It's all fake news ... the dumb lawyer jokes and the smart ass
dolphins. I'm doing this so they'll leave us and our fins alone."
4545,3345,6,12,90,108,1.2222222222222223,0.05151450365446505,666,Personally I prefer the breast.
5801,3345,4,16,88,108,1.2222222222222223,0.048037522351901875,666,I just feel like maybe this politically correct thing is getting a little out of hand.
5794,3345,4,16,88,108,1.2222222222222223,0.048037522351901875,666,But I need this job to make fins meet.
5680,3345,2,20,86,108,1.2222222222222223,0.04428840729415601,666,I'm just waiting for that scary Jaws music.
5622,3345,2,20,86,108,1.2222222222222223,0.04428840729415601,666,‘Have you seen my dinner?’
5582,3345,0,24,84,108,1.2222222222222223,0.04019107472557346,666,"I know our relationship is unhealthy, but it's nice to feel needed."
4779,3345,4,16,88,108,1.2222222222222223,0.048037522351901875,666,"I can't, as much as I'd like to. He said he's a PETA agent and needed a Lyft."
5543,3345,2,20,86,108,1.2222222222222223,0.04428840729415601,666,Not sure this ride sharing business is really worth it!
5441,3345,5,14,89,108,1.2222222222222223,0.04980636325046914,666,I think this species is learning to adapt...
5380,3345,3,18,87,108,1.2222222222222223,0.046201009590497714,666,He’s on loan.
5347,3345,4,16,88,108,1.2222222222222223,0.048037522351901875,666,They say opposites attract.
4872,3345,2,20,86,108,1.2222222222222223,0.04428840729415601,666,I find it more effective than octopus's aquapuncture cupping.
5059,3345,4,16,88,108,1.2222222222222223,0.048037522351901875,666,They call me Uber shark
5008,3345,4,16,88,108,1.2222222222222223,0.048037522351901875,666,I like your hat.
4880,3345,2,20,86,108,1.2222222222222223,0.04428840729415601,666,I like mine half baked
4959,3345,2,20,86,108,1.2222222222222223,0.04428840729415601,666,The surf gouging always takes them by surprise.
4518,3345,3,18,87,108,1.2222222222222223,0.046201009590497714,666,What can I do?  It was this or become a pair of loafers.
4930,3345,2,20,86,108,1.2222222222222223,0.04428840729415601,666,"Whatever you do, don’t start your shift on an empty stomach."
2445,3345,5,14,89,108,1.2222222222222223,0.04980636325046914,666,He gets internship credit at law school. I get free chum.
2395,3345,2,20,86,108,1.2222222222222223,0.04428840729415601,666,He promised to let me eat him when he is done with the water polo game.  Care for a limb?
2822,3345,2,20,86,108,1.2222222222222223,0.04428840729415601,666,"Ugh, his feet are freezing."
1912,3345,5,14,89,108,1.2222222222222223,0.04980636325046914,666,I  know but it's too early for lunch.
2078,3345,4,16,88,108,1.2222222222222223,0.048037522351901875,666,Uber is testing some new services. I prefer passengers over this food delivery though.
49,3345,2,20,86,108,1.2222222222222223,0.04428840729415601,666,"Yea, He's a stand-up guy."
152,3345,5,14,89,108,1.2222222222222223,0.04980636325046914,666,"Evidently, he hasn't seen JAWS!"
154,3345,4,16,88,108,1.2222222222222223,0.048037522351901875,666,"Because he's managing partner, that's why."
177,3345,5,14,89,108,1.2222222222222223,0.04980636325046914,666,"I'm trying out for Aqua-Uber, so don't even think about it!"
273,3345,4,16,88,108,1.2222222222222223,0.048037522351901875,666,I'd eat him but he really helps me back!
363,3345,4,16,88,108,1.2222222222222223,0.048037522351901875,666,"No,I'm a bait white shark."
718,3345,4,16,88,108,1.2222222222222223,0.048037522351901875,666,My humiliation is complete.
866,3345,4,16,88,108,1.2222222222222223,0.048037522351901875,666,He's sooo lucky I've become a vegan.
1045,3345,3,18,87,108,1.2222222222222223,0.046201009590497714,666,When they think you’re a reef it takes all the fun out of it.
1135,3345,3,18,87,108,1.2222222222222223,0.046201009590497714,666,Oh my God I felt something!
1299,3345,4,16,88,108,1.2222222222222223,0.048037522351901875,666,I chose a massage over dinner
1306,3345,4,16,88,108,1.2222222222222223,0.048037522351901875,666,"It's Mark Cuban, and he's the star of the show"
1321,3345,4,16,88,108,1.2222222222222223,0.048037522351901875,666,What can I say? I owed him a favor.
853,3345,2,20,86,108,1.2222222222222223,0.04428840729415601,666,Does this make me into a nurse shark.
1453,3345,3,18,87,108,1.2222222222222223,0.046201009590497714,666,"I keep telling him,
It’s JUMP the shark."
1754,3345,4,16,88,108,1.2222222222222223,0.048037522351901875,666,"Ron, get it off"
1332,3345,2,20,86,108,1.2222222222222223,0.04428840729415601,666,I feel bad that I ate his surfboard.
1718,3345,3,18,87,108,1.2222222222222223,0.046201009590497714,666,You're going to need a bigger back.
1694,3345,5,14,89,108,1.2222222222222223,0.04980636325046914,666,...But dude! You should have seen us in the barrel!
1691,3345,3,18,87,108,1.2222222222222223,0.046201009590497714,666,"I want to give true homage to John Donne and the 'No man is an island' meme, but I'm conflicted because I haven't had lunch yet."
1523,3345,1,22,85,108,1.2222222222222223,0.042289392926889366,666,We are waiting for the big wave.
1561,3345,2,20,86,108,1.2222222222222223,0.04428840729415601,666,"Yeah, they call it ""sharkboarding"", can you imagine?"
1494,3345,6,12,90,108,1.2222222222222223,0.05151450365446505,666,Hang ten? Watch this.
1454,3345,2,20,86,108,1.2222222222222223,0.04428840729415601,666,I know you told me not to play with my food but it's just too much fun.
1520,3345,0,24,84,108,1.2222222222222223,0.04019107472557346,666,This sharkboarding is exhausting!
4452,3426,3,23,105,131,1.2213740458015268,0.04096613088549232,666,"Nah, this one's an hors d'oeuvre."
4161,3427,3,19,91,113,1.2212389380530972,0.044859862695137545,666,We’re just messing with the Lifeguard
3382,3427,2,21,90,113,1.2212389380530972,0.043062506524023,666,I got five yelps from my last meal...ready to count?
5664,3429,6,14,98,118,1.2203389830508475,0.048347445406947874,666,It's all about the optics.
862,3430,2,20,87,109,1.2201834862385321,0.043927546231223726,666,What’s the score?
2299,3431,4,21,107,132,1.2196969696969697,0.04208644972494561,666,"Kevin, please don’t tell my dad..."
5571,3432,4,17,93,114,1.219298245614035,0.046218216889008214,666,Said he forgot his surf board!
4278,3433,1,21,83,105,1.2190476190476192,0.042755271681801814,666,"Yes, fine, but what I asked you is, ""Do I have something in my teeth?"""
1169,3434,4,14,83,101,1.2178217821782178,0.04995832004571433,666,"To bite or not to bit , that is the question?"
4894,3435,3,19,93,115,1.2173913043478262,0.044159423919739836,666,This way people  think he can walk on water.
2090,3435,4,17,94,115,1.2173913043478262,0.045854225783672445,666,"No Jerry, I don't like you're new hat."
2580,3435,4,17,94,115,1.2173913043478262,0.045854225783672445,666,"Yeah, but you should see what I did to his surfboard."
3803,3438,3,17,86,106,1.2169811320754718,0.04644547176488884,666,I had a stint at SeaWorld.
3623,3438,3,17,86,106,1.2169811320754718,0.04644547176488884,666,"I don’t think so, but if it is Aquaman, I don’t want any trouble!"
3901,3438,2,19,85,106,1.2169811320754718,0.04446894790914134,666,"It may be my fin, but it's gonna be his fin-ish."
3982,3438,3,17,86,106,1.2169811320754718,0.04644547176488884,666,He called it a sharkskin suit.
4007,3438,2,19,85,106,1.2169811320754718,0.04446894790914134,666,You can have him if you want...not enough meat on the bones for me.
3814,3438,4,15,87,106,1.2169811320754718,0.04834124912308584,666,"You suppose he'll yell ""Hang five!"" when I get through with him?"
4048,3438,5,13,88,106,1.2169811320754718,0.05016543517300939,666,Just like an arrogant white guy -- can't stand on his own without the underclass.
4322,3438,5,13,88,106,1.2169811320754718,0.05016543517300939,666,Can you get this guy off my back?
4065,3438,4,15,87,106,1.2169811320754718,0.04834124912308584,666,"Look at me:
I have a periscope and you don't; 
so there!"
4115,3438,3,17,86,106,1.2169811320754718,0.04644547176488884,666,"We have this deal.  He shows his friends he can walk on water, and then he carries me over to the kiddie pool."
4136,3438,3,17,86,106,1.2169811320754718,0.04644547176488884,666,I heard they pay the other lifeguards $20 an hour
4162,3438,1,21,84,106,1.2169811320754718,0.04240038689480044,666,The world used to be on the back of a tortoise.
4229,3438,3,17,86,106,1.2169811320754718,0.04644547176488884,666,He said he would get me on Bay Watch
4254,3438,3,17,86,106,1.2169811320754718,0.04644547176488884,666,I am really making good money as an Uber driver.
4277,3438,3,17,86,106,1.2169811320754718,0.04644547176488884,666,"It’s kinda scary. In a very deep voice, this guy keeps saying “dum dum dum dum.”"
4285,3438,3,17,86,106,1.2169811320754718,0.04644547176488884,666,He's a member of the Remora Union.
4291,3438,3,17,86,106,1.2169811320754718,0.04644547176488884,666,This would have to happen just when I start my diet.
4394,3438,5,13,88,106,1.2169811320754718,0.05016543517300939,666,This lure was a stupid idea.
4410,3438,4,15,87,106,1.2169811320754718,0.04834124912308584,666,"I tried to tell him I'm a shark, not a skate."
4453,3438,2,19,85,106,1.2169811320754718,0.04446894790914134,666,I heard you prefer the thighs.
4536,3438,4,15,87,106,1.2169811320754718,0.04834124912308584,666,I feel like I've lost some respect since I became a vegetarian.
4546,3438,4,15,87,106,1.2169811320754718,0.04834124912308584,666,Synchronized Standing Competition
4050,3438,1,21,84,106,1.2169811320754718,0.04240038689480044,666,We get no respect since that damn song hit YouTube.
3612,3438,1,21,84,106,1.2169811320754718,0.04240038689480044,666,Honestly it's called a massage
3288,3438,4,15,87,106,1.2169811320754718,0.04834124912308584,666,I feel so used.
3605,3438,3,17,86,106,1.2169811320754718,0.04644547176488884,666,"Haven't you heard? Delayed gratification, man! It's the bomb."
2896,3438,1,21,84,106,1.2169811320754718,0.04240038689480044,666,Now I know how equestrian horses feel.
2906,3438,4,15,87,106,1.2169811320754718,0.04834124912308584,666,Do I turn him over? Or gobble him up half baked?
2943,3438,1,21,84,106,1.2169811320754718,0.04240038689480044,666,Some guys will do anything to look a little taller.
2980,3438,5,13,88,106,1.2169811320754718,0.05016543517300939,666,It’s portion control...I’ll eat the other half later.
2998,3438,2,19,85,106,1.2169811320754718,0.04446894790914134,666,Don't let your food play with you.
3030,3438,2,19,85,106,1.2169811320754718,0.04446894790914134,666,He didn't jump high enough.
3046,3438,3,17,86,106,1.2169811320754718,0.04644547176488884,666,"It doesn't seem fair, wouldn't you say?"
3065,3438,4,15,87,106,1.2169811320754718,0.04834124912308584,666,You ordered UberEats?
3108,3438,4,15,87,106,1.2169811320754718,0.04834124912308584,666,"He said he was the world’s greatest deal maker so I said, ‘Heads or tails?’"
3119,3438,1,21,84,106,1.2169811320754718,0.04240038689480044,666,I prefer working with live bait
3138,3438,3,17,86,106,1.2169811320754718,0.04644547176488884,666,"If you can't eat em, join them!"
3216,3438,4,15,87,106,1.2169811320754718,0.04834124912308584,666,I don't know WHATS come over me lately!
3257,3438,2,19,85,106,1.2169811320754718,0.04446894790914134,666,"Oh, it's some kind of proverb, I'm sure."
3266,3438,6,11,89,106,1.2169811320754718,0.05192557563874058,666,My agent told me if I took a surfboard gig I'd be able to grab bigger parts.
4581,3438,2,19,85,106,1.2169811320754718,0.04446894790914134,666,If it digs in its toenails one more time I’m going to eat it.
3406,3438,4,15,87,106,1.2169811320754718,0.04834124912308584,666,You hungry? I've got dinner on my mind.
3424,3438,2,19,85,106,1.2169811320754718,0.04446894790914134,666,I’m his lawyer.
3455,3438,5,13,88,106,1.2169811320754718,0.05016543517300939,666,"Sure they taste great, but this guy gives a fantastic back rub"
3471,3438,3,17,86,106,1.2169811320754718,0.04644547176488884,666,Don’t ask me!
3494,3438,3,17,86,106,1.2169811320754718,0.04644547176488884,666,Meal prepping has changed my life
3511,3438,2,19,85,106,1.2169811320754718,0.04446894790914134,666,I'm beginning to think I'm not cut out for Cirque du Soleil after all.
3535,3438,1,21,84,106,1.2169811320754718,0.04240038689480044,666,He just thinks he hasn't gone off the deep end.
3563,3438,3,17,86,106,1.2169811320754718,0.04644547176488884,666,"Counterintuitive, I know. But it stabilizes me and lets me go faster."
3608,3438,1,21,84,106,1.2169811320754718,0.04240038689480044,666,Uber has expanded.
4591,3438,1,21,84,106,1.2169811320754718,0.04240038689480044,666,Apparently it’s called “extreme” surfing
5166,3438,2,19,85,106,1.2169811320754718,0.04446894790914134,666,I miss stand-up paddleboarding.
4632,3438,4,15,87,106,1.2169811320754718,0.04834124912308584,666,Speilberg cut this scene just before release!
5413,3438,3,17,86,106,1.2169811320754718,0.04644547176488884,666,I guess another one got his better half.
5433,3438,4,15,87,106,1.2169811320754718,0.04834124912308584,666,"Ok, so it's not goat yoga."
5434,3438,5,13,88,106,1.2169811320754718,0.05016543517300939,666,Paying passengers help pay the dental bills.
5581,3438,4,15,87,106,1.2169811320754718,0.04834124912308584,666,I'd been warned about picking up parasites in these waters.
5596,3438,2,19,85,106,1.2169811320754718,0.04446894790914134,666,Now I understand.
5634,3438,3,17,86,106,1.2169811320754718,0.04644547176488884,666,I invested in his business on Shark Tank last night
5650,3438,5,13,88,106,1.2169811320754718,0.05016543517300939,666,I have no idea where I'm going to install the Uber sign.
5703,3438,0,23,83,106,1.2169811320754718,0.04022559246936711,666,Ecotourism pays the gills.
5725,3438,3,17,86,106,1.2169811320754718,0.04644547176488884,666,He has no clue he is standing on sharkey ground.
5791,3438,4,15,87,106,1.2169811320754718,0.04834124912308584,666,"Before we take him for dinner, let him give you a Shiatzu"
5797,3438,4,15,87,106,1.2169811320754718,0.04834124912308584,666,It's the latest in gadgetry. A human periscope.
5809,3438,4,15,87,106,1.2169811320754718,0.04834124912308584,666,"Leap, and the net will appear."
5909,3438,5,13,88,106,1.2169811320754718,0.05016543517300939,666,The top was a little too rare for my taste.
5985,3438,2,19,85,106,1.2169811320754718,0.04446894790914134,666,You order Door Dash?
6042,3438,3,17,86,106,1.2169811320754718,0.04644547176488884,666,"I  guess  the  swimmer  was   not  as  fast  as
I   thought!"""
6045,3438,4,15,87,106,1.2169811320754718,0.04834124912308584,666,I asked for Swedish not Thai
6089,3438,1,21,84,106,1.2169811320754718,0.04240038689480044,666,You actually have to admire his balance.
6097,3438,2,19,85,106,1.2169811320754718,0.04446894790914134,666,"Dude, this massage is dooope."
6108,3438,6,11,89,106,1.2169811320754718,0.05192557563874058,666,"Careful, these waters are leg-infested."
6112,3438,3,17,86,106,1.2169811320754718,0.04644547176488884,666,It’s more than embarrassing. It’s sole crushing.
6125,3438,4,15,87,106,1.2169811320754718,0.04834124912308584,666,Will you be paying with cash or credit?
6177,3438,2,19,85,106,1.2169811320754718,0.04446894790914134,666,Order's up.
6229,3438,3,17,86,106,1.2169811320754718,0.04644547176488884,666,The fin was getting me the wrong kind of attention.
5396,3438,5,13,88,106,1.2169811320754718,0.05016543517300939,666,"Yeah, but this one claims he knows the casting director for the Jaws remake."
5390,3438,3,17,86,106,1.2169811320754718,0.04644547176488884,666,"Trust me, it's weirder for me than it is for you."
5336,3438,2,19,85,106,1.2169811320754718,0.04446894790914134,666,He doesn't like swimming so I'm his Uber-shark.
5328,3438,4,15,87,106,1.2169811320754718,0.04834124912308584,666,"I had half for lunch, and I'm saving the rest for dinner."
4683,3438,3,17,86,106,1.2169811320754718,0.04644547176488884,666,I'm brining him before I eat him.
4696,3438,7,9,90,106,1.2169811320754718,0.05362797707103756,666,Tourists pay better than scientists.
4790,3438,2,19,85,106,1.2169811320754718,0.04446894790914134,666,Hummm... The water is more shallow than I thought.
4878,3438,1,21,84,106,1.2169811320754718,0.04240038689480044,666,"I get him fish, he gets me poachers."
4883,3438,3,17,86,106,1.2169811320754718,0.04644547176488884,666,"Well, this is a new one on me!"
4928,3438,4,15,87,106,1.2169811320754718,0.04834124912308584,666,I’m trying a new thing where I eat half and save half for later.
4938,3438,3,17,86,106,1.2169811320754718,0.04644547176488884,666,I'm volunteering with Dins On Fins.
4942,3438,5,13,88,106,1.2169811320754718,0.05016543517300939,666,This Uber surfing gig will pay for my trip to South Carolina this winter.
4962,3438,3,17,86,106,1.2169811320754718,0.04644547176488884,666,He grew tired of bucking broncos.
4970,3438,4,15,87,106,1.2169811320754718,0.04834124912308584,666,he said i could eat his brother if I gave him a ride
5025,3438,3,17,86,106,1.2169811320754718,0.04644547176488884,666,I always come here in July for spine therapy
4600,3438,3,17,86,106,1.2169811320754718,0.04644547176488884,666,I'd skip it. It tastes like chicken.
5078,3438,3,17,86,106,1.2169811320754718,0.04644547176488884,666,What bothers me is that he thinks I'm a segway.
5113,3438,3,17,86,106,1.2169811320754718,0.04644547176488884,666,I can't make out what he wants me to do. Submerge and he'll drown. Surface float and he'll get sunburned.
5124,3438,3,17,86,106,1.2169811320754718,0.04644547176488884,666,"God, this neighborhood has become so gentrified."
5132,3438,5,13,88,106,1.2169811320754718,0.05016543517300939,666,"Yeah, I'm worried that he's gonna be COMPLETELY tasteless - just look at those boring shorts!"
2891,3438,1,21,84,106,1.2169811320754718,0.04240038689480044,666,This one is playing hard to get.
5179,3438,2,19,85,106,1.2169811320754718,0.04446894790914134,666,If I keep this up Netflix will make a documentary about me
5208,3438,3,17,86,106,1.2169811320754718,0.04644547176488884,666,"He is supposed to be yelling, ""Come on in!"""
5226,3438,0,23,83,106,1.2169811320754718,0.04022559246936711,666,"I don't know,I'm just not hungry."
5262,3438,5,13,88,106,1.2169811320754718,0.05016543517300939,666,"Fins don't cut it anymore, but social anxiety still keeps people far away"
5266,3438,4,15,87,106,1.2169811320754718,0.04834124912308584,666,Please don't tell me I've got a monkey on my back!
5275,3438,3,17,86,106,1.2169811320754718,0.04644547176488884,666,Want to make a wish?
5277,3438,3,17,86,106,1.2169811320754718,0.04644547176488884,666,It’s a collectable decoy.
5107,3438,3,17,86,106,1.2169811320754718,0.04644547176488884,666,"I'll flip you  ...er, him... to see who gets the top half."
2863,3438,4,15,87,106,1.2169811320754718,0.04834124912308584,666,"Get him off my back!



I brought you lunch"
3618,3438,4,15,87,106,1.2169811320754718,0.04834124912308584,666,Hors d’oeuvres are on me!
2703,3438,4,15,87,106,1.2169811320754718,0.04834124912308584,666,keeping him around for a midnight snack....
845,3438,4,15,87,106,1.2169811320754718,0.04834124912308584,666,"This is my camo hat— I wear it and people think it’s okay to swim out here. When somebody gets close enough, WAM, I read them my list of ways I would improve the last season of Game of Thrones by adding light elements of steampunk."
849,3438,4,15,87,106,1.2169811320754718,0.04834124912308584,666,"He thinks I'm his surf-board. You've had this problem before, what did you do?"
861,3438,4,15,87,106,1.2169811320754718,0.04834124912308584,666,Pithy witticism.
914,3438,3,17,86,106,1.2169811320754718,0.04644547176488884,666,I'm with Uber Eats.
986,3438,2,19,85,106,1.2169811320754718,0.04446894790914134,666,Every now and then I like takeout...
994,3438,3,17,86,106,1.2169811320754718,0.04644547176488884,666,Extreme sports just aren’t what they used to be....
1003,3438,3,17,86,106,1.2169811320754718,0.04644547176488884,666,Well I win with the last man standing!
1083,3438,4,15,87,106,1.2169811320754718,0.04834124912308584,666,We made a deal.
1100,3438,1,21,84,106,1.2169811320754718,0.04240038689480044,666,"If you know a better way to get these kinks out, I'd like to hear it."
1160,3438,4,15,87,106,1.2169811320754718,0.04834124912308584,666,You have to build their trust before consuming their life.
1220,3438,5,13,88,106,1.2169811320754718,0.05016543517300939,666,"All he said was ""SUP."" Care to join me?"
1221,3438,2,19,85,106,1.2169811320754718,0.04446894790914134,666,He's got chicken legs. I'll wait for the next one.
1293,3438,2,19,85,106,1.2169811320754718,0.04446894790914134,666,"We just can't eat them all, can we?"
1334,3438,3,17,86,106,1.2169811320754718,0.04644547176488884,666,"He calls it body surfing, but when he falls off I call it lunch."
1342,3438,2,19,85,106,1.2169811320754718,0.04446894790914134,666,"Leave him alone.  I need a good back rub

Sidney Delson
East Hampton, NY"
1351,3438,2,19,85,106,1.2169811320754718,0.04446894790914134,666,I'm trying to go vegan.
1382,3438,4,15,87,106,1.2169811320754718,0.04834124912308584,666,And I thought it was embarrasing when they were wearing crocs...
782,3438,0,23,83,106,1.2169811320754718,0.04022559246936711,666,"He's standing on the shoulders of Greatness."""
780,3438,5,13,88,106,1.2169811320754718,0.05016543517300939,666,Sharks love Uber Eats
716,3438,3,17,86,106,1.2169811320754718,0.04644547176488884,666,Do I look like a dolphin to you?
712,3438,4,15,87,106,1.2169811320754718,0.04834124912308584,666,Ooh!  He has pointy toes!
2810,3438,4,15,87,106,1.2169811320754718,0.04834124912308584,666,What?! Everybody's wearing one!
104,3438,2,19,85,106,1.2169811320754718,0.04446894790914134,666,"I'm supposed to swallow him in the next scene but, to be honest, I don't have the stomach for it."
123,3438,4,15,87,106,1.2169811320754718,0.04834124912308584,666,"On the surface, it can be fairly unnoticeable, ..."
142,3438,3,17,86,106,1.2169811320754718,0.04644547176488884,666,He smells of pizza. I can’t handle Italian anymore!
164,3438,4,15,87,106,1.2169811320754718,0.04834124912308584,666,"Just my luck, another lawyer."
192,3438,5,13,88,106,1.2169811320754718,0.05016543517300939,666,I don't like this. It seems TOO easy.
221,3438,4,15,87,106,1.2169811320754718,0.04834124912308584,666,That was some party last night.
267,3438,4,15,87,106,1.2169811320754718,0.04834124912308584,666,I’m a cuck.
1394,3438,3,17,86,106,1.2169811320754718,0.04644547176488884,666,I'll flip you for it.
338,3438,3,17,86,106,1.2169811320754718,0.04644547176488884,666,They're texting.
429,3438,3,17,86,106,1.2169811320754718,0.04644547176488884,666,"I don’t think he knows, but the massage feels great!"
522,3438,5,13,88,106,1.2169811320754718,0.05016543517300939,666,Just trying to keep his head above water.
591,3438,4,15,87,106,1.2169811320754718,0.04834124912308584,666,"Well, it looks like they need to re-release Jaws for a new generation."
605,3438,3,17,86,106,1.2169811320754718,0.04644547176488884,666,Cuban's giving him a thrashing up there.
606,3438,2,19,85,106,1.2169811320754718,0.04446894790914134,666,My dad thinks it’s hilarious when he puts food on my head.
640,3438,3,17,86,106,1.2169811320754718,0.04644547176488884,666,"No, I'm not going to eat him. I swim for Uber now."
676,3438,3,17,86,106,1.2169811320754718,0.04644547176488884,666,Now for his killer dismount.
710,3438,1,21,84,106,1.2169811320754718,0.04240038689480044,666,"He's outside of my HMO,  but what he does for dorsal pain is worth it's weight in seal."
373,3438,2,19,85,106,1.2169811320754718,0.04446894790914134,666,Rock-paper-scissors?
1418,3438,3,17,86,106,1.2169811320754718,0.04644547176488884,666,I’m hoping to attract one with a bit more meat on it.
176,3438,5,13,88,106,1.2169811320754718,0.05016543517300939,666,I'm not doing anything until I hear that  Double Bassoon
2607,3438,2,19,85,106,1.2169811320754718,0.04446894790914134,666,He’s way more alarming to swimmers than my dorsal fin.
2171,3438,5,13,88,106,1.2169811320754718,0.05016543517300939,666,It was your turn to swim the human.
2177,3438,4,15,87,106,1.2169811320754718,0.04834124912308584,666,I work for Scuber on the side.
2182,3438,3,17,86,106,1.2169811320754718,0.04644547176488884,666,"Is this what they call ""Surf and Turf""?"
2240,3438,2,19,85,106,1.2169811320754718,0.04446894790914134,666,They were out of to-go containers.
2261,3438,3,17,86,106,1.2169811320754718,0.04644547176488884,666,I know you think I am spineless
2296,3438,4,15,87,106,1.2169811320754718,0.04834124912308584,666,Who's not in the mood for some beach park skin soup?
1479,3438,1,21,84,106,1.2169811320754718,0.04240038689480044,666,"Don't touch him, he's Swedish."
2115,3438,4,15,87,106,1.2169811320754718,0.04834124912308584,666,He thinks I’m giving him a ride home...
2363,3438,5,13,88,106,1.2169811320754718,0.05016543517300939,666,What?! He had a great muffin top!
2382,3438,2,19,85,106,1.2169811320754718,0.04446894790914134,666,"I read that carrying the weight of an average human during my swim helps weight loss, but I can't resist eating those toes."
2447,3438,2,19,85,106,1.2169811320754718,0.04446894790914134,666,He's great bait.
2449,3438,2,19,85,106,1.2169811320754718,0.04446894790914134,666,On a magic shark-pet ride
2463,3438,2,19,85,106,1.2169811320754718,0.04446894790914134,666,Does this mean we've been domesticated?
2466,3438,1,21,84,106,1.2169811320754718,0.04240038689480044,666,They really are unappetizing
2600,3438,3,17,86,106,1.2169811320754718,0.04644547176488884,666,"...and then I just swim away, the '""sandbar"" collapses, and you lunge!"
2659,3438,5,13,88,106,1.2169811320754718,0.05016543517300939,666,Maybe we should at least wait until his insurance kicks in?
2369,3438,2,19,85,106,1.2169811320754718,0.04446894790914134,666,Do you think it bites?
1995,3438,5,13,88,106,1.2169811320754718,0.05016543517300939,666,"Quick, he thinks it's a sand bar."
2681,3438,2,19,85,106,1.2169811320754718,0.04446894790914134,666,"When the wife feels it ok to come in, we eat them both"
1550,3438,4,15,87,106,1.2169811320754718,0.04834124912308584,666,Its Not pot luck?
1535,3438,3,17,86,106,1.2169811320754718,0.04644547176488884,666,"sooo not impressed with the swimming with humans at the resort, it's not the life changer I was expecting."
1950,3438,5,13,88,106,1.2169811320754718,0.05016543517300939,666,"Fuggedaboutit, I saw him first."
1588,3438,2,19,85,106,1.2169811320754718,0.04446894790914134,666,"He's too dumb to eat, probably be bitter."
1637,3438,3,17,86,106,1.2169811320754718,0.04644547176488884,666,What a day for my remora to take the day off.
1703,3438,4,15,87,106,1.2169811320754718,0.04834124912308584,666,"If I do not get a good massage, I just eat him."
1724,3438,1,21,84,106,1.2169811320754718,0.04240038689480044,666,His profile said that he was a shark in the boardroom.
1726,3438,5,13,88,106,1.2169811320754718,0.05016543517300939,666,He's trying to start a new sport called shark-surfing.  Let's just say the jury's still out.
1688,3438,4,15,87,106,1.2169811320754718,0.04834124912308584,666,"It's called professional courtesy, that's  Jeopardy champ James Holzhauer"
1765,3438,5,13,88,106,1.2169811320754718,0.05016543517300939,666,"I would, but it actually feels kinda nice"
1876,3438,4,15,87,106,1.2169811320754718,0.04834124912308584,666,Do you want to tell; or should I?
1847,3438,5,13,88,106,1.2169811320754718,0.05016543517300939,666,He thinks he's the scorpion...
1728,3438,4,15,87,106,1.2169811320754718,0.04834124912308584,666,He scratches my back...or I eat his
1827,3438,2,19,85,106,1.2169811320754718,0.04446894790914134,666,HEADS UP !
1486,3438,2,19,85,106,1.2169811320754718,0.04446894790914134,666,One of us. He's a loan shark.
1774,3438,2,19,85,106,1.2169811320754718,0.04446894790914134,666,Isn't he supposed to jump the shark?
4035,3624,5,12,86,103,1.2135922330097086,0.05097653916825528,666,That explains it. I was wondering where the other half had gotten to.
52,3624,3,16,84,103,1.2135922330097086,0.0470942961235598,666,I feed him minnows;  he keeps an eye out for shark fishermen.
4132,3624,6,10,87,103,1.2135922330097086,0.05281074658317402,666,I'm just pulling his leg.
4250,3624,3,16,84,103,1.2135922330097086,0.0470942961235598,666,Millennials.
3953,3624,3,16,84,103,1.2135922330097086,0.0470942961235598,666,It's the Surf 'n' Turf special.
3701,3624,2,18,83,103,1.2135922330097086,0.045027828265129306,666,I just can’t wrap my head around this!
4598,3624,2,18,83,103,1.2135922330097086,0.045027828265129306,666,"I know, I know. But the price was surging, I had to take the fare."
3470,3624,2,18,83,103,1.2135922330097086,0.045027828265129306,666,Listen...I’ve been getting cold feet...”
21,3624,3,16,84,103,1.2135922330097086,0.0470942961235598,666,We’re gonna’ need smaller people.
4098,3624,4,14,85,103,1.2135922330097086,0.0490738233325375,666,"I mean, standing on water won't make them think too much of him, right?"
4003,3624,0,22,81,103,1.2135922330097086,0.04058042015646035,666,What’s your problem? I was feeling magnanimous.
2456,3624,5,12,86,103,1.2135922330097086,0.05097653916825528,666,"I,ve got gas."
720,3624,5,12,86,103,1.2135922330097086,0.05097653916825528,666,I know what you’re thinking.
824,3624,2,18,83,103,1.2135922330097086,0.045027828265129306,666,Can you believe I paid 100$ for this?
1058,3624,3,16,84,103,1.2135922330097086,0.0470942961235598,666,Can you imagine the expression on his face when he looks down and sees me?
1065,3624,2,18,83,103,1.2135922330097086,0.045027828265129306,666,Could be better than chicken fingers!
1408,3624,2,18,83,103,1.2135922330097086,0.045027828265129306,666,And this was all she left me....
1789,3624,3,16,84,103,1.2135922330097086,0.0470942961235598,666,Hammerhead? Pashaw!                                                                                                I've got an entire card-carrying union carpenter!
2246,3624,4,14,85,103,1.2135922330097086,0.0490738233325375,666,"This is not a midlife crisis, it's a lifestyle."
2565,3624,3,16,84,103,1.2135922330097086,0.0470942961235598,666,"You've heard of goat yoga?  Well, this is as close as I could get."
2360,3624,2,18,83,103,1.2135922330097086,0.045027828265129306,666,It’s just in case I feel like a snack.
2458,3624,4,14,85,103,1.2135922330097086,0.0490738233325375,666,Technically it's cartilage
578,3624,2,18,83,103,1.2135922330097086,0.045027828265129306,666,"Because being his maritime support animal pays in chum, chum."
3261,3624,2,18,83,103,1.2135922330097086,0.045027828265129306,666,"I know, right?  Fear-induced immobility was supposed to be our thing."
3013,3624,2,18,83,103,1.2135922330097086,0.045027828265129306,666,"It’s my lunch, I’ll eat it at noon."
4758,3624,2,18,83,103,1.2135922330097086,0.045027828265129306,666,"If this idiot doesn’t get off me soon, his nickname will soon be “stumpy.”"
6284,3624,2,18,83,103,1.2135922330097086,0.045027828265129306,666,I knew those shark tracking apps would lead to no good!
6268,3624,3,16,84,103,1.2135922330097086,0.0470942961235598,666,"No thanks, you go ahead. I’ll be eating in tonight."
6085,3624,2,18,83,103,1.2135922330097086,0.045027828265129306,666,"Yep, well, many a truth is told in jest."
2772,3624,4,14,85,103,1.2135922330097086,0.0490738233325375,666,Get it off! Get it off! It's so disgusting...any moment it's gonna drop plastic trash on me.
4645,3624,3,16,84,103,1.2135922330097086,0.0470942961235598,666,I thought our PR could use a boost.
5826,3624,2,18,83,103,1.2135922330097086,0.045027828265129306,666,Just another example of 'the man' keepin' us down
6035,3624,6,10,87,103,1.2135922330097086,0.05281074658317402,666,It’s supposed to help with the cravings.
4813,3624,1,20,82,103,1.2135922330097086,0.0428618467774595,666,I'm depressed
5279,3624,3,16,84,103,1.2135922330097086,0.0470942961235598,666,It makes me more aquadynamic.
5247,3624,3,16,84,103,1.2135922330097086,0.0470942961235598,666,The moron thinks he's standing on the bottom.
5079,3624,2,18,83,103,1.2135922330097086,0.045027828265129306,666,"Next time, let me know when you're coming for dinner"
5369,3624,4,14,85,103,1.2135922330097086,0.0490738233325375,666,These mandatory lunch breaks are killing me.
1005,3662,3,10,62,75,1.2133333333333334,0.057870104103491554,666,Grubhub.
3210,3663,3,18,92,113,1.2123893805309736,0.044358269149919076,666,Court orders ...!
4549,3664,3,22,107,132,1.2121212121212122,0.040283380633923935,666,"When it's my turn, I'll have him stick his head in my mouth."
6101,3665,0,22,82,104,1.2115384615384615,0.040240773027713866,666,"So much for biomimicry, he knows there is nothing like the real thing."
6046,3665,1,20,83,104,1.2115384615384615,0.042497368286213824,666,Have you ever lost your appetite for no good reason?
1271,3665,1,20,83,104,1.2115384615384615,0.042497368286213824,666,What are you doing after dinner?
1621,3665,2,18,84,104,1.2115384615384615,0.04464003593905589,666,"I'm not sure why I keep him. He does like sardines, though."
4446,3665,0,22,82,104,1.2115384615384615,0.040240773027713866,666,He pays me scale.
4877,3670,2,22,99,123,1.2113821138211383,0.04040979034319688,666,"Yeah, I can’t stand Shark Week either, Fred."
32,3671,4,14,87,105,1.2095238095238094,0.04821965555951266,666,This court dismisses pulling a rabbit out of a hat as evidence
5752,3672,4,16,95,115,1.208695652173913,0.045374368134300666,666,Call me Primitive!  I don't need a table and napkins for dinner.
4700,3672,4,16,95,115,1.208695652173913,0.045374368134300666,666,Personal Injury clients are always asking for support.
4409,3672,3,18,94,115,1.208695652173913,0.043660943442513006,666,It's the reboot--he's too old now to actually make it over me.
4010,3675,4,13,84,101,1.2079207920792079,0.04938599569639575,666,Diets suck.
4022,3675,3,15,83,101,1.2079207920792079,0.04733874490250266,666,I thought global sea level rise would be a good thing.
4028,3675,2,17,82,101,1.2079207920792079,0.04519886023965674,666,Dark meat is juicer.
2741,3675,3,15,83,101,1.2079207920792079,0.04733874490250266,666,"You know we can't stop to chat.  My Uber rating is already down to a 4.7.  Also, I'm pretty sure we'd die."
3440,3675,3,15,83,101,1.2079207920792079,0.04733874490250266,666,It’s all the rage....he’s a chum
3960,3675,2,17,82,101,1.2079207920792079,0.04519886023965674,666,It's hard to get a day's work done with a monkey on your back.
2686,3675,2,17,82,101,1.2079207920792079,0.04519886023965674,666,Sometimes it's not easy to keep my food fresh.
2849,3675,2,17,82,101,1.2079207920792079,0.04519886023965674,666,Listen doc I just want this *thing* off my *back*
2645,3675,4,13,84,101,1.2079207920792079,0.04938599569639575,666,I saved the drumsticks for you.
2587,3675,2,17,82,101,1.2079207920792079,0.04519886023965674,666,"I signed up for ""Swimming With the Humans"" but I think he signed up for something too."
2576,3675,3,15,83,101,1.2079207920792079,0.04733874490250266,666,Last week I mistook his surf board for meal. I guess now it's his turn.
2857,3675,3,15,83,101,1.2079207920792079,0.04733874490250266,666,This one tips in sardines
2882,3675,5,11,85,101,1.2079207920792079,0.05135169298966313,666,"Oh that's John, he thinks he's a remora."
2890,3675,3,15,83,101,1.2079207920792079,0.04733874490250266,666,Me neither. I don't understand fashion at all.
2572,3675,4,13,84,101,1.2079207920792079,0.04938599569639575,666,He really gives a great foot massage.
4033,3675,2,17,82,101,1.2079207920792079,0.04519886023965674,666,"He told me this would be good for my root chakra, but I think I'd rather just eat him."
2984,3675,2,17,82,101,1.2079207920792079,0.04519886023965674,666,The orcas have given up. It's our time to shine!
2521,3675,2,17,82,101,1.2079207920792079,0.04519886023965674,666,I got community service for eating his surfboard.
3053,3675,4,13,84,101,1.2079207920792079,0.04938599569639575,666,I'm going back to remoras as soon as his contract is up.
3071,3675,4,13,84,101,1.2079207920792079,0.04938599569639575,666,I took it home because waist not want not.
3089,3675,2,17,82,101,1.2079207920792079,0.04519886023965674,666,It mostly helps with spine alignment.
3158,3675,3,15,83,101,1.2079207920792079,0.04733874490250266,666,I told you to pack your own lunch
3179,3675,0,21,80,101,1.2079207920792079,0.040581983231523164,666,It's like he's baiting me into acting like a shark.
3935,3675,3,15,83,101,1.2079207920792079,0.04733874490250266,666,Which of us will litigate this?
3869,3675,4,13,84,101,1.2079207920792079,0.04938599569639575,666,"Go On.   Just say ""Polo""..."
3849,3675,4,13,84,101,1.2079207920792079,0.04938599569639575,666,It's desperate attempt to repair our public image
3839,3675,2,17,82,101,1.2079207920792079,0.04519886023965674,666,Where are the plates?
3825,3675,3,15,83,101,1.2079207920792079,0.04733874490250266,666,Baby shark do do do do do do
3731,3675,3,15,83,101,1.2079207920792079,0.04733874490250266,666,"I think this stand up paddleboard craze has gone too far, don't you agree?"
3971,3675,2,17,82,101,1.2079207920792079,0.04519886023965674,666,He wants us to help demonstrate his new shark repellant on Shark Tank.
3575,3675,4,13,84,101,1.2079207920792079,0.04938599569639575,666,My wife said it was pot luck.
3502,3675,4,13,84,101,1.2079207920792079,0.04938599569639575,666,I can’t decide whether to eat him or just enjoy the massage.
3479,3675,1,19,81,101,1.2079207920792079,0.04295249893759181,666,"What, never seen a shark getting a foot massage?"
3439,3675,2,17,82,101,1.2079207920792079,0.04519886023965674,666,"Well you know what they say, “If you can’t eat ‘em adjoin ‘em”."
3282,3675,3,15,83,101,1.2079207920792079,0.04733874490250266,666,I happen to like the mixture of wet and dry meat.
3220,3675,1,19,81,101,1.2079207920792079,0.04295249893759181,666,"Apparently, more environmentally friendly than speed boats"
3199,3675,2,17,82,101,1.2079207920792079,0.04519886023965674,666,I'm baiting him for a larger one.
3530,3675,2,17,82,101,1.2079207920792079,0.04519886023965674,666,"When he falls off, I'll gobble him up."
4062,3675,3,15,83,101,1.2079207920792079,0.04733874490250266,666,He is lucky I don’t like the taste of humans.
5903,3675,2,17,82,101,1.2079207920792079,0.04519886023965674,666,I'm starting an Uber Water Taxi Service.
4169,3675,2,17,82,101,1.2079207920792079,0.04519886023965674,666,It was a bad itch.
6088,3675,6,9,86,101,1.2079207920792079,0.05324486993959902,666,"Dinner winner, I called tails."
4661,3675,2,17,82,101,1.2079207920792079,0.04519886023965674,666,I can't get rid of this monkey.
6127,3675,2,17,82,101,1.2079207920792079,0.04519886023965674,666,"Yeah, I like the aquatic stuff but these ashiatsu massages are wonderful!"
5403,3675,5,11,85,101,1.2079207920792079,0.05135169298966313,666,I saved you the drumsticks.
4668,3675,1,19,81,101,1.2079207920792079,0.04295249893759181,666,Do you want to take this one?
5401,3675,2,17,82,101,1.2079207920792079,0.04519886023965674,666,"I brought my half, where's yours?"
5393,3675,6,9,86,101,1.2079207920792079,0.05324486993959902,666,Improves the freshness and gets the blood pumping.
6086,3675,2,17,82,101,1.2079207920792079,0.04519886023965674,666,He’s all yours after my back rub.
5315,3675,6,9,86,101,1.2079207920792079,0.05324486993959902,666,We can do lunch after my back massage
5242,3675,5,11,85,101,1.2079207920792079,0.05135169298966313,666,"He told me that since I prefer dark meat, he needed to get some sun!"
4726,3675,3,15,83,101,1.2079207920792079,0.04733874490250266,666,Would you mind doing me a little favor?
4759,3675,1,19,81,101,1.2079207920792079,0.04295249893759181,666,The least he could do is cut his toenails.
5120,3675,2,17,82,101,1.2079207920792079,0.04519886023965674,666,NO!! You cannot have lunch with him after he finishes my back massage!
4867,3675,4,13,84,101,1.2079207920792079,0.04938599569639575,666,It's Uber's new service...finsharing.
4994,3675,2,17,82,101,1.2079207920792079,0.04519886023965674,666,Please say you will stay for dinner.
4963,3675,4,13,84,101,1.2079207920792079,0.04938599569639575,666,"First it was just incessant singing, now a movie adaptation? I don’t know, Mama Shark... what should we doot-do-do-doot-doot-do-do-do...?"
4691,3675,1,19,81,101,1.2079207920792079,0.04295249893759181,666,There I was couch-surfing...now I can't get rid of him!
6009,3675,5,11,85,101,1.2079207920792079,0.05135169298966313,666,My lawyer is a real shark and he going to eat you alive in this divorce!
5974,3675,4,13,84,101,1.2079207920792079,0.04938599569639575,666,"Don’t worry, I’ve got dinner handled.”
Darilyn Bennett, Salem, Orego"
5914,3675,5,11,85,101,1.2079207920792079,0.05135169298966313,666,What’s really annoying is he keeps calling me ‘Mac.’
4234,3675,2,17,82,101,1.2079207920792079,0.04519886023965674,666,We have a working relationship.  He rubs my back.  I clean his feet.
4256,3675,2,17,82,101,1.2079207920792079,0.04519886023965674,666,Foot massage before dinner.
4288,3675,4,13,84,101,1.2079207920792079,0.04938599569639575,666,I miss when they'd just jump us for attention.
4375,3675,0,21,80,101,1.2079207920792079,0.040581983231523164,666,"Yeh, I know it looks weird.  But he asked nicely and, you know, I couldn't say no.  Anyway, if he is going to be some sort of Grand Poobah he will have to learn how to swim with us."
4390,3675,3,15,83,101,1.2079207920792079,0.04733874490250266,666,I/m saving him for lunch.
5644,3675,3,15,83,101,1.2079207920792079,0.04733874490250266,666,"""He's only helping me with my back pain, Karen."""
5618,3675,4,13,84,101,1.2079207920792079,0.04938599569639575,666,"Just remember, these free rides pay for the groceries."
2424,3675,3,15,83,101,1.2079207920792079,0.04733874490250266,666,Three is a crowd.
5599,3675,4,13,84,101,1.2079207920792079,0.04938599569639575,666,Quick ... before Secret Service shows up !
5652,3675,3,15,83,101,1.2079207920792079,0.04733874490250266,666,I brought a dish to pass.
5660,3675,3,15,83,101,1.2079207920792079,0.04733874490250266,666,Let's flip for it.
5751,3675,3,15,83,101,1.2079207920792079,0.04733874490250266,666,"I'm saving this half of my lunch for later."""
4528,3675,3,15,83,101,1.2079207920792079,0.04733874490250266,666,Moonlighting for Uber. Why do you ask?
5789,3675,3,15,83,101,1.2079207920792079,0.04733874490250266,666,It's a gig ocean.
5825,3675,4,13,84,101,1.2079207920792079,0.04938599569639575,666,Don't say it! I've got a monkey on my back.
4554,3675,5,11,85,101,1.2079207920792079,0.05135169298966313,666,God I wish I was a piranha!
4648,3675,5,11,85,101,1.2079207920792079,0.05135169298966313,666,just helping change the bad PR from Jaws #6.
4131,3675,4,13,84,101,1.2079207920792079,0.04938599569639575,666,"Let's talk about table manners, The lower part in water is mine and the upper one is yours!"
2368,3675,4,13,84,101,1.2079207920792079,0.04938599569639575,666,"Would you believe, this is harder than it looks!"
6298,3675,1,19,81,101,1.2079207920792079,0.04295249893759181,666,"Gillbert: He keeps singing ""Baby shark, doo doo doo doo"" every time I pass by. 
Jawshua: Humans - think they own ""everything!"""
2310,3675,1,19,81,101,1.2079207920792079,0.04295249893759181,666,They're the only parts I'm really interested in.
1303,3675,2,17,82,101,1.2079207920792079,0.04519886023965674,666,Sorry but I don't like raw fishermen...
1231,3675,3,15,83,101,1.2079207920792079,0.04733874490250266,666,"He's MY lunch...he just doesn't know it yet...first, I have to work up an appetite first by treading water in place for 10 minutes while he plays to the crowd on the beach."
1137,3675,2,17,82,101,1.2079207920792079,0.04519886023965674,666,Good morning. Old chum.
943,3675,2,17,82,101,1.2079207920792079,0.04519886023965674,666,I was told around here it’s not illegal to use live bait
898,3675,3,15,83,101,1.2079207920792079,0.04733874490250266,666,It must be tourist season again...
878,3675,2,17,82,101,1.2079207920792079,0.04519886023965674,666,Third time this month I've been mistaken for a surfboard.
828,3675,1,19,81,101,1.2079207920792079,0.04295249893759181,666,"Picked up surfing as a hobby, but it's more of a headache than you realize"
750,3675,6,9,86,101,1.2079207920792079,0.05324486993959902,666,You ever tried bait?
713,3675,5,11,85,101,1.2079207920792079,0.05135169298966313,666,"Wait. I thought you said ""Beto"" diet."
600,3675,3,15,83,101,1.2079207920792079,0.04733874490250266,666,I don't think this guy's keto diet is working out too well.
490,3675,3,15,83,101,1.2079207920792079,0.04733874490250266,666,"Bruce, remember: humans are friends, not food."
469,3675,2,17,82,101,1.2079207920792079,0.04519886023965674,666,"I know, I know...."
443,3675,2,17,82,101,1.2079207920792079,0.04519886023965674,666,Like to come to dunner tonight?
425,3675,4,13,84,101,1.2079207920792079,0.04938599569639575,666,The millennials needed a new trend after self-driving cars.
250,3675,3,15,83,101,1.2079207920792079,0.04733874490250266,666,"I felt bad for the kid, Jerry. Prom weekend and he couldn't afford a limo."
235,3675,3,15,83,101,1.2079207920792079,0.04733874490250266,666,It's called ashiatsu massage and all the sharks are doing it.
165,3675,4,13,84,101,1.2079207920792079,0.04938599569639575,666,Another “Shark Tank” loser!
102,3675,5,11,85,101,1.2079207920792079,0.05135169298966313,666,And then they wonder why.
77,3675,1,19,81,101,1.2079207920792079,0.04295249893759181,666,"You want to be the one to break the news, or should I?"
1304,3675,2,17,82,101,1.2079207920792079,0.04519886023965674,666,My therapist says this is good for me.
1430,3675,4,13,84,101,1.2079207920792079,0.04938599569639575,666,We wait till they Q the music.
556,3675,1,19,81,101,1.2079207920792079,0.04295249893759181,666,It's mutualism.
1468,3675,3,15,83,101,1.2079207920792079,0.04733874490250266,666,I feel so violated.
1446,3675,4,13,84,101,1.2079207920792079,0.04938599569639575,666,Can you tell I already ate the top half?
2228,3675,2,17,82,101,1.2079207920792079,0.04519886023965674,666,"I thought I was tough but lately, I've been letting people walk all over me"
2156,3675,2,17,82,101,1.2079207920792079,0.04519886023965674,666,You ever have one of these?
2142,3675,3,15,83,101,1.2079207920792079,0.04733874490250266,666,"I don't know, Bob...I fear that I've lost my edge."
2130,3675,4,13,84,101,1.2079207920792079,0.04938599569639575,666,This chum is getting too chummy.
2067,3675,0,21,80,101,1.2079207920792079,0.040581983231523164,666,His hepatitis screen is pending.
2033,3675,6,9,86,101,1.2079207920792079,0.05324486993959902,666,What can he be thinking?
2023,3675,2,17,82,101,1.2079207920792079,0.04519886023965674,666,I always like to bring a snack along.
2008,3675,4,13,84,101,1.2079207920792079,0.04938599569639575,666,"Even the tourists found out Martha's got me on the kelp. I've been giving dorsal fin rides like I'm some kind of dolphin, all month."
1906,3675,1,19,81,101,1.2079207920792079,0.04295249893759181,666,"This economy, am I right?"
1982,3675,3,15,83,101,1.2079207920792079,0.04733874490250266,666,"This time, forget about the deep-fried wings and keep it simple. The left leg is yours and the right is mine."
1791,3675,3,15,83,101,1.2079207920792079,0.04733874490250266,666,I regret taking my food to go
2320,3675,2,17,82,101,1.2079207920792079,0.04519886023965674,666,I'm starting to think it's political.
1742,3675,4,13,84,101,1.2079207920792079,0.04938599569639575,666,I save the drumsticks till last.
1683,3675,2,17,82,101,1.2079207920792079,0.04519886023965674,666,He thinks he's playing Jump the Shark. I hope he tastes better than the last one.
1641,3675,5,11,85,101,1.2079207920792079,0.05135169298966313,666,He promised me a job.
1547,3675,5,11,85,101,1.2079207920792079,0.05135169298966313,666,He thinks he's on a reef.
1792,3675,3,15,83,101,1.2079207920792079,0.04733874490250266,666,I have your order for delivery...
2523,3798,4,14,88,106,1.2075471698113207,0.04780347070761396,666,You can have the rest. I lost my appetite when I got to the shorts.
5638,3798,4,14,88,106,1.2075471698113207,0.04780347070761396,666,"Back off, I've been carrying this appetizer for 10 minutes."
2231,3798,4,14,88,106,1.2075471698113207,0.04780347070761396,666,"Hon, do you mind having leftovers tonight?"
348,3798,2,18,86,106,1.2075471698113207,0.04388374155720299,666,"I wouldn’t want to be in Chief Brody’s shoes, it’s the Kintner boy."
3162,3798,3,16,87,106,1.2075471698113207,0.04588548019119496,666,I told you that if you fed them they
6068,3798,4,14,88,106,1.2075471698113207,0.04780347070761396,666,I myself prefer the tail!
5908,3798,2,18,86,106,1.2075471698113207,0.04388374155720299,666,"This guy is so stupid, I could eat him standing on my head"
3533,3805,4,9,69,82,1.2073170731707317,0.05686215517169996,666,I know he's not the star he use to be but ya gotta admit Swimming with Sharks II is real timely annnd he got Harvey to green light it!!!!!
3867,3806,3,17,91,111,1.2072072072072073,0.04455093454204471,666,They taste better when they're healthy.
6121,3806,4,15,92,111,1.2072072072072073,0.04635284168602521,666,Did you wait 30 minutes before swimming first?
4001,3806,4,15,92,111,1.2072072072072073,0.04635284168602521,666,He's from Finland
1216,3809,4,16,96,116,1.206896551724138,0.04501747350125653,666,I think of him as an attractive nuisance...
3134,3809,5,8,74,87,1.206896551724138,0.05696111457628315,666,"I know I've been getting drunk lately, but I've got a lot on my back so back off, Sue!"
1865,3811,4,19,108,131,1.2061068702290076,0.04157435697855915,666,It's the new ride share called aqualyft.
1892,3812,2,17,83,102,1.2058823529411764,0.04479993988272699,666,"Yeah, it’s hard not to eat him, but it’s great for the cartilage and inner core muscles.”"
3912,3813,2,12,64,78,1.205128205128205,0.05275927638889398,666,"No, I'm not ride-sharing with you."
393,3814,4,18,105,127,1.204724409448819,0.042333188189562124,666,This is the worst back massage I've ever gotten in my life.
3895,3815,4,12,82,98,1.2040816326530612,0.050161077954179,666,This guy thinks he's getting a submarine free ride!!
4259,3815,1,18,79,98,1.2040816326530612,0.043416050423211075,666,Perryscope
3780,3815,6,8,84,98,1.2040816326530612,0.05419336318198782,666,What can you do when you don't have a refrigerator?
3874,3815,1,18,79,98,1.2040816326530612,0.043416050423211075,666,"Zack, is there a human on me for the 100th time this week?"
3730,3815,3,14,81,98,1.2040816326530612,0.048018124763472565,666,"Sure he looks appetizing, but if I eat him Uber won’t process the fare."
3599,3815,2,16,80,98,1.2040816326530612,0.045774958984969194,666,It's supposed to be good for headaches.
3589,3815,3,14,81,98,1.2040816326530612,0.048018124763472565,666,He's my shiatsu therapist.  I picked him up off the coast of Japan.
3882,3815,4,12,82,98,1.2040816326530612,0.050161077954179,666,He’s sure gonna be surprised I’m not a sandbar.
3561,3815,4,12,82,98,1.2040816326530612,0.050161077954179,666,He used his Unter app to hail me.
3559,3815,3,14,81,98,1.2040816326530612,0.048018124763472565,666,Is this a nightmare out of some movie or what?
4183,3815,2,16,80,98,1.2040816326530612,0.045774958984969194,666,My doc tells me that I have a delusional idea that I’m a lamp base.
3934,3815,1,18,79,98,1.2040816326530612,0.043416050423211075,666,Pret a Manger carry out
2660,3815,3,14,81,98,1.2040816326530612,0.048018124763472565,666,Uber for Sharks.
3362,3815,4,12,82,98,1.2040816326530612,0.050161077954179,666,Felt cute. Might eat later.
2541,3815,4,12,82,98,1.2040816326530612,0.050161077954179,666,I'm bringing lunch today
2561,3815,1,18,79,98,1.2040816326530612,0.043416050423211075,666,He's looking for a smaller boat.
2583,3815,3,14,81,98,1.2040816326530612,0.048018124763472565,666,Wishbone!
2584,3815,4,12,82,98,1.2040816326530612,0.050161077954179,666,"If he hurts, I eat him."
4287,3815,2,16,80,98,1.2040816326530612,0.045774958984969194,666,It's Shiatsu.  I'm always sore after a feeding frenzy.
2676,3815,2,16,80,98,1.2040816326530612,0.045774958984969194,666,"Have you felt their skin? It feels so weird, like sandpaper."
2723,3815,2,16,80,98,1.2040816326530612,0.045774958984969194,666,"It's an audition for an allegorical film--""Drowning, Trust, and the U.S. Senate.""  My agent here says I'm right for the part of  Mitch McConnell."""
2785,3815,1,18,79,98,1.2040816326530612,0.043416050423211075,666,it's an actual pilot..
2821,3815,4,12,82,98,1.2040816326530612,0.050161077954179,666,He thinks I’m a sandbar...
2884,3815,3,14,81,98,1.2040816326530612,0.048018124763472565,666,...and his third wish was to put him on Shark Tank.
2948,3815,3,14,81,98,1.2040816326530612,0.048018124763472565,666,"Better hurry, the buffet is about to close."
2965,3815,2,16,80,98,1.2040816326530612,0.045774958984969194,666,"Filling in until a replacement is found... had it BEEN a seal, I wouldn’t be in this predicament!"
2993,3815,1,18,79,98,1.2040816326530612,0.043416050423211075,666,I lost a BAD bet damn it!!
3026,3815,3,14,81,98,1.2040816326530612,0.048018124763472565,666,Get this guy off my back please.
3044,3815,1,18,79,98,1.2040816326530612,0.043416050423211075,666,"I figure if he can strengthen his core like this, he'll eventually taste a lot better."
3055,3815,3,14,81,98,1.2040816326530612,0.048018124763472565,666,It's s nice way to relax before meals.
3067,3815,3,14,81,98,1.2040816326530612,0.048018124763472565,666,If  the second half is anything like the first there’ll be plenty to share”
3092,3815,2,16,80,98,1.2040816326530612,0.045774958984969194,666,Lately I've been feeling like a person out of air
3100,3815,3,14,81,98,1.2040816326530612,0.048018124763472565,666,"I just prefer to have a masseur over a masseuse, Brian."
3409,3815,3,14,81,98,1.2040816326530612,0.048018124763472565,666,I'm transitioning to sole.
4290,3815,4,12,82,98,1.2040816326530612,0.050161077954179,666,Thanks. It's Tom Ford.
5383,3815,3,14,81,98,1.2040816326530612,0.048018124763472565,666,"It tickles, but I'm still gonna eat him."
4391,3815,1,18,79,98,1.2040816326530612,0.043416050423211075,666,"Yeah he's pissing me off, but they already think we're crazy enough."
5404,3815,4,12,82,98,1.2040816326530612,0.050161077954179,666,He keeps me balanced
5479,3815,5,10,83,98,1.2040816326530612,0.05221615820079095,666,"Yeah, this gig can be a pain in the neck, but I make a killing on surge pricing."
5485,3815,3,14,81,98,1.2040816326530612,0.048018124763472565,666,You've already had the other half.
5514,3815,4,12,82,98,1.2040816326530612,0.050161077954179,666,It started as a growth on my dorsal fin.
5551,3815,2,16,80,98,1.2040816326530612,0.045774958984969194,666,I asked for the leading man but got his stand-in.
5695,3815,0,20,78,98,1.2040816326530612,0.040921388033960934,666,Watch closely and learn and I will show you how to toss the salad
5755,3815,3,14,81,98,1.2040816326530612,0.048018124763472565,666,This is just too easy!
5882,3815,3,14,81,98,1.2040816326530612,0.048018124763472565,666,I really don't mind. It keeps me settled.
5964,3815,1,18,79,98,1.2040816326530612,0.043416050423211075,666,"If you ask me, this predator-prey relationship business is a bit overrated."
6111,3815,5,10,83,98,1.2040816326530612,0.05221615820079095,666,And then he said something about law school and professional courtesy.
6159,3815,2,16,80,98,1.2040816326530612,0.045774958984969194,666,Don't ask me to break my agreement with Uber.
6183,3815,3,14,81,98,1.2040816326530612,0.048018124763472565,666,I make extra money as Blubber driver!
6252,3815,2,16,80,98,1.2040816326530612,0.045774958984969194,666,Is there any leftovers left on me?
6265,3815,3,14,81,98,1.2040816326530612,0.048018124763472565,666,"We're shooting ""Man-nado."""
6297,3815,2,16,80,98,1.2040816326530612,0.045774958984969194,666,I swear I always have food on my mind.
5384,3815,3,14,81,98,1.2040816326530612,0.048018124763472565,666,Now what do I do?
4343,3815,4,12,82,98,1.2040816326530612,0.050161077954179,666,"Oh, I know, but where's the challenge?"
2528,3815,3,14,81,98,1.2040816326530612,0.048018124763472565,666,They were out of pilot fish.
5302,3815,4,12,82,98,1.2040816326530612,0.050161077954179,666,"Modern times calls for modern invention, he's my periscope."
4461,3815,3,14,81,98,1.2040816326530612,0.048018124763472565,666,"Like we’re not TAKING jobs from dolphins, we’re just way less entitled workers."
4568,3815,1,18,79,98,1.2040816326530612,0.043416050423211075,666,You eat him. I just don’t have the heart.
4610,3815,3,14,81,98,1.2040816326530612,0.048018124763472565,666,"He gave an amazing pitch for his invention, and I can’t help but support him."
4637,3815,3,14,81,98,1.2040816326530612,0.048018124763472565,666,"I said that if he lures in four others for me, he gets to walk away."
4717,3815,3,14,81,98,1.2040816326530612,0.048018124763472565,666,I hate surfers.
4724,3815,4,12,82,98,1.2040816326530612,0.050161077954179,666,Trust me.  Wait for the helicopter.
4777,3815,5,10,83,98,1.2040816326530612,0.05221615820079095,666,"If I bite him, he'll never give me a 5-star rating for this ride"
4815,3815,4,12,82,98,1.2040816326530612,0.050161077954179,666,I hate it when the Dolphin Encounter gets all booked up.
4854,3815,3,14,81,98,1.2040816326530612,0.048018124763472565,666,I work for Uber.  What about you?
4874,3815,2,16,80,98,1.2040816326530612,0.045774958984969194,666,I picked up a side gig driving for Dryft and Tuber.
4916,3815,2,16,80,98,1.2040816326530612,0.045774958984969194,666,"Let me tell you, kid - Speilberg would never have let this happen."
5000,3815,3,14,81,98,1.2040816326530612,0.048018124763472565,666,Stop teasing me.  I forgot to put my lunch in my locker.
5067,3815,5,10,83,98,1.2040816326530612,0.05221615820079095,666,I don’t care what ‘shark chum’ is supposed to mean; he’s my friend!
5141,3815,2,16,80,98,1.2040816326530612,0.045774958984969194,666,Has he mistaken me for his Stand-up paddleboard?
5196,3815,3,14,81,98,1.2040816326530612,0.048018124763472565,666,I swear the Groupon said couples massage.
5304,3815,4,12,82,98,1.2040816326530612,0.050161077954179,666,"I said:  'Look, Jonah, try a whale--more your size' and he goes:  'Yeah, but I'm allergic to all the plastic crap they now eat.'""        Murray Block, Albany, New Yor"
2520,3815,3,14,81,98,1.2040816326530612,0.048018124763472565,666,"I can't help it, he is a Republican."
1475,3815,3,14,81,98,1.2040816326530612,0.048018124763472565,666,He saved me from being finned. I'm saving him for lunch.
2357,3815,3,14,81,98,1.2040816326530612,0.048018124763472565,666,These new ride share apps are getting out of hand.
1301,3815,2,16,80,98,1.2040816326530612,0.045774958984969194,666,He thinks I'm his surfboard
1184,3815,3,14,81,98,1.2040816326530612,0.048018124763472565,666,I'm supplementing my income by driving for Uber.
1021,3815,2,16,80,98,1.2040816326530612,0.045774958984969194,666,That's the last time I tell anyone I'm a Sand Shark.
777,3815,3,14,81,98,1.2040816326530612,0.048018124763472565,666,It'll be great. They enter our tank to pitch ideas...
774,3815,2,16,80,98,1.2040816326530612,0.045774958984969194,666,I know he treats me like a doormat.
684,3815,3,14,81,98,1.2040816326530612,0.048018124763472565,666,I’m with a hedge fund now -mostly serving as team metaphor and then doing some executive coaching for the guy standing on my back.
664,3815,0,20,78,98,1.2040816326530612,0.040921388033960934,666,"I can't stand these bloody humans, mate!"
571,3815,3,14,81,98,1.2040816326530612,0.048018124763472565,666,It was either this or sharkskin boots.
1442,3815,2,16,80,98,1.2040816326530612,0.045774958984969194,666,His name is Remora - he’s a pain in the ass.
472,3815,2,16,80,98,1.2040816326530612,0.045774958984969194,666,What? You've never heard of decoys?
350,3815,1,18,79,98,1.2040816326530612,0.043416050423211075,666,I ordered carryout.
237,3815,1,18,79,98,1.2040816326530612,0.043416050423211075,666,"Look, you said there are plenty of humans in the sea, and you were right."
215,3815,3,14,81,98,1.2040816326530612,0.048018124763472565,666,All I know is they work at the White House.
195,3815,5,10,83,98,1.2040816326530612,0.05221615820079095,666,"I know we said it is only temporary, but they really are being priced out of the cities."
147,3815,2,16,80,98,1.2040816326530612,0.045774958984969194,666,We can't keep meeting like this. I just can't do it to Stan - he's in such a vulnerable place right now.
53,3815,2,16,80,98,1.2040816326530612,0.045774958984969194,666,So what if you're hungry. How often do we run into a Ashiatsu therapist?
38,3815,2,16,80,98,1.2040816326530612,0.045774958984969194,666,"0kay ‘Bad Shark,’ you’re up."
2506,3815,2,16,80,98,1.2040816326530612,0.045774958984969194,666,"Watch what you sign. I assumed he was going to jump over me, not onto me."
416,3815,3,14,81,98,1.2040816326530612,0.048018124763472565,666,It relieves my stress.
1467,3815,1,18,79,98,1.2040816326530612,0.043416050423211075,666,I actually feel sorry for him.
239,3815,2,16,80,98,1.2040816326530612,0.045774958984969194,666,He told me the lifeguards are yummier.
1551,3815,2,16,80,98,1.2040816326530612,0.045774958984969194,666,You are a killer shark and you are getting stepped on...whose fault do you think it is?
2262,3815,3,14,81,98,1.2040816326530612,0.048018124763472565,666,He paid me three fish so he could look like he's treading water.
2185,3815,4,12,82,98,1.2040816326530612,0.050161077954179,666,tastes better after happy hour
2114,3815,3,14,81,98,1.2040816326530612,0.048018124763472565,666,The goat wasn’t available.
2098,3815,1,18,79,98,1.2040816326530612,0.043416050423211075,666,I'm trying to avoid the bad press.
2347,3815,5,10,83,98,1.2040816326530612,0.05221615820079095,666,"He says his name is ""R. E. Mora""."
2053,3815,2,16,80,98,1.2040816326530612,0.045774958984969194,666,"I admit it, it’s not very well paid, but Uber have been very eager to expand"
2028,3815,2,16,80,98,1.2040816326530612,0.045774958984969194,666,"This deep tissue massage is great at increasing blood flow, relaxing my back muscles, and releasing stress!"
2016,3815,4,12,82,98,1.2040816326530612,0.050161077954179,666,"I admit it's lunch on the hoof, but it's better than brown-bagging it."
1926,3815,1,18,79,98,1.2040816326530612,0.043416050423211075,666,I told you lunch would be on me!
1869,3815,1,18,79,98,1.2040816326530612,0.043416050423211075,666,My rating dropped two stars after I ate my last passenger.
1830,3815,3,14,81,98,1.2040816326530612,0.048018124763472565,666,I didn't expect driving for Uber Ocean to be this humiliating.
1803,3815,3,14,81,98,1.2040816326530612,0.048018124763472565,666,I just don't have the heart to tell him!
1687,3815,5,10,83,98,1.2040816326530612,0.05221615820079095,666,Another delusional human who thinks he can float...as if such thoughts can really expand the mind and body weightlessly.
1652,3815,4,12,82,98,1.2040816326530612,0.050161077954179,666,"We'll eat after he finishes his terrific back massage."""
1639,3815,2,16,80,98,1.2040816326530612,0.045774958984969194,666,Table for one?
1569,3815,2,16,80,98,1.2040816326530612,0.045774958984969194,666,"It's therapy to keep me from constantly moving, moving, moving."
2332,3815,4,12,82,98,1.2040816326530612,0.050161077954179,666,Spielberg said I could audition for the Jaws reboot if I take him to Maui.
2302,3815,4,12,82,98,1.2040816326530612,0.050161077954179,666,I'm vegetarian
2263,3930,4,13,86,103,1.203883495145631,0.04850560089606933,666,I'm hoping this patch will help me quit the habit.
3916,3930,3,15,85,103,1.203883495145631,0.046501891458189094,666,I’m trying that new service “Food to Go” !
3312,3932,2,18,88,108,1.2037037037037037,0.043152147891456286,666,its only  temporary . he  just  broke  up  with  his girl._he'll be  gone  by Tuesday!
3297,3933,6,20,133,159,1.20125786163522,0.038666443836710765,666,It's Hemingway's great grandson.
1328,3934,3,16,91,110,1.2,0.0443656051737758,666,I already ate the top half
5916,3935,4,13,89,106,1.1981132075471699,0.04724163444772896,666,"I just want them scared, and I read humans kill more humans than we do.."
5335,3935,5,11,90,106,1.1981132075471699,0.0491066853351966,666,"Sure, Bob, I’ve had a spate of good luck - that doesn’t make it cheating."
3815,3935,2,17,87,106,1.1981132075471699,0.04327104097035949,666,I’m helping him save gas.
1419,3935,3,15,88,106,1.1981132075471699,0.04529986209665202,666,Well... Hot yoga seemed too invasive
5585,3939,3,14,84,101,1.198019801980198,0.046713370740932486,666,Have you seen the guy on the surfboard?
5991,3939,2,16,83,101,1.198019801980198,0.0445434529869386,666,My therapist says this works for anger management.
1565,3939,3,14,84,101,1.198019801980198,0.046713370740932486,666,First I braise them
5373,3939,5,10,86,101,1.198019801980198,0.05077576794042807,666,"At times, I feel like I have the weight of the world on my shoulders...."
2745,3943,1,17,78,96,1.1979166666666667,0.043477640116023786,666,"At first, it was annoying. But now I find it's good for my posture."
5920,3943,2,15,79,96,1.1979166666666667,0.04593041950246607,666,I decided to pack lunch this week.
4289,3943,3,13,80,96,1.1979166666666667,0.04825869539561291,666,"It was floating around Plastic Island - a throw away from ""Jaws"". I call him 'Bruce'."
4104,3943,2,15,79,96,1.1979166666666667,0.04593041950246607,666,"My therapist says you carry your emotional baggage in your dorsal fin spine. Honestly I thought it was a lot of hoo hah but lately I really feel it. The break up, climate change, my mother, all of it.  Right in that spot. Just like, ugh! Baggage!"
3240,3943,2,15,79,96,1.1979166666666667,0.04593041950246607,666,"Believe me, nothing cures a stiff fin better than a Thai Massage session."
3878,3943,4,11,81,96,1.1979166666666667,0.05047969816570406,666,"No, you can't have a bite. I'd get a terrible Uber Review."
2755,3943,3,13,80,96,1.1979166666666667,0.04825869539561291,666,I really do it for the health insurance.
3767,3943,1,17,78,96,1.1979166666666667,0.043477640116023786,666,"I told him and told him, but he just won't listen."
3734,3943,3,13,80,96,1.1979166666666667,0.04825869539561291,666,Swimming with the dolphins is out.
3681,3943,3,13,80,96,1.1979166666666667,0.04825869539561291,666,This is yet another example of why it's important to read the fine print.
3640,3943,2,15,79,96,1.1979166666666667,0.04593041950246607,666,"He says he needs to ""get his feet wet"" before he tries to ""jump"" the shark. Whatever that means."
3469,3943,1,17,78,96,1.1979166666666667,0.043477640116023786,666,At least I didn't eat my human!
2634,3943,1,17,78,96,1.1979166666666667,0.043477640116023786,666,I’m going topless.
5836,3943,2,15,79,96,1.1979166666666667,0.04593041950246607,666,Humans who make one nasty mouth noise tend to make them all.
3303,3943,4,11,81,96,1.1979166666666667,0.05047969816570406,666,"My new job as a paddleboard is great - I don't have to chase humans, and after six months I qualify for health insurance."
3920,3943,2,15,79,96,1.1979166666666667,0.04593041950246607,666,I like to relax them before I eat them.
3391,3943,3,13,80,96,1.1979166666666667,0.04825869539561291,666,"You've heard of having an albatross around your neck, well, ..."""
5021,3943,4,11,81,96,1.1979166666666667,0.05047969816570406,666,You look different...new haircut?
5643,3943,3,13,80,96,1.1979166666666667,0.04825869539561291,666,This 'Uber of the Seas'  gig is only temporary.
2488,3943,1,17,78,96,1.1979166666666667,0.043477640116023786,666,"But I just turned vegetarian!’
Catherine Burgess
Somerville M"
4711,3943,2,15,79,96,1.1979166666666667,0.04593041950246607,666,"Ten-Toe massage, then dinner."
4761,3943,2,15,79,96,1.1979166666666667,0.04593041950246607,666,You try eating him. I can't.
4914,3943,1,17,78,96,1.1979166666666667,0.043477640116023786,666,You've never tried it?
5017,3943,2,15,79,96,1.1979166666666667,0.04593041950246607,666,"Hey, don't let the man get you down."
5057,3943,0,19,77,96,1.1979166666666667,0.040877951813226225,666,I'm becoming a vegetarian and BTW he gives a good back massage.
5104,3943,2,15,79,96,1.1979166666666667,0.04593041950246607,666,He thinks I'm a stable genus.
5696,3943,1,17,78,96,1.1979166666666667,0.043477640116023786,666,You're ruining Shark Week
5164,3943,3,13,80,96,1.1979166666666667,0.04825869539561291,666,It’s the new gig economy
5478,3943,3,13,80,96,1.1979166666666667,0.04825869539561291,666,"Close, it's called Under"
4459,3943,2,15,79,96,1.1979166666666667,0.04593041950246607,666,I have a foot fetish.
5495,3943,3,13,80,96,1.1979166666666667,0.04825869539561291,666,Uber water rides are my side hustle plus if I get really hungry I can have a snack.
5562,3943,1,17,78,96,1.1979166666666667,0.043477640116023786,666,"It's like a GoPro, but with feet."
5563,3943,2,15,79,96,1.1979166666666667,0.04593041950246607,666,I have to keep moving or else he'll die.
5584,3943,1,17,78,96,1.1979166666666667,0.043477640116023786,666,I've found surfing is a good way to eat people.
5636,3943,5,9,82,96,1.1979166666666667,0.05260701638103629,666,Uber is easy money—just sayin’.
5222,3943,1,17,78,96,1.1979166666666667,0.043477640116023786,666,Frank thought it would be funny if I had to wear it tonight for the bachelor party.
2339,3943,3,13,80,96,1.1979166666666667,0.04825869539561291,666,I’m on a nylon-free diet this summer.
1112,3943,1,17,78,96,1.1979166666666667,0.043477640116023786,666,I was laid off so I’m phoning it in.
1878,3943,2,15,79,96,1.1979166666666667,0.04593041950246607,666,Wait till his check clears.
2223,3943,2,15,79,96,1.1979166666666667,0.04593041950246607,666,These new requirements from Uber and Lyft are getting too much for me
240,3943,1,17,78,96,1.1979166666666667,0.043477640116023786,666,It started out as a patch of eczema!
347,3943,3,13,80,96,1.1979166666666667,0.04825869539561291,666,"There's something gross on my back isn't there? 
C'mon, what is it!? Glen, get it off me!
Please, Glen?"
510,3943,4,11,81,96,1.1979166666666667,0.05047969816570406,666,This Grandpa shark thing has gotten out of control...
747,3943,2,15,79,96,1.1979166666666667,0.04593041950246607,666,I liked them better when they were just paddleboarding
783,3943,3,13,80,96,1.1979166666666667,0.04825869539561291,666,I don’t know how this marriage is going to work if you don’t respect my hobbies.
856,3943,1,17,78,96,1.1979166666666667,0.043477640116023786,666,"It's called ""Ashiatsu""."
821,3943,1,17,78,96,1.1979166666666667,0.043477640116023786,666,"Of the barefoot massage doesn't do any good, I know he'll make good sushi."
1039,3943,3,13,80,96,1.1979166666666667,0.04825869539561291,666,"Sam, would you get this guy off my back!"
1219,3943,2,15,79,96,1.1979166666666667,0.04593041950246607,666,He was a loser on Shark Tank
1252,3943,1,17,78,96,1.1979166666666667,0.043477640116023786,666,He thinks he's being funny.
1579,3943,2,15,79,96,1.1979166666666667,0.04593041950246607,666,Freeloader.....Free Lunch!
1824,3943,3,13,80,96,1.1979166666666667,0.04825869539561291,666,I’ve lost my touch.
1825,3943,2,15,79,96,1.1979166666666667,0.04593041950246607,666,It's the latest - show your dorsal torso above the water line.
966,3943,2,15,79,96,1.1979166666666667,0.04593041950246607,666,Don't judge me. I'm using my discounted massage Groupon.
2092,3997,4,11,82,97,1.1958762886597938,0.04999822861495349,666,He wants a pedicure!
4532,3998,4,9,74,87,1.1954022988505748,0.05382727149237504,666,Do you want the Democratic or the Republican side?
2667,3999,3,15,90,108,1.1944444444444444,0.04453197507374984,666,I asked him to scratch my back.
6056,3999,1,19,88,108,1.1944444444444444,0.04045931624376092,666,"Hey, wanna join the finitching school?"
2411,4001,4,18,112,134,1.1940298507462686,0.040307442576898195,666,"Well, how did YOU think he walked on water, Ezekiel?"
731,4002,1,17,80,98,1.1938775510204083,0.04268044887831027,666,I'm still waiting for a few more surfers for our Spring Frenzy.
8,4002,2,15,81,98,1.1938775510204083,0.0450778676534157,666,"you gotta go see my guy, best shiatsu in the Atlantic"
2383,4004,2,14,77,93,1.1935483870967742,0.04652000056511267,666,Wanna join me and my chum for take out?
2068,4004,2,14,77,93,1.1935483870967742,0.04652000056511267,666,There has to be more to life than eating.
2468,4004,3,12,78,93,1.1935483870967742,0.04896799509143365,666,What some people won’t do to look taller.
2475,4004,3,12,78,93,1.1935483870967742,0.04896799509143365,666,"Off the top of my head, it's about two feet or so."
2484,4004,2,14,77,93,1.1935483870967742,0.04652000056511267,666,"You want me to eat him for you, too?"
2022,4004,1,16,76,93,1.1935483870967742,0.043935820942387044,666,Not much of a symbiotic relationship eh?!
2621,4004,3,12,78,93,1.1935483870967742,0.04896799509143365,666,"Standing on, as opposed to jumping the, implying hopeless idiocy is actually strategic . . .."
2735,4004,1,16,76,93,1.1935483870967742,0.043935820942387044,666,"Don't believe it!  You can't pay the kids' tuition on your Uber pay.
Swim!  Swim far away!"
1883,4004,2,14,77,93,1.1935483870967742,0.04652000056511267,666,"All I've heard the whole way here is ""you gotta wait until you've tried one of Nathan's footlongs"".  Oh, it seems dinner has just arrived.  (Comments overheard at Sharky's Deli, Long Island NY)"
2685,4004,1,16,76,93,1.1935483870967742,0.043935820942387044,666,This is my community service for eating his surfboard.
2112,4004,3,12,78,93,1.1935483870967742,0.04896799509143365,666,Let's just say I understand the average American swimmer.
2930,4004,1,16,76,93,1.1935483870967742,0.043935820942387044,666,I'm getting a crick in my dorsal fin.
4096,4004,3,12,78,93,1.1935483870967742,0.04896799509143365,666,It’s sort of like having a monkey on your back
3427,4004,2,14,77,93,1.1935483870967742,0.04652000056511267,666,He's posting a selfie of him and me.
3437,4004,2,14,77,93,1.1935483870967742,0.04652000056511267,666,"Okay, so what’d a great white do?"
3579,4004,3,12,78,93,1.1935483870967742,0.04896799509143365,666,YOU GO AHEAD.  I JUST ATE A BIG LUNCH
3727,4004,1,16,76,93,1.1935483870967742,0.043935820942387044,666,"He says he won't indict me if he doesn't have a leg to stand on.
Can you help me?"
3829,4004,3,12,78,93,1.1935483870967742,0.04896799509143365,666,This is just getting too easy.
3965,4004,1,16,76,93,1.1935483870967742,0.043935820942387044,666,It’s worth the wait.  If he actually gets a bigger boat we sink it and eat them all.
4021,4004,3,12,78,93,1.1935483870967742,0.04896799509143365,666,"Dude I’m tellin’ ya, if you need a few extra clams, check out UberAqua. This guy ordered a Great UberWHITE so I got a sonar ping. Once I drop him off, I pocket a couple fins. It’s the beginning of a beautiful symbiotic relationship."
1807,4004,0,18,75,93,1.1935483870967742,0.041189832133487855,666,"If I can't make the dramatic approach with my dorsal fin ominously slicing through the water, what's the point?"
4100,4004,2,14,77,93,1.1935483870967742,0.04652000056511267,666,Some people will risk everything for a free ride.
4123,4004,5,8,80,93,1.1935483870967742,0.05352917638697465,666,It's take-out. I didn't want the bag.
4184,4004,1,16,76,93,1.1935483870967742,0.043935820942387044,666,The job pool is pretty limited when you hit my age.
4215,4004,1,16,76,93,1.1935483870967742,0.043935820942387044,666,What do you mean you 'went vegan'?
4493,4004,1,16,76,93,1.1935483870967742,0.043935820942387044,666,I hate take-out.
4556,4004,3,12,78,93,1.1935483870967742,0.04896799509143365,666,Day 12 of my Total Body Workout Challenge just said: legs.
3233,4004,3,12,78,93,1.1935483870967742,0.04896799509143365,666,"Honey, it was an accident."
1776,4004,2,14,77,93,1.1935483870967742,0.04652000056511267,666,Is it safe to say Shark Week fosters the overconfidence that makes white male privilege so annoying?
84,4004,0,18,75,93,1.1935483870967742,0.041189832133487855,666,"I know you're judging me right now, but I just don't think western medicine has all the answers."
1433,4004,3,12,78,93,1.1935483870967742,0.04896799509143365,666,"Oh I’ll eat him, as soon as he finishes updating my Facebook profile."
6311,4004,3,12,78,93,1.1935483870967742,0.04896799509143365,666,Foot massage.
6202,4004,4,10,79,93,1.1935483870967742,0.05129930441995542,666,It’s called Shuber and they say it’s going to be very disruptive.
5252,4004,3,12,78,93,1.1935483870967742,0.04896799509143365,666,"That'll be 10 dollars sir, and thank you for choosing Scuba Eats."
5983,4004,3,12,78,93,1.1935483870967742,0.04896799509143365,666,"It's not the weight, it's the smell of those feet!"
5565,4004,0,18,75,93,1.1935483870967742,0.041189832133487855,666,Well at least it's not a monkey.
5528,4004,2,14,77,93,1.1935483870967742,0.04652000056511267,666,The smart money is on 30 seconds before he realizes I'm not a surfboard.
5450,4004,4,10,79,93,1.1935483870967742,0.05129930441995542,666,It's called sharking
5045,4004,1,16,76,93,1.1935483870967742,0.043935820942387044,666,"Blessing in disguise! 
This Handsome Meal asked me for a Lift"
6017,4004,4,10,79,93,1.1935483870967742,0.05129930441995542,666,"Air, land and sea....Uber alles."
414,4004,2,14,77,93,1.1935483870967742,0.04652000056511267,666,"Sorry, I already ate the white meat."
126,4004,4,10,79,93,1.1935483870967742,0.05129930441995542,666,Vegetarianism.
1360,4004,4,10,79,93,1.1935483870967742,0.05129930441995542,666,Because I am surfeited for now!
1308,4004,3,12,78,93,1.1935483870967742,0.04896799509143365,666,Shall we toss him back in?
1147,4004,4,10,79,93,1.1935483870967742,0.05129930441995542,666,Gary here convinced me try intermittent fasting.
5243,4004,2,14,77,93,1.1935483870967742,0.04652000056511267,666,Whatever I just ate tastes like styrofoam
742,4004,4,10,79,93,1.1935483870967742,0.05129930441995542,666,"This is 2019, man - son of a mermaid!!"
5331,4004,3,12,78,93,1.1935483870967742,0.04896799509143365,666,"I was saving some for later, but I can’t remember where I put the rest of him"
452,4004,2,14,77,93,1.1935483870967742,0.04652000056511267,666,"I suppose it's better than him driving drunk"""
935,4004,3,12,78,93,1.1935483870967742,0.04896799509143365,666,I just feel like no one respects us anymore since this “Baby Shark” song
809,4054,3,19,110,132,1.1893939393939394,0.03897331447269078,666,"I considered Lyft, but Uber gets me more business."
759,4055,2,13,75,90,1.1888888888888889,0.04712573678232538,666,It's the newest rage. I think we'll all be wearing a human by summer's end!
1651,4055,3,11,76,90,1.1888888888888889,0.04970435551754336,666,I’m board.
2267,4055,2,13,75,90,1.1888888888888889,0.04712573678232538,666,"Yeah, athelete's foot sounds bad, but the doc says it's nothing more than a fun guy."
2668,4055,3,11,76,90,1.1888888888888889,0.04970435551754336,666,Is there something on my face?
2979,4055,3,11,76,90,1.1888888888888889,0.04970435551754336,666,Fonzie landed!
3291,4055,1,15,74,90,1.1888888888888889,0.044397603281480034,666,"I'm supposed to wait until he says, ""OK, boy!"""
3747,4055,4,9,77,90,1.1888888888888889,0.05215564061107554,666,I was going to eat him but it’s a waist.
4054,4055,3,11,76,90,1.1888888888888889,0.04970435551754336,666,I feel offended when people say I have a chip on my shoulder.
5157,4055,4,9,77,90,1.1888888888888889,0.05215564061107554,666,It's touching me!
1996,4055,2,13,75,90,1.1888888888888889,0.04712573678232538,666,He's upset because I don't have pearly teeth.
5142,4055,5,7,78,90,1.1888888888888889,0.05449677731470917,666,You placed the Uber Eats order?  Sorry about the missing arms.
4642,4066,2,16,88,106,1.1886792452830188,0.04262966067122,666,He thinks he's Moses.
337,4066,2,16,88,106,1.1886792452830188,0.04262966067122,666,I'm trying symbiosis this year.
1478,4068,1,17,83,101,1.188118811881188,0.04153698408594658,666,I thought it was just a headache.
5840,4069,2,14,80,96,1.1875,0.04519087200177378,666,"I think this is what the humans call hitchhiking, or is it surfing?"
5735,4069,1,16,79,96,1.1875,0.042695628191498324,666,now:SMILE!
135,4071,3,11,77,91,1.1868131868131868,0.04919892568609763,666,Scab!
2545,4071,4,9,78,91,1.1868131868131868,0.05162106675444049,666,Evolving Remoras...
2201,4071,2,13,76,91,1.1868131868131868,0.046651195530939105,666,Yea it’s a lot of extra swimming but I get to eat a lot of interesting people.
170,4071,2,13,76,91,1.1868131868131868,0.046651195530939105,666,"Good luck, Bob"
5448,4071,2,13,76,91,1.1868131868131868,0.046651195530939105,666,"I don't love the crowds at this beach, but I'm rarely hungry."
2639,4071,1,15,75,91,1.1868131868131868,0.04395604395604396,666,But he's right on my pressure point!
4170,4071,0,17,74,91,1.1868131868131868,0.041084468550358834,666,They call it ‘Millennial Surfing.’
5504,4078,5,6,75,86,1.186046511627907,0.05612090696789607,666,Ever feel topped off with riffraff?
2700,4079,2,16,90,108,1.1851851851851851,0.04190874258156364,666,I didn't read the fine print in that Contract with Kevin O'Leary.
2902,4080,0,19,84,103,1.1844660194174756,0.03840423627288277,666,It repels the remoras.
3894,4081,2,12,73,87,1.1839080459770115,0.04774726195683065,666,"No, we eat him after he finishes the massage."
4053,4081,3,10,74,87,1.1839080459770115,0.050468893694394994,666,"They're calling it ""Unter""."
4077,4081,2,12,73,87,1.1839080459770115,0.04774726195683065,666,"It's my Dating App. Females find it very attractive."""
4103,4081,2,12,73,87,1.1839080459770115,0.04774726195683065,666,Sam I'm conflicted on the one hand I should eat him but he's saving me a Chiropractor bill and those bills are pure murder!
4175,4081,0,16,71,87,1.1839080459770115,0.04177540678018991,666,"Sorry!  They were just about to close, and only had a couple of scrawny drumsticks!"
4178,4081,2,12,73,87,1.1839080459770115,0.04774726195683065,666,This one's heavy. Take a bite off for me?
4198,4081,3,10,74,87,1.1839080459770115,0.050468893694394994,666,Ashiatsu is great. After the massage I'll eat him.
3887,4081,3,10,74,87,1.1839080459770115,0.050468893694394994,666,I found this decoy on eBay--the bathing beauty model was sold out.
3858,4081,4,8,75,87,1.1839080459770115,0.0530510832792138,666,Please tell me it’s not an white man.
3847,4081,2,12,73,87,1.1839080459770115,0.04774726195683065,666,"It's called Shark Lift.
I'm supplementing my income"
3928,4081,2,12,73,87,1.1839080459770115,0.04774726195683065,666,Have you been hanging around with the dolphins again?
5871,4081,3,10,74,87,1.1839080459770115,0.050468893694394994,666,I have this tumor that’s been growing on my back. I need to have it removed.
4243,4081,3,10,74,87,1.1839080459770115,0.050468893694394994,666,He says he can’t reveal anything but I’ve got the part in the season finale.
4263,4081,0,16,71,87,1.1839080459770115,0.04177540678018991,666,I like to take my snacks along with me
4264,4081,1,14,72,87,1.1839080459770115,0.04486081606493881,666,Just another surfer dude cruising the briny deep!
4302,4081,1,14,72,87,1.1839080459770115,0.04486081606493881,666,"I get no respect, Johnny. No respect."
4363,4081,3,10,74,87,1.1839080459770115,0.050468893694394994,666,"I know,...waste of money. What's a vertebrate to do with an ashiatsu massage? I may have to eat it."
4422,4081,3,10,74,87,1.1839080459770115,0.050468893694394994,666,I’m considering a bold statement about my participation in these new encounter pools.
4454,4081,0,16,71,87,1.1839080459770115,0.04177540678018991,666,I thought we said this was a standing meeting?
4458,4081,3,10,74,87,1.1839080459770115,0.050468893694394994,666,It’s cheaper than shiatsu.
4460,4081,1,14,72,87,1.1839080459770115,0.04486081606493881,666,I’ve got this feeling someone’s riding me.
4466,4081,2,12,73,87,1.1839080459770115,0.04774726195683065,666,I wanted a massage and you said no!
4509,4081,4,8,75,87,1.1839080459770115,0.0530510832792138,666,"Sure he""d be tastey, but he gives the best massages this side of the Sea of Japan."
4535,4081,4,8,75,87,1.1839080459770115,0.0530510832792138,666,Nothing like a relaxing massage before dinner.
3821,4081,5,6,76,87,1.1839080459770115,0.05551329249342011,666,Republican lawyers do strange things on vacation.
3811,4081,2,12,73,87,1.1839080459770115,0.04774726195683065,666,This remora that I picked up isn’t doing a dang thing for me!
3497,4081,4,8,75,87,1.1839080459770115,0.0530510832792138,666,Do the trick…get the treat.
3745,4081,2,12,73,87,1.1839080459770115,0.04774726195683065,666,This guy certainly has perfected the shark yoga pose!
2894,4081,2,12,73,87,1.1839080459770115,0.04774726195683065,666,I get paid by the minute so they can ‘do it for th gram’
2934,4081,0,16,71,87,1.1839080459770115,0.04177540678018991,666,"I'd eat him, but my back itches."
6287,4081,3,10,74,87,1.1839080459770115,0.050468893694394994,666,I’m going to eat him after he sends this text.
2939,4081,2,12,73,87,1.1839080459770115,0.04774726195683065,666,Flip you for him!
2947,4081,4,8,75,87,1.1839080459770115,0.0530510832792138,666,I'm done doing ride-alongs.
2949,4081,3,10,74,87,1.1839080459770115,0.050468893694394994,666,Your Grub-hub is here.
3041,4081,3,10,74,87,1.1839080459770115,0.050468893694394994,666,It's part of a new pilot program from Lyft meant to address the future of climate change in coastal areas.
3080,4081,4,8,75,87,1.1839080459770115,0.0530510832792138,666,"Yes, it’s humiliating, but the kids need braces."
3149,4081,3,10,74,87,1.1839080459770115,0.050468893694394994,666,Did you order delivery?
3167,4081,3,10,74,87,1.1839080459770115,0.050468893694394994,666,"If people knew how Moses really walked on water, they might even be more impressed."
3207,4081,1,14,72,87,1.1839080459770115,0.04486081606493881,666,My Uber-Under shift makes me so hungry.
3245,4081,3,10,74,87,1.1839080459770115,0.050468893694394994,666,This guy has the wrong idea of swim fins.
3249,4081,2,12,73,87,1.1839080459770115,0.04774726195683065,666,Now?
3274,4081,0,16,71,87,1.1839080459770115,0.04177540678018991,666,I regret becoming an Uber driver...
3339,4081,4,8,75,87,1.1839080459770115,0.0530510832792138,666,"Wanna get him off my back, please."
3340,4081,2,12,73,87,1.1839080459770115,0.04774726195683065,666,This human is so dumb he thinks he's standing on a sandbar.
3371,4081,0,16,71,87,1.1839080459770115,0.04177540678018991,666,An itch I juts can't reach.
4563,4081,3,10,74,87,1.1839080459770115,0.050468893694394994,666,One nasty review cost me Superhost status.
3543,4081,2,12,73,87,1.1839080459770115,0.04774726195683065,666,"Apparently this is known as a ""sweet-fish massage."""
3562,4081,2,12,73,87,1.1839080459770115,0.04774726195683065,666,"You can have the head, I want these dang feet"
3565,4081,2,12,73,87,1.1839080459770115,0.04774726195683065,666,"I know, but  I  really hate to disappoint  him."
3586,4081,3,10,74,87,1.1839080459770115,0.050468893694394994,666,"Trying to get in at Sea World. They require some experience."""
3596,4081,2,12,73,87,1.1839080459770115,0.04774726195683065,666,Get this guy off my back!
3776,4081,4,8,75,87,1.1839080459770115,0.0530510832792138,666,“This feels so much better than those remoras!”
4595,4081,3,10,74,87,1.1839080459770115,0.050468893694394994,666,"-""I  will dip sudenly-you grab him as he falters."""
4833,4081,2,12,73,87,1.1839080459770115,0.04774726195683065,666,I charge by the depth and wave length. The company that sets it up is Baracuber.
4682,4081,3,10,74,87,1.1839080459770115,0.050468893694394994,666,"You know it’s a delicacy for humans to eat a leg of lamb.
Do they know how much we enjoy eating a leg of a man ....?"
5649,4081,1,14,72,87,1.1839080459770115,0.04486081606493881,666,Yeah...but he’s better than a monkey.
5665,4081,2,12,73,87,1.1839080459770115,0.04774726195683065,666,"He looked so cute trying to swim that I just couldn't do it, and now we have a relationship."
5683,4081,3,10,74,87,1.1839080459770115,0.050468893694394994,666,"It's called Uber, and I give them rides in my spare time."""
5711,4081,2,12,73,87,1.1839080459770115,0.04774726195683065,666,"What does ""I've got your back"" mean?"
5715,4081,4,8,75,87,1.1839080459770115,0.0530510832792138,666,"I don't know what happened. The New Yorker used to be brilliant.”
“No, it didn't. It was only pretentious."
5727,4081,2,12,73,87,1.1839080459770115,0.04774726195683065,666,"Don't worry you said,  he'll jump the shark you said..."
5738,4081,3,10,74,87,1.1839080459770115,0.050468893694394994,666,"Don't prejudge.  When he curls his toes, its the best backrub ever."
5746,4081,2,12,73,87,1.1839080459770115,0.04774726195683065,666,Lousy jumper.
5749,4081,3,10,74,87,1.1839080459770115,0.050468893694394994,666,I  learned this trick from watching Fido balance a bone on his nose.
5772,4081,3,10,74,87,1.1839080459770115,0.050468893694394994,666,I bet I could balance two on my back before dinner.
5776,4081,1,14,72,87,1.1839080459770115,0.04486081606493881,666,"My brother ate his best friend, so I thought I owed  it to him."
2893,4081,3,10,74,87,1.1839080459770115,0.050468893694394994,666,It’s take-a-human-to-work day.
5922,4081,3,10,74,87,1.1839080459770115,0.050468893694394994,666,Do I look like a sandbar?!
5931,4081,4,8,75,87,1.1839080459770115,0.0530510832792138,666,"I developed a cordial relationship with the life guard, now I can't get him off my back."
5953,4081,2,12,73,87,1.1839080459770115,0.04774726195683065,666,"This 'tasty morsel', as you put it, and I are the reigning world champion surfer team, and we've ridden the largest waves on the planet, including a tsunami or two."
6030,4081,1,14,72,87,1.1839080459770115,0.04486081606493881,666,Hey! Stop giving me that look!
6057,4081,3,10,74,87,1.1839080459770115,0.050468893694394994,666,"It’s called a “decoy”, and I’m working this end of the beach, so, scram! ‘\"
5901,4081,4,8,75,87,1.1839080459770115,0.0530510832792138,666,"After the foot massage, I'm going for the deep tissue."
5793,4081,2,12,73,87,1.1839080459770115,0.04774726195683065,666,'I remember when carryout orders were neatly wrapped!'
6141,4081,3,10,74,87,1.1839080459770115,0.050468893694394994,666,Wait till you see how we feed the multitudes.
6154,4081,3,10,74,87,1.1839080459770115,0.050468893694394994,666,I usually prefer Swedish but this shiatsu isn't bad.
6242,4081,3,10,74,87,1.1839080459770115,0.050468893694394994,666,"See, I wasn’t bull-snarking you!"
6258,4081,3,10,74,87,1.1839080459770115,0.050468893694394994,666,You gotta help me get this monkey off my back!
5600,4081,5,6,76,87,1.1839080459770115,0.05551329249342011,666,But he gives a great back massage...
5515,4081,2,12,73,87,1.1839080459770115,0.04774726195683065,666,Go ahead! It's a chewable life vest.
5420,4081,2,12,73,87,1.1839080459770115,0.04774726195683065,666,I wonder who will get the better half?
5415,4081,3,10,74,87,1.1839080459770115,0.050468893694394994,666,I thought I was applying for a meal delivery company not a ride hailing company.
4723,4081,4,8,75,87,1.1839080459770115,0.0530510832792138,666,"CAm out get this nerd off me and not make it look
Like we are killers."
4740,4081,2,12,73,87,1.1839080459770115,0.04774726195683065,666,I thought I'd give take-away a shot.
4789,4081,3,10,74,87,1.1839080459770115,0.050468893694394994,666,"On the plus side, once my massage is finished we'll have a snack to share."
4800,4081,2,12,73,87,1.1839080459770115,0.04774726195683065,666,My therapist says I should count to ten.
4809,4081,1,14,72,87,1.1839080459770115,0.04486081606493881,666,He does the best shiatsu around.
5799,4081,2,12,73,87,1.1839080459770115,0.04774726195683065,666,I'm fishing for a dinner date.
4876,4081,1,14,72,87,1.1839080459770115,0.04486081606493881,666,It's called a hood ornament.
4888,4081,3,10,74,87,1.1839080459770115,0.050468893694394994,666,I drew the line at waxing and sanding my spine.
4944,4081,4,8,75,87,1.1839080459770115,0.0530510832792138,666,We're having take-out tonight.
4957,4081,2,12,73,87,1.1839080459770115,0.04774726195683065,666,He doesn't know he's not close to shore.
5046,4081,2,12,73,87,1.1839080459770115,0.04774726195683065,666,"Doesn't he realize the expression is jump the shark, not jump ON the shark?"
4653,4081,3,10,74,87,1.1839080459770115,0.050468893694394994,666,It's a remora human.
5065,4081,4,8,75,87,1.1839080459770115,0.0530510832792138,666,"Well, at least I'm not alone in this fight."
5198,4081,2,12,73,87,1.1839080459770115,0.04774726195683065,666,This is my massage therapist.
5199,4081,3,10,74,87,1.1839080459770115,0.050468893694394994,666,"Ugh, why did I start going on a Vegan diet yesterday?"
5213,4081,1,14,72,87,1.1839080459770115,0.04486081606493881,666,Fifty bucks this guy's caption for Instagram will be 'Current events'
5219,4081,3,10,74,87,1.1839080459770115,0.050468893694394994,666,"This ride share gig is ok, but lunch can be problematic"
5234,4081,2,12,73,87,1.1839080459770115,0.04774726195683065,666,He got bored of kite surfing
5261,4081,4,8,75,87,1.1839080459770115,0.0530510832792138,666,First the ashiatsu; then the meal.
5268,4081,3,10,74,87,1.1839080459770115,0.050468893694394994,666,Yuck! Hic nails need trimming.
5298,4081,4,8,75,87,1.1839080459770115,0.0530510832792138,666,My cartilagest recommended him.
5365,4081,4,8,75,87,1.1839080459770115,0.0530510832792138,666,Make sure your new emotional support animal can breathe underwater.
5386,4081,3,10,74,87,1.1839080459770115,0.050468893694394994,666,He has incredible balance.
5388,4081,2,12,73,87,1.1839080459770115,0.04774726195683065,666,"You want him, I just ate lunch."
5144,4081,3,10,74,87,1.1839080459770115,0.050468893694394994,666,You want eat him or shall I?
2769,4081,1,14,72,87,1.1839080459770115,0.04486081606493881,666,I think it's Fonzie!  Do you like leather?
2540,4081,2,12,73,87,1.1839080459770115,0.04774726195683065,666,I promised my mom I wouldn't snack between meals.
194,4081,3,10,74,87,1.1839080459770115,0.050468893694394994,666,What one has to do just to get a meal!
814,4081,3,10,74,87,1.1839080459770115,0.050468893694394994,666,And you wondered why we have this sandy skin.....
851,4081,3,10,74,87,1.1839080459770115,0.050468893694394994,666,I saved the chriropractor for dessert!
852,4081,3,10,74,87,1.1839080459770115,0.050468893694394994,666,"He' s refusing to pet us today. So, what's eating at him"
870,4081,2,12,73,87,1.1839080459770115,0.04774726195683065,666,"There's on right on top of me, isn't there?"
880,4081,4,8,75,87,1.1839080459770115,0.0530510832792138,666,It’s a luncheon for Dad but he said we can do the wishbone
887,4081,3,10,74,87,1.1839080459770115,0.050468893694394994,666,"He tried to jump the shark, but it didn't work."
902,4081,2,12,73,87,1.1839080459770115,0.04774726195683065,666,It's the latest fad.  Foot message before you eat.
923,4081,3,10,74,87,1.1839080459770115,0.050468893694394994,666,"Decent wage, doo doo doo doo doo doo"""
951,4081,3,10,74,87,1.1839080459770115,0.050468893694394994,666,"Yeah, and _they_ hide hooks in food."
799,4081,4,8,75,87,1.1839080459770115,0.0530510832792138,666,He's going to need a bigger floatie.
1036,4081,3,10,74,87,1.1839080459770115,0.050468893694394994,666,He is asserting his white male privilege.
1080,4081,2,12,73,87,1.1839080459770115,0.04774726195683065,666,Just trying to make ends meet.  It's a new service: UberShark
1086,4081,1,14,72,87,1.1839080459770115,0.04486081606493881,666,I really need to think more deeply about working these beach parties.
1129,4081,1,14,72,87,1.1839080459770115,0.04486081606493881,666,He's more inviting than my dorsal fin.
1173,4081,3,10,74,87,1.1839080459770115,0.050468893694394994,666,"Sometimes I do it for Uber, sometimes for Uber Eats."
1296,4081,0,16,71,87,1.1839080459770115,0.04177540678018991,666,"I know, I know... stringy and get caught in your teeth... but nothing else was open."
1314,4081,2,12,73,87,1.1839080459770115,0.04774726195683065,666,They don't scare like they used to
1340,4081,3,10,74,87,1.1839080459770115,0.050468893694394994,666,I really regret going vegan.
1376,4081,3,10,74,87,1.1839080459770115,0.050468893694394994,666,"I'm afraid, if his phone has GPS they can track me down to wherever."
1447,4081,3,10,74,87,1.1839080459770115,0.050468893694394994,666,"He's a chiropractor. If he doesn't cure my spinal stenosis, he'll be VERY sorry."
1074,4081,1,14,72,87,1.1839080459770115,0.04486081606493881,666,"Since Linda had the kids, I've been ride sharing in the evenings to cover the bills."
1449,4081,3,10,74,87,1.1839080459770115,0.050468893694394994,666,He says my driving makes him feel ‘über unsafe.’
746,4081,1,14,72,87,1.1839080459770115,0.04486081606493881,666,He thinks this make him a “great white.”
700,4081,2,12,73,87,1.1839080459770115,0.04774726195683065,666,The dolphins say he'll get me into show biz.
2738,4081,2,12,73,87,1.1839080459770115,0.04774726195683065,666,He thinks he’s standing on a sand bar.
27,4081,2,12,73,87,1.1839080459770115,0.04774726195683065,666,"He keeps saying, 'I told 'em they're gonna need a bigger boat.'"
29,4081,4,8,75,87,1.1839080459770115,0.0530510832792138,666,Talk about lazy. Won't even swim.
143,4081,1,14,72,87,1.1839080459770115,0.04486081606493881,666,"Ever since I went vegan, I've been constantly tempted."
157,4081,0,16,71,87,1.1839080459770115,0.04177540678018991,666,This Uber gig just doesn't pay enough!
161,4081,1,14,72,87,1.1839080459770115,0.04486081606493881,666,"Dinner to go is convenient, but it has its negatives."
175,4081,3,10,74,87,1.1839080459770115,0.050468893694394994,666,I’ve signed up to Uber.
198,4081,0,16,71,87,1.1839080459770115,0.04177540678018991,666,I love those oriental foot massages
213,4081,2,12,73,87,1.1839080459770115,0.04774726195683065,666,My therapist says I need to be ok with the fact that some people are going to walk all over me.
714,4081,2,12,73,87,1.1839080459770115,0.04774726195683065,666,We’re both trying to be more green.
227,4081,3,10,74,87,1.1839080459770115,0.050468893694394994,666,He agreed to be my lure for bigger people.
293,4081,3,10,74,87,1.1839080459770115,0.050468893694394994,666,"It’s a swim-sharing service. You’ll never guess where I got an investor. And if my rider leaves a bad review, I eat them."
403,4081,1,14,72,87,1.1839080459770115,0.04486081606493881,666,"When I say I have a monkey on my back, I mean it literally."
458,4081,4,8,75,87,1.1839080459770115,0.0530510832792138,666,Yeah this is the testing my patience therapy.
466,4081,2,12,73,87,1.1839080459770115,0.04774726195683065,666,"I count six basses, eight cellos, four trombones and a tuba."
497,4081,2,12,73,87,1.1839080459770115,0.04774726195683065,666,Surfer à la mode.
543,4081,1,14,72,87,1.1839080459770115,0.04486081606493881,666,"SoCal is getting so expensive they can't afford surfboards anymore."""
589,4081,1,14,72,87,1.1839080459770115,0.04486081606493881,666,It's called ashiatsu. I find it very relaxing.
683,4081,3,10,74,87,1.1839080459770115,0.050468893694394994,666,Has this ever happened to you? I'm cruising the surface checking out the surfers and this guy jumps off his surf board and onto my back.
695,4081,2,12,73,87,1.1839080459770115,0.04774726195683065,666,I wish he'd just jump already.
238,4081,2,12,73,87,1.1839080459770115,0.04774726195683065,666,He promised me he bring me all of his in-laws if I take him to shore.
1459,4081,1,14,72,87,1.1839080459770115,0.04486081606493881,666,"I'm not really sure what it is, but Kevin said it tastes like chicken."
877,4081,3,10,74,87,1.1839080459770115,0.050468893694394994,666,"Get your camera and say wait, wait, wait, okay."
1500,4081,3,10,74,87,1.1839080459770115,0.050468893694394994,666,"I used to have a monkey on my back.  Now, this!"
2080,4081,2,12,73,87,1.1839080459770115,0.04774726195683065,666,"This is what happens Myrtle, this is what happens when Sharks go Vegetarian."
2088,4081,3,10,74,87,1.1839080459770115,0.050468893694394994,666,I'm starting to get kinda fond of the little guy
2120,4081,2,12,73,87,1.1839080459770115,0.04774726195683065,666,Don’t even think about it!  He belongs to me!
2125,4081,0,16,71,87,1.1839080459770115,0.04177540678018991,666,Is it just passed hors d'oeuvres or are they serving dinner?
2133,4081,1,14,72,87,1.1839080459770115,0.04486081606493881,666,I had been doing so much better with my enabling and co-dependency issues. But I think maybe I need to start seeing my therapist again.
2172,4081,2,12,73,87,1.1839080459770115,0.04774726195683065,666,I’m saving the best part for later.
2173,4081,2,12,73,87,1.1839080459770115,0.04774726195683065,666,Wow...this guy is clueless!
2236,4081,0,16,71,87,1.1839080459770115,0.04177540678018991,666,I swear people think they can walk all over me.
2285,4081,1,14,72,87,1.1839080459770115,0.04486081606493881,666,He says you need to realize there's other fish in the sea.
2327,4081,1,14,72,87,1.1839080459770115,0.04486081606493881,666,I had the torso appetizer and I saved you the legs
2345,4081,0,16,71,87,1.1839080459770115,0.04177540678018991,666,I was gonna eat him but he feeds me well.
2373,4081,1,14,72,87,1.1839080459770115,0.04486081606493881,666,I have an itch I can't scratch.
2396,4081,5,6,76,87,1.1839080459770115,0.05551329249342011,666,I bet him that Dany would end up on the throne.
2403,4081,2,12,73,87,1.1839080459770115,0.04774726195683065,666,It's Mark Cuban!
2421,4081,3,10,74,87,1.1839080459770115,0.050468893694394994,666,We're both running out of cartilage
1491,4081,3,10,74,87,1.1839080459770115,0.050468893694394994,666,I’m getting a headache. It’s your turn to cruise around with the decoy.
2487,4081,1,14,72,87,1.1839080459770115,0.04486081606493881,666,I'm offering a new service. It combines Uber's ride sharing with the Organized Crime's protection racket.
2511,4081,1,14,72,87,1.1839080459770115,0.04486081606493881,666,Do me a favor..bite his legs off
2550,4081,2,12,73,87,1.1839080459770115,0.04774726195683065,666,He's realigning my spine.
2602,4081,2,12,73,87,1.1839080459770115,0.04774726195683065,666,Takeout is so tedious.
2625,4081,4,8,75,87,1.1839080459770115,0.0530510832792138,666,I'm taking the leftovers home.
2077,4081,3,10,74,87,1.1839080459770115,0.050468893694394994,666,They sign up for free shark rides...and then we eat 'em.
2065,4081,2,12,73,87,1.1839080459770115,0.04774726195683065,666,Is the coast clear?
2430,4081,2,12,73,87,1.1839080459770115,0.04774726195683065,666,"You wanna tell Darwin, or should I?"
1954,4081,0,16,71,87,1.1839080459770115,0.04177540678018991,666,He doesn't realize he lost his paddleboard.
1544,4081,2,12,73,87,1.1839080459770115,0.04774726195683065,666,Feet are overrated.
1980,4081,3,10,74,87,1.1839080459770115,0.050468893694394994,666,Anything to escape communism...
1552,4081,2,12,73,87,1.1839080459770115,0.04774726195683065,666,My psychiatrist says I should try being the nail and not the hammer.
1568,4081,3,10,74,87,1.1839080459770115,0.050468893694394994,666,Uber. It's the bloody tips.
1616,4081,3,10,74,87,1.1839080459770115,0.050468893694394994,666,Somebody this stupid wouldn't taste that good.
1695,4081,4,8,75,87,1.1839080459770115,0.0530510832792138,666,It's Keto friendly.
1700,4081,5,6,76,87,1.1839080459770115,0.05551329249342011,666,"As a lawyer, he's great at spotting a new ""client""."
1725,4081,2,12,73,87,1.1839080459770115,0.04774726195683065,666,We have got to stop meeting like this!
1731,4081,1,14,72,87,1.1839080459770115,0.04486081606493881,666,I know. I just can't help it. I'm co-dependent.
1557,4081,1,14,72,87,1.1839080459770115,0.04486081606493881,666,Have you seen my lunch?
1766,4081,1,14,72,87,1.1839080459770115,0.04486081606493881,666,He said his name is POTUS and I am supposed to take him to my leader... I figured if I ate him it might impact my intelligence.
1793,4081,2,12,73,87,1.1839080459770115,0.04774726195683065,666,Then they will wonder why you bit his legs off.
1808,4081,2,12,73,87,1.1839080459770115,0.04774726195683065,666,You take him I just don't have the heart to do it
1890,4081,2,12,73,87,1.1839080459770115,0.04774726195683065,666,I can't wait for that 'Jaws' sequel to come out.
1820,4081,4,8,75,87,1.1839080459770115,0.0530510832792138,666,"I thought I was tired of being seen as dangerous, but now I just have a headache."
1839,4081,2,12,73,87,1.1839080459770115,0.04774726195683065,666,Yours or mine?
1763,4081,2,12,73,87,1.1839080459770115,0.04774726195683065,666,I owe him since I broke his surfboard.
1941,4081,2,12,73,87,1.1839080459770115,0.04774726195683065,666,We have sunk so low.
1888,4081,2,12,73,87,1.1839080459770115,0.04774726195683065,666,I love backrubs more than a full stomach.
138,4283,2,14,82,98,1.183673469387755,0.04434562619344774,666,I like a good foot massage before dinner.
626,4284,5,7,81,93,1.1827956989247312,0.05284393687196336,666,I thought I could pull off a long con.
1627,4284,3,11,79,93,1.1827956989247312,0.04821797883295062,666,"If he doesn't get off, I'm joining the Sharknado."
4437,4286,5,6,77,88,1.1818181818181819,0.0549186121136799,666,"Watch this. It's my version of the ""treat on the nose trick."""
4438,4286,3,10,75,88,1.1818181818181819,0.04993583800023195,666,Working for SCUBER is one way to bring in a few extra bucks.
4383,4286,3,10,75,88,1.1818181818181819,0.04993583800023195,666,I get the wishbone!
4321,4286,2,12,74,88,1.1818181818181819,0.04724780309106128,666,So I got a part in the Disney remake of Jaws.
4295,4286,3,10,75,88,1.1818181818181819,0.04993583800023195,666,Grubhub delivery!
4475,4286,1,14,73,88,1.1818181818181819,0.044397318354580724,666,Once I am ready to eat again Ill be able to get this weight off my back.
4421,4286,1,14,73,88,1.1818181818181819,0.044397318354580724,666,"If I don't encourage and support him, he punches me right on the nose!"
4753,4286,4,8,76,88,1.1818181818181819,0.052486388108147805,666,"I'm digesting it's torso, but I saved leftovers for you."
4540,4286,1,14,73,88,1.1818181818181819,0.044397318354580724,666,"Carl and I agreed to share, so he took the top half."
4634,4286,2,12,74,88,1.1818181818181819,0.04724780309106128,666,"One week of community service for speeding through the no-wake Zone, but this is silly."
4635,4286,3,10,75,88,1.1818181818181819,0.04993583800023195,666,"I've heard of having a monkey on your back, but this is something new to me."
4639,4286,5,6,77,88,1.1818181818181819,0.0549186121136799,666,I don't think the seat of his soul can be in the under-water parts.
4078,4286,2,12,74,88,1.1818181818181819,0.04724780309106128,666,"Clean Up the Ocean"" tours aren't going as planned"
4754,4286,2,12,74,88,1.1818181818181819,0.04724780309106128,666,Don’t eat anything he gives you that’s attached to a hook!
4727,4286,1,14,73,88,1.1818181818181819,0.044397318354580724,666,I got a second job working for Uber.
4729,4286,2,12,74,88,1.1818181818181819,0.04724780309106128,666,This massage sucks
4489,4286,1,14,73,88,1.1818181818181819,0.044397318354580724,666,His wife told him to go to a fish-stand.
4052,4286,1,14,73,88,1.1818181818181819,0.044397318354580724,666,Do I look top heavy to you?
3567,4286,2,12,74,88,1.1818181818181819,0.04724780309106128,666,"He'd LIKE to walk on water, but I hate getting that close to the surface . . ."
3994,4286,0,16,72,88,1.1818181818181819,0.0413508023770311,666,He’s telling everyone he’s a land shark!
4870,4286,1,14,73,88,1.1818181818181819,0.044397318354580724,666,You take him I ate his surf board.
3255,4286,1,14,73,88,1.1818181818181819,0.044397318354580724,666,I just have so much trouble saying no.
3485,4286,4,8,76,88,1.1818181818181819,0.052486388108147805,666,I'm auditioning for the film 'Supershark'.
3509,4286,2,12,74,88,1.1818181818181819,0.04724780309106128,666,"For our next lesson Fred, open your mouth while I do a quick fade left"
3514,4286,2,12,74,88,1.1818181818181819,0.04724780309106128,666,"Pardon me. Do you have any Grey Poupon?""
Cathy O'Neil"
3430,4286,3,10,75,88,1.1818181818181819,0.04993583800023195,666,He says he’s fine— as long as HE keeps his head above water.
3519,4286,2,12,74,88,1.1818181818181819,0.04724780309106128,666,"sorry, can't come for tea today something's wrong with my back"
3555,4286,3,10,75,88,1.1818181818181819,0.04993583800023195,666,"You take the top half, I’ll take the bottom bit."
4041,4286,5,6,77,88,1.1818181818181819,0.0549186121136799,666,I tried rocking and rolling but he just hangs ten
3558,4286,2,12,74,88,1.1818181818181819,0.04724780309106128,666,The remora has the weekend off.
3572,4286,3,10,75,88,1.1818181818181819,0.04993583800023195,666,"My therapist keeps telling me to think before I attack but if this guy doesn’t soon realize that I’m not a surfboard, he’s going to be lunch."
3602,4286,1,14,73,88,1.1818181818181819,0.044397318354580724,666,Is this one from YOUR SCHOOL?
3639,4286,1,14,73,88,1.1818181818181819,0.044397318354580724,666,"After you, Alphonse"
3649,4286,2,12,74,88,1.1818181818181819,0.04724780309106128,666,It's acupressure therapy for a badly infected tooth!
3663,4286,2,12,74,88,1.1818181818181819,0.04724780309106128,666,Did you call for Uber Shark Eats?
3793,4286,3,10,75,88,1.1818181818181819,0.04993583800023195,666,"I""m saving the last one for later."
3972,4286,2,12,74,88,1.1818181818181819,0.04724780309106128,666,"Don’t be salty, I told you I was poly."
3986,4286,1,14,73,88,1.1818181818181819,0.044397318354580724,666,Is this your first order from UberEats?
3564,4286,2,12,74,88,1.1818181818181819,0.04724780309106128,666,I'm helping him keep his head above water.  For now.
4997,4286,0,16,72,88,1.1818181818181819,0.0413508023770311,666,Getting ready for our five o'clock performance...
4432,4286,3,10,75,88,1.1818181818181819,0.04993583800023195,666,I'm taking weight lifting classes
5035,4286,1,14,73,88,1.1818181818181819,0.044397318354580724,666,He tells me his bigger friend is coming to rescue him.
5843,4286,1,14,73,88,1.1818181818181819,0.044397318354580724,666,It's called a foot massage.
5846,4286,1,14,73,88,1.1818181818181819,0.044397318354580724,666,I brought a snack for later.
5932,4286,4,8,76,88,1.1818181818181819,0.052486388108147805,666,"I was promised free fish for a year to try the new ""tag & release"" program, but I have been the victim of ""bait & switch""."
5942,4286,1,14,73,88,1.1818181818181819,0.044397318354580724,666,I'll do a somersault and we'll see who catches him first.
5963,4286,1,14,73,88,1.1818181818181819,0.044397318354580724,666,Yeah ... he’s the Good  Humor dude ... popsicle legs.
5979,4286,1,14,73,88,1.1818181818181819,0.044397318354580724,666,Hey stop looking at him like that! We're vegan now remember?
6003,4286,2,12,74,88,1.1818181818181819,0.04724780309106128,666,We sure picked a bad week to go vegetarian...
6011,4286,2,12,74,88,1.1818181818181819,0.04724780309106128,666,The family wanted take out tonight.
5817,4286,3,10,75,88,1.1818181818181819,0.04993583800023195,666,I'm saving the other half for a snack.
6070,4286,1,14,73,88,1.1818181818181819,0.044397318354580724,666,I'm on a strict diet but there's a hunger weighing me down.
6091,4286,1,14,73,88,1.1818181818181819,0.044397318354580724,666,He's a high maintenance periscope.
6126,4286,1,14,73,88,1.1818181818181819,0.044397318354580724,666,There's nothing creepier than to have your food walk on your back.
6190,4286,0,16,72,88,1.1818181818181819,0.0413508023770311,666,The treats were just too tempting.
6219,4286,3,10,75,88,1.1818181818181819,0.04993583800023195,666,you seen the top half of this guy?
3253,4286,1,14,73,88,1.1818181818181819,0.044397318354580724,666,"It's called fashion, look it up."
6223,4286,3,10,75,88,1.1818181818181819,0.04993583800023195,666,"If they don’t give me five stars, I eat them."
6237,4286,1,14,73,88,1.1818181818181819,0.044397318354580724,666,I'm just not hungry
6309,4286,0,16,72,88,1.1818181818181819,0.0413508023770311,666,My agent controls book rights for Aesop's fables so he packaged us in.
6078,4286,4,8,76,88,1.1818181818181819,0.052486388108147805,666,Ugh... and they wonder why we eat them.
5019,4286,3,10,75,88,1.1818181818181819,0.04993583800023195,666,Two more weeks and he goes back to his parents
5812,4286,2,12,74,88,1.1818181818181819,0.04724780309106128,666,Usually they step on the scales before going to the beach.
5688,4286,2,12,74,88,1.1818181818181819,0.04724780309106128,666,Have you seen my saddle?
5073,4286,4,8,76,88,1.1818181818181819,0.052486388108147805,666,"It seems that ""jumping the shark"" has actually become cool."
5101,4286,2,12,74,88,1.1818181818181819,0.04724780309106128,666,"You can call it a comedown, but I felt it was time to evolve with the marketplace."
5123,4286,1,14,73,88,1.1818181818181819,0.044397318354580724,666,"Come on Frank, you gotta stop letting people walk all over you.”"
5170,4286,3,10,75,88,1.1818181818181819,0.04993583800023195,666,"Other than deep tissue, she ate sue is my favorite massage."
5184,4286,2,12,74,88,1.1818181818181819,0.04724780309106128,666,"Another Fonz, another miss..."
5249,4286,2,12,74,88,1.1818181818181819,0.04724780309106128,666,It's something called Thai massage.
5322,4286,4,8,76,88,1.1818181818181819,0.052486388108147805,666,"Yes,Uber's been underwater since the IPO."
5334,4286,3,10,75,88,1.1818181818181819,0.04993583800023195,666,Hey Georgie: Am I supposed to eat this person?
5780,4286,1,14,73,88,1.1818181818181819,0.044397318354580724,666,"Now, for today's a la carte item."
5344,4286,3,10,75,88,1.1818181818181819,0.04993583800023195,666,"""My mother tried to explain 'hubris' to me. 
The only thing I understood was that you can't eat it."""
5379,4286,1,14,73,88,1.1818181818181819,0.044397318354580724,666,Never bet someone who bets a shark!
5428,4286,3,10,75,88,1.1818181818181819,0.04993583800023195,666,Do I have something on my head?
5439,4286,1,14,73,88,1.1818181818181819,0.044397318354580724,666,He thinks he's a remora.
5555,4286,2,12,74,88,1.1818181818181819,0.04724780309106128,666,"dibs on the thighs"""
5570,4286,1,14,73,88,1.1818181818181819,0.044397318354580724,666,I'm letting him think I am one of those paddle boards until I get hungry.
5591,4286,1,14,73,88,1.1818181818181819,0.044397318354580724,666,"What can I say?  Yeah, I joined the gig economy ..."
5614,4286,3,10,75,88,1.1818181818181819,0.04993583800023195,666,I promised to give up red meat not withstanding.
5684,4286,3,10,75,88,1.1818181818181819,0.04993583800023195,666,"If I don't have background music, I lose my appetite."
5345,4286,1,14,73,88,1.1818181818181819,0.044397318354580724,666,I just figured we were going the same way...
3229,4286,1,14,73,88,1.1818181818181819,0.044397318354580724,666,Tuna is a peer-to-shark transport network
2304,4286,0,16,72,88,1.1818181818181819,0.0413508023770311,666,"I really do not like this new GOP climate change adaption strategy"""
3111,4286,1,14,73,88,1.1818181818181819,0.044397318354580724,666,"Being vegan is really hard, let me tell you."
1107,4286,2,12,74,88,1.1818181818181819,0.04724780309106128,666,"Mixed us up again with the tv show, but you’d think they’d at least come up with something useful for us for a change !"
1153,4286,1,14,73,88,1.1818181818181819,0.044397318354580724,666,Care for an hors d'oeuvre?
1166,4286,3,10,75,88,1.1818181818181819,0.04993583800023195,666,It was a trade-off to keep my fins.
1191,4286,2,12,74,88,1.1818181818181819,0.04724780309106128,666,He thinks if he doesn't move I won't eat him!
1198,4286,2,12,74,88,1.1818181818181819,0.04724780309106128,666,"Yeah, it’s stylish as hats go, but it gives me such a headache."
1210,4286,3,10,75,88,1.1818181818181819,0.04993583800023195,666,Speak of clueless.
1082,4286,3,10,75,88,1.1818181818181819,0.04993583800023195,666,It's a new lure I'm using.
1218,4286,1,14,73,88,1.1818181818181819,0.044397318354580724,666,Can you help? I seem to have misplaced my lunch.
1284,4286,2,12,74,88,1.1818181818181819,0.04724780309106128,666,"Not to worry about eating those legs. They're Donald Trump's... and you know they're filled with hormones, gluten, saturated fat and plastic."
1300,4286,2,12,74,88,1.1818181818181819,0.04724780309106128,666,We could flip for him.
1339,4286,3,10,75,88,1.1818181818181819,0.04993583800023195,666,Don't you hate it that our reputation of being man eaters has been killed by the National Geographic Channel.
1368,4286,2,12,74,88,1.1818181818181819,0.04724780309106128,666,I am skipping the appetizers.
1465,4286,1,14,73,88,1.1818181818181819,0.044397318354580724,666,I still say you attract more of them with promises of tax cuts.
1571,4286,0,16,72,88,1.1818181818181819,0.0413508023770311,666,``Knock yourself out.''
1280,4286,2,12,74,88,1.1818181818181819,0.04724780309106128,666,"Well, I was the one who suggested couple's therapy. I think we both feel stuck in our roles in this relationship. And the emotional distance is hard."
1576,4286,0,16,72,88,1.1818181818181819,0.0413508023770311,666,Don't order the back massage with this guy.
1008,4286,2,12,74,88,1.1818181818181819,0.04724780309106128,666,The things they make you do when it’s not shark week.
833,4286,3,10,75,88,1.1818181818181819,0.04993583800023195,666,Nah! He's a vegan. They're stringy
70,4286,1,14,73,88,1.1818181818181819,0.044397318354580724,666,Don't look at me that way.  It's the latest thing - I thought I'd try it.
151,4286,2,12,74,88,1.1818181818181819,0.04724780309106128,666,"No, it’s not a wishbone!"
226,4286,1,14,73,88,1.1818181818181819,0.044397318354580724,666,"If he pees, I want overtime."
299,4286,1,14,73,88,1.1818181818181819,0.044397318354580724,666,I’m taking the leftovers to work for lunch tomorrow.
3228,4286,2,12,74,88,1.1818181818181819,0.04724780309106128,666,Damien Hirst is now a performance artist
321,4286,3,10,75,88,1.1818181818181819,0.04993583800023195,666,Ready?  On the count of three...
924,4286,2,12,74,88,1.1818181818181819,0.04724780309106128,666,He'll only give me three stars unless I take him right up to the beach.
327,4286,2,12,74,88,1.1818181818181819,0.04724780309106128,666,I'm testing a new ride service called FUBER -Fish Underwater Bleeping Efficient Ride!
533,4286,2,12,74,88,1.1818181818181819,0.04724780309106128,666,The monkey on my back has evolved.
621,4286,2,12,74,88,1.1818181818181819,0.04724780309106128,666,It’s called massage.
669,4286,2,12,74,88,1.1818181818181819,0.04724780309106128,666,I saved half for leftovers.
675,4286,1,14,73,88,1.1818181818181819,0.044397318354580724,666,He's bait...
705,4286,2,12,74,88,1.1818181818181819,0.04724780309106128,666,Can you please just not get so much blood in my eyes this time?
722,4286,2,12,74,88,1.1818181818181819,0.04724780309106128,666,Ashiatsu AF
389,4286,0,16,72,88,1.1818181818181819,0.0413508023770311,666,This is what's left over.
1601,4286,3,10,75,88,1.1818181818181819,0.04993583800023195,666,"He's seeking asylum from Greenwich, Conn."
309,4286,0,16,72,88,1.1818181818181819,0.0413508023770311,666,The humans call it SUP - Shark Using Pedestrians
1779,4286,2,12,74,88,1.1818181818181819,0.04724780309106128,666,"I don't care, I'm keeping him!"
2566,4286,2,12,74,88,1.1818181818181819,0.04724780309106128,666,What do you think? It’s for a British Royal Wedding.
2616,4286,2,12,74,88,1.1818181818181819,0.04724780309106128,666,May I offer you an hors d'oeuvre sir?
2635,4286,1,14,73,88,1.1818181818181819,0.044397318354580724,666,"Keep his head above water.”  But Bruce, what about our nature?"
2641,4286,3,10,75,88,1.1818181818181819,0.04993583800023195,666,Says he is the Attorney General.  So this is definitely only a temporary professional courtesy.
2687,4286,2,12,74,88,1.1818181818181819,0.04724780309106128,666,I turned vegan.
2766,4286,4,8,76,88,1.1818181818181819,0.052486388108147805,666,maybe he will loose his balance !
2492,4286,0,16,72,88,1.1818181818181819,0.0413508023770311,666,I found him on a German message board.
2768,4286,2,12,74,88,1.1818181818181819,0.04724780309106128,666,I only took this job because  I’d be paid in bitcoin.
2888,4286,1,14,73,88,1.1818181818181819,0.044397318354580724,666,I got a loan from the wrong guy!
2978,4286,2,12,74,88,1.1818181818181819,0.04724780309106128,666,"Don't give me that look, it's just my side hustle."
2981,4286,4,8,76,88,1.1818181818181819,0.052486388108147805,666,"Please don't eat him--every since my air  bladders got pressurized, it's the only thing that keeps me from floating all the time."
3019,4286,2,12,74,88,1.1818181818181819,0.04724780309106128,666,Looks like stupid is on the menu again
3069,4286,3,10,75,88,1.1818181818181819,0.04993583800023195,666,It’s a new PR campaign
1671,4286,3,10,75,88,1.1818181818181819,0.04993583800023195,666,"First an Ashiatsu massage, then dinner."
2880,4286,3,10,75,88,1.1818181818181819,0.04993583800023195,666,He said we would go viral.
2448,4286,2,12,74,88,1.1818181818181819,0.04724780309106128,666,I found him on E-Bay !
2992,4286,1,14,73,88,1.1818181818181819,0.044397318354580724,666,"They told him not to walk on the reef, but he didn’t listen. Boy is he going to be sorry!"
2407,4286,1,14,73,88,1.1818181818181819,0.044397318354580724,666,Now I know how a humpback feels.
1790,4286,2,12,74,88,1.1818181818181819,0.04724780309106128,666,Why do you say I'm a slave to my appetites?
1785,4286,1,14,73,88,1.1818181818181819,0.044397318354580724,666,"I know it looks silly, but I'm just playing along until it's my lunch time."
1937,4286,2,12,74,88,1.1818181818181819,0.04724780309106128,666,"I’m working for the new water taxi service, SCUBER."
2072,4286,2,12,74,88,1.1818181818181819,0.04724780309106128,666,"I'm not even making Minimum on this ride, but at least they let me bring home food."
2127,4286,3,10,75,88,1.1818181818181819,0.04993583800023195,666,Do you think he will jump the shark?
2135,4286,4,8,76,88,1.1818181818181819,0.052486388108147805,666,You can have the rest. I always eat my favorite parts first.
2211,4286,2,12,74,88,1.1818181818181819,0.04724780309106128,666,You catch more flies with honey.
1818,4286,0,16,72,88,1.1818181818181819,0.0413508023770311,666,I finally got the monkey off my back and now this homosapien is causing me grief!
2249,4286,1,14,73,88,1.1818181818181819,0.044397318354580724,666,"Honestly, I think I prefer the Swedish massage."
2298,4286,3,10,75,88,1.1818181818181819,0.04993583800023195,666,"I just picked up some take out at Sands Point, want to come by for a bite."
2329,4286,3,10,75,88,1.1818181818181819,0.04993583800023195,666,Uber has promised aggressive growth potential; still no insurance.
2385,4286,2,12,74,88,1.1818181818181819,0.04724780309106128,666,"Okay.  When I dive, you grab our lunch."
2354,4286,2,12,74,88,1.1818181818181819,0.04724780309106128,666,"Sorry, that new beach's take-out menu is really limited."
4989,4439,3,15,98,116,1.1810344827586208,0.04170133318085456,666,He’s watching out for people with hooks.
3151,4440,3,10,76,89,1.1797752808988764,0.04941382071271396,666,"They’re still scared, maybe I shouldn’t have used Liam Neeson."
5888,4440,2,12,75,89,1.1797752808988764,0.04675856138200857,666,"Get this guy off my back, he’s been on me all day!"
3490,4442,4,11,91,106,1.179245283018868,0.0460422279928785,666,Best back rub I ever had.
2210,4443,3,10,77,90,1.1777777777777778,0.04890250633185913,666,Why do I always get the goofy foot?
5193,4444,3,11,82,96,1.1770833333333333,0.04681709386300883,666,I know you have the other half.
2435,4445,2,11,72,85,1.1764705882352942,0.0478573703400451,666,"Hey, Gaga wore the meat dress."
2777,4445,2,11,72,85,1.1764705882352942,0.0478573703400451,666,"Yeah, I signed up with Ocean Uber."
1945,4445,4,7,74,85,1.1764705882352942,0.05339056082773511,666,"Dish-on-Fish, the food delivery service for non-discriminating marine clients, who just want fast food now."
2907,4445,2,11,72,85,1.1764705882352942,0.0478573703400451,666,His TV series jumped the shark.
2985,4445,0,15,70,85,1.1764705882352942,0.04159451654038516,666,He makes a great lure.
1592,4445,3,9,73,85,1.1764705882352942,0.05069950631596087,666,"He thinks I'm his surfboard.
I'm just waiting to poop and get my appetite back."
3098,4445,2,11,72,85,1.1764705882352942,0.0478573703400451,666,Wait! I can still feel some neck tension.
3120,4445,3,9,73,85,1.1764705882352942,0.05069950631596087,666,"Kowabunga, dude!"
3247,4445,1,13,71,85,1.1764705882352942,0.04483543075566802,666,Uber is everywhere.
3398,4445,2,11,72,85,1.1764705882352942,0.0478573703400451,666,"I heard someone yell out, ""Jesus!"""
5037,4445,3,9,73,85,1.1764705882352942,0.05069950631596087,666,"Swimming isn't paying the bills, so I started ride-sharing."
2300,4445,1,13,71,85,1.1764705882352942,0.04483543075566802,666,It's a new form of water aerobics.
1956,4445,1,13,71,85,1.1764705882352942,0.04483543075566802,666,I don't have the heart to tell him that he is going to be dinner.
3756,4445,3,9,73,85,1.1764705882352942,0.05069950631596087,666,Doesn’t he know I’m a lemon?
3443,4445,2,11,72,85,1.1764705882352942,0.0478573703400451,666,"It’s like Uber, but for the coastal water regions."
3507,4445,1,13,71,85,1.1764705882352942,0.04483543075566802,666,Dinner will be soon. He asked to say goodbye to his wife.
3717,4445,1,13,71,85,1.1764705882352942,0.04483543075566802,666,"Yeah, been driving for seaUBER for a month now."
3722,4445,1,13,71,85,1.1764705882352942,0.04483543075566802,666,He's an environmentalist with an AR-15.  He volunteered to protect my fin.
4519,4445,3,9,73,85,1.1764705882352942,0.05069950631596087,666,when you say goodbye and then both end up walking in the same direction
3860,4445,0,15,70,85,1.1764705882352942,0.04159451654038516,666,Go ahead and munch.  They taste like chicken!
3906,4445,0,15,70,85,1.1764705882352942,0.04159451654038516,666,He said his name was Finn. How could I say “No”?
4069,4445,2,11,72,85,1.1764705882352942,0.0478573703400451,666,"Its the latest in camouflage technology, its supposed to allow you to get right up close to those unsuspecting swimmers !"
4101,4445,2,11,72,85,1.1764705882352942,0.0478573703400451,666,One of the dolfins didn't show up.
1519,4445,2,11,72,85,1.1764705882352942,0.0478573703400451,666,He’s practicing for the Sea World Follies.
4804,4445,2,11,72,85,1.1764705882352942,0.0478573703400451,666,I thought swimming for Uber would be a good idea but these humans keep using my skin to scrape the callouses off their feet!
4117,4445,0,15,70,85,1.1764705882352942,0.04159451654038516,666,They’re a lot more confident since “Finding Nemo”
4633,4445,2,11,72,85,1.1764705882352942,0.0478573703400451,666,Bruce had John Williams’ ostinato of bass notes to help clear a beach. I have a shirtless Steve Mnuchin.
4209,4445,2,11,72,85,1.1764705882352942,0.0478573703400451,666,He calls it Veganism. I call it a pain in the neck.
3401,4445,2,11,72,85,1.1764705882352942,0.0478573703400451,666,‘Sup
1517,4445,0,15,70,85,1.1764705882352942,0.04159451654038516,666,I'm just heading out for a quick bite.
6307,4445,2,11,72,85,1.1764705882352942,0.0478573703400451,666,He needs to learn how to be a five-star passenger.
1501,4445,3,9,73,85,1.1764705882352942,0.05069950631596087,666,"That’s right, I invited you to come meet my chum."
5501,4445,4,7,74,85,1.1764705882352942,0.05339056082773511,666,Don't complain about the delivery charge.   I had to swim to Germany for your Hamburger.
4808,4445,2,11,72,85,1.1764705882352942,0.0478573703400451,666,"Yeah, I decided to start working for Uber’s water taxi service."
5429,4445,1,13,71,85,1.1764705882352942,0.04483543075566802,666,"So this guy from Uber says,“You gotta be moving all the time, why not make a few bucks at it?”"
5503,4445,1,13,71,85,1.1764705882352942,0.04483543075566802,666,"Change our image for the tourist season, you said. And this is what you come up with!"
5567,4445,1,13,71,85,1.1764705882352942,0.04483543075566802,666,I'm saving it for a snack later!
5781,4445,1,13,71,85,1.1764705882352942,0.04483543075566802,666,I'm just not feeling respected
5876,4445,0,15,70,85,1.1764705882352942,0.04159451654038516,666,Now I understand what living at Sea World feels like
6032,4445,3,9,73,85,1.1764705882352942,0.05069950631596087,666,"Ever Since I signed on with Uber, I've gotten all these strange requests...Do you have any idea where ""Times Square"" is?"
6104,4445,3,9,73,85,1.1764705882352942,0.05069950631596087,666,Let's do lunch—the treat's on me!
6115,4445,1,13,71,85,1.1764705882352942,0.04483543075566802,666,It's sort of like Custers stand.
6135,4445,0,15,70,85,1.1764705882352942,0.04159451654038516,666,Uber in Florida in 2050.
6170,4445,2,11,72,85,1.1764705882352942,0.0478573703400451,666,I'm really sorry but he makes my tail wiggle.
1516,4445,3,9,73,85,1.1764705882352942,0.05069950631596087,666,Now I'm sorry I signed with Uber
6299,4445,2,11,72,85,1.1764705882352942,0.0478573703400451,666,"I'm only doing it until he gets his ""shore legs"" back."
62,4445,0,15,70,85,1.1764705882352942,0.04159451654038516,666,I'd rather have a monkey on my back.
230,4445,1,13,71,85,1.1764705882352942,0.04483543075566802,666,He said his name was Fonzarelli.
367,4445,2,11,72,85,1.1764705882352942,0.0478573703400451,666,Show your fin again; I want a real deep-tissue massage.
562,4445,2,11,72,85,1.1764705882352942,0.0478573703400451,666,"We need to hire an  Reputation Management Agency, we’re getting no respect."
596,4445,3,9,73,85,1.1764705882352942,0.05069950631596087,666,"I don't think this is what JFK meant when he said, ""A rising tide lifts all boats."""
635,4445,4,7,74,85,1.1764705882352942,0.05339056082773511,666,You'd think by now they'd be afraid of our 'Jaws.'
5348,4445,1,13,71,85,1.1764705882352942,0.04483543075566802,666,Save for your retirement Carl - otherwise you end up doing this for tips.
959,4445,1,13,71,85,1.1764705882352942,0.04483543075566802,666,The things you do for Instagram...
1233,4445,0,15,70,85,1.1764705882352942,0.04159451654038516,666,They were all out of jumbo.
1371,4445,1,13,71,85,1.1764705882352942,0.04483543075566802,666,I’m saving him for a snack.
1416,4445,2,11,72,85,1.1764705882352942,0.0478573703400451,666,"Yes, I decided to go to work for ""Shark-Uber."""
1427,4445,1,13,71,85,1.1764705882352942,0.04483543075566802,666,Ashi-ark-su
1462,4445,3,9,73,85,1.1764705882352942,0.05069950631596087,666,Can I eat him NOW?
4953,4445,0,15,70,85,1.1764705882352942,0.04159451654038516,666,"So, how long do we have to play sand bar to a bunch of edible tourists?"
5042,4505,4,13,103,120,1.175,0.04211246114576422,666,I call it Swyft - my new app based water taxi service.
6026,4506,2,11,73,86,1.1744186046511629,0.0473421069773523,666,Are you here to replace me?
2876,4507,4,7,76,87,1.1724137931034482,0.05223396605431375,666,So much for being an apex predator!
1412,4507,2,11,74,87,1.1724137931034482,0.04683770700022932,666,"It's Conceptual Art and helps with my dieting,I can only chew little pieces while it stands on my head"
549,4509,2,9,65,76,1.1710526315789473,0.050914988985724385,666,"Are you ready for lunch?  This guy doesn't understand that even at Sea World, we have our limits."
3468,4510,1,12,69,82,1.170731707317073,0.045266376933577414,666,I prefer leg of lamb.  You want his?
3483,4510,1,12,69,82,1.170731707317073,0.045266376933577414,666,I owe him a paddle board
3500,4510,2,10,70,82,1.170731707317073,0.048478438536580806,666,"No thanks, I brought my own lunch"
3515,4510,1,12,69,82,1.170731707317073,0.045266376933577414,666,He doesn't weigh that much.  It's the toenails.
3538,4510,4,6,72,82,1.170731707317073,0.05433587440586293,666,We've thrown in a free second leg with your takeout order
3581,4510,3,8,71,82,1.170731707317073,0.051490514905149054,666,I only do Uber on the weekends.
3593,4510,2,10,70,82,1.170731707317073,0.048478438536580806,666,He's a vegan.  He promised to lure meat eaters out here if I did;t eat him.
3620,4510,1,12,69,82,1.170731707317073,0.045266376933577414,666,"Maybe, maybe not not .  .  . I really prefer the taste of board shorts."
3715,4510,3,8,71,82,1.170731707317073,0.051490514905149054,666,"Enough is enough! If you don't eat him, I will!"
3729,4510,3,8,71,82,1.170731707317073,0.051490514905149054,666,No there isn’t.
3467,4510,1,12,69,82,1.170731707317073,0.045266376933577414,666,"Look it’s a free massage, don’t judge!"
5657,4510,2,10,70,82,1.170731707317073,0.048478438536580806,666,I lost a bet. For now.
3777,4510,1,12,69,82,1.170731707317073,0.045266376933577414,666,"Overheard at the sandbar; “Cheers, this one’s on me!”"
3875,4510,1,12,69,82,1.170731707317073,0.045266376933577414,666,Something's fishy here!
3904,4510,2,10,70,82,1.170731707317073,0.048478438536580806,666,"OK, It ain't the reef but here you get all the fish you can eat and water temperature control."
3946,4510,2,10,70,82,1.170731707317073,0.048478438536580806,666,"Sure, I get hungry. But this is the only relief I can get for my chronic backache."
3985,4510,1,12,69,82,1.170731707317073,0.045266376933577414,666,"I'll flip him. Heads you get um, tails he's mine."
4026,4510,1,12,69,82,1.170731707317073,0.045266376933577414,666,He promised me something bigger.
4064,4510,3,8,71,82,1.170731707317073,0.051490514905149054,666,"We could have him for lunch, but then Uber might fire me."
4216,4510,2,10,70,82,1.170731707317073,0.048478438536580806,666,I like a little ashiatsu before lunch.
4244,4510,0,14,68,82,1.170731707317073,0.04180826184428594,666,"If you stay perfectly still, he can't see you and will hopefully swim away."
4334,4510,2,10,70,82,1.170731707317073,0.048478438536580806,666,Like shooting fish in a barrel
4360,4510,1,12,69,82,1.170731707317073,0.045266376933577414,666,He thinks he's standing on the bottom. How do I break the news?
3733,4510,0,14,68,82,1.170731707317073,0.04180826184428594,666,Grubhub or Doordash??
3435,4510,2,10,70,82,1.170731707317073,0.048478438536580806,666,I'm working the gig economy as ab Uber shark
3422,4510,1,12,69,82,1.170731707317073,0.045266376933577414,666,Call me Ceremony and I'll bite your face off.
3411,4510,0,14,68,82,1.170731707317073,0.04180826184428594,666,It's easier if you make them feel warm and comfortable first.
2586,4510,2,10,70,82,1.170731707317073,0.048478438536580806,666,Half a loaf is better than none.
2591,4510,2,10,70,82,1.170731707317073,0.048478438536580806,666,This poor loser thinks he’s on dry land.
2598,4510,1,12,69,82,1.170731707317073,0.045266376933577414,666,I prefer to carry my lunch.
2678,4510,4,6,72,82,1.170731707317073,0.05433587440586293,666,Feetish massage.  Yummy.
2712,4510,1,12,69,82,1.170731707317073,0.045266376933577414,666,"He's been taking a selfie for the past twenty minutes, can't really move until he does."
2719,4510,2,10,70,82,1.170731707317073,0.048478438536580806,666,Their regular Uber drivers are on strike.
2765,4510,3,8,71,82,1.170731707317073,0.051490514905149054,666,"I thought during the closed season I could make some money from this Uber thing, at least."
2773,4510,3,8,71,82,1.170731707317073,0.051490514905149054,666,This helps me get a LOT closer.
2839,4510,1,12,69,82,1.170731707317073,0.045266376933577414,666,He’s light. The pay is good. He might have a friend for you.
2938,4510,1,12,69,82,1.170731707317073,0.045266376933577414,666,They are not a very intelligent species.
4374,4510,3,8,71,82,1.170731707317073,0.051490514905149054,666,Do you hear music?
2944,4510,3,8,71,82,1.170731707317073,0.051490514905149054,666,"I bit off his toes last summer and my conscience got the best of me.  Now I ride him around the bay so he can impress his friends."""
2988,4510,4,6,72,82,1.170731707317073,0.05433587440586293,666,He thinks I’m a rabbit
3025,4510,1,12,69,82,1.170731707317073,0.045266376933577414,666,I can’t get this guy off my back!
3127,4510,3,8,71,82,1.170731707317073,0.051490514905149054,666,You’d think we would get at least a third of the money.
3168,4510,1,12,69,82,1.170731707317073,0.045266376933577414,666,Shark or sink.
3236,4510,2,10,70,82,1.170731707317073,0.048478438536580806,666,Looks like daddy shark do do do do is the winner.
3262,4510,3,8,71,82,1.170731707317073,0.051490514905149054,666,Damn millennials and the ‘gram
3296,4510,1,12,69,82,1.170731707317073,0.045266376933577414,666,Once he leaves me five stars you can attack.
3318,4510,1,12,69,82,1.170731707317073,0.045266376933577414,666,Death is not the end.
3324,4510,3,8,71,82,1.170731707317073,0.051490514905149054,666,I'm saving him for tea time.
3384,4510,2,10,70,82,1.170731707317073,0.048478438536580806,666,"So,now will you go out with me?"
2951,4510,1,12,69,82,1.170731707317073,0.045266376933577414,666,Stop playing with your food
4393,4510,3,8,71,82,1.170731707317073,0.051490514905149054,666,He scratches my back and then I eat him.
4402,4510,3,8,71,82,1.170731707317073,0.051490514905149054,666,Long story short: he pulled a thorn out of my paw.
4413,4510,1,12,69,82,1.170731707317073,0.045266376933577414,666,Delivery?
5427,4510,1,12,69,82,1.170731707317073,0.045266376933577414,666,"Stay low!  They want our eggs, too."
5430,4510,2,10,70,82,1.170731707317073,0.048478438536580806,666,"Without the dangling, it’s just no fun."
5442,4510,1,12,69,82,1.170731707317073,0.045266376933577414,666,Looks like we're gonna need a bigger ocean
5483,4510,0,14,68,82,1.170731707317073,0.04180826184428594,666,Remember when Jaws was scarier than Blackfish?
5493,4510,1,12,69,82,1.170731707317073,0.045266376933577414,666,I broke his surfboard.
5572,4510,1,12,69,82,1.170731707317073,0.045266376933577414,666,It's an alpha male test.
5592,4510,5,4,73,82,1.170731707317073,0.05703947203211162,666,"You just wait, its a little trick i learned from them"
5597,4510,1,12,69,82,1.170731707317073,0.045266376933577414,666,I’m saving him for tomorrow
5653,4510,2,10,70,82,1.170731707317073,0.048478438536580806,666,Wait till he posts a few selfies.
6016,4510,0,14,68,82,1.170731707317073,0.04180826184428594,666,Don't eat him. I want to keep my five-star rating.
5360,4510,2,10,70,82,1.170731707317073,0.048478438536580806,666,Uber's not all it's cracked up to be.
5969,4510,4,6,72,82,1.170731707317073,0.05433587440586293,666,"No, this is our new food delivery platform that makes getting great food as easy as getting a ride."
6023,4510,2,10,70,82,1.170731707317073,0.048478438536580806,666,I've picked up some seasonal work offering cruise ship excursions.
2585,4510,1,12,69,82,1.170731707317073,0.045266376933577414,666,It's the latest trend in extreme sports.
6246,4510,1,12,69,82,1.170731707317073,0.045266376933577414,666,Thinking that he is still aboard his Stand-up paddleboard?
6227,4510,2,10,70,82,1.170731707317073,0.048478438536580806,666,"Damn...I wish! But we can’t. Remember, we’re doing keto this week!"
6122,4510,2,10,70,82,1.170731707317073,0.048478438536580806,666,"It’s heavy, but it’s a find."
6083,4510,3,8,71,82,1.170731707317073,0.051490514905149054,666,"I know this bites, but with rising sea levels, we have to learn to coexist."
5828,4510,0,14,68,82,1.170731707317073,0.04180826184428594,666,I now identify as an emotional support Selachimorpha.
5813,4510,3,8,71,82,1.170731707317073,0.051490514905149054,666,Shark yoga. Beats chasing seals for a living.
5765,4510,1,12,69,82,1.170731707317073,0.045266376933577414,666,You wanna go get something to eat
5750,4510,1,12,69,82,1.170731707317073,0.045266376933577414,666,He's a verified rider and I could use the money.
5838,4510,2,10,70,82,1.170731707317073,0.048478438536580806,666,"It's something like Uber for swimmers. Pretty good pay, but they fire you if you eat a passenger."
5656,4510,2,10,70,82,1.170731707317073,0.048478438536580806,666,We bonded at Seaworld.
5359,4510,2,10,70,82,1.170731707317073,0.048478438536580806,666,"I’ll go ahead and have the legs, the breast is always dry."
5292,4510,1,12,69,82,1.170731707317073,0.045266376933577414,666,He doesn’t know about jumping the shark.
4495,4510,1,12,69,82,1.170731707317073,0.045266376933577414,666,I'll have the rest of him for lunch
4506,4510,3,8,71,82,1.170731707317073,0.051490514905149054,666,It's just not the same when we do it.
4538,4510,2,10,70,82,1.170731707317073,0.048478438536580806,666,Here is your UberEats delivery sir.
4547,4510,1,12,69,82,1.170731707317073,0.045266376933577414,666,75/25 or I’m outta here!
4599,4510,0,14,68,82,1.170731707317073,0.04180826184428594,666,"I’d bite him, but I’m trying to be my best self."
4651,4510,2,10,70,82,1.170731707317073,0.048478438536580806,666,Lifeguard interns are much too brazen these days.
4816,4510,1,12,69,82,1.170731707317073,0.045266376933577414,666,The line for poke bowl was too long so I finessed us some sashimi instead.
4829,4510,3,8,71,82,1.170731707317073,0.051490514905149054,666,"Yes, he's THAT Laird Hamilton."
4847,4510,3,8,71,82,1.170731707317073,0.051490514905149054,666,"I would bite him, but I’m not a fan of stereotypes."
4966,4510,3,8,71,82,1.170731707317073,0.051490514905149054,666,Trump's white guys can't jump!
5349,4510,2,10,70,82,1.170731707317073,0.048478438536580806,666,I started with goat yoga then moved on to surfer yoga.
4987,4510,1,12,69,82,1.170731707317073,0.045266376933577414,666,"What do you mean there is not enough meat on him?""  "" You said you wanted to start a low fat diet."
5040,4510,1,12,69,82,1.170731707317073,0.045266376933577414,666,"HEAVY meal ahead!"""
5091,4510,0,14,68,82,1.170731707317073,0.04180826184428594,666,He's my first Uber passenger.
5103,4510,1,12,69,82,1.170731707317073,0.045266376933577414,666,I got a 50% vig for this one
5138,4510,1,12,69,82,1.170731707317073,0.045266376933577414,666,My girlfriend wanted take-out.
5174,4510,2,10,70,82,1.170731707317073,0.048478438536580806,666,And they say Shark Fin hunting is illegal.
5203,4510,1,12,69,82,1.170731707317073,0.045266376933577414,666,Can you believe it? This guy keeps saying global warming is not a thing... this used to be his living room!
5207,4510,3,8,71,82,1.170731707317073,0.051490514905149054,666,"If you keep your fin underwater, I'll split him with you."
6276,4510,1,12,69,82,1.170731707317073,0.045266376933577414,666,"He says: ""When the water recedes they will see I have trunks on, but before that I need to swim with the sharks."" Also says I will get 10% commission, do you know what food that is?"
5245,4510,3,8,71,82,1.170731707317073,0.051490514905149054,666,Getting aboard the gig economy
5286,4510,0,14,68,82,1.170731707317073,0.04180826184428594,666,He has a 5 star rating but one more shark joke and he’s fuel .
5004,4510,1,12,69,82,1.170731707317073,0.045266376933577414,666,There's a sous-vide frenzy right now
2558,4510,2,10,70,82,1.170731707317073,0.048478438536580806,666,"It’s new business- 
a ride sharing."
5228,4510,2,10,70,82,1.170731707317073,0.048478438536580806,666,"The pay is lousy, but it’s the only summer job I could get."
2518,4510,1,12,69,82,1.170731707317073,0.045266376933577414,666,What? It's surge pricing.
584,4510,0,14,68,82,1.170731707317073,0.04180826184428594,666,"...And to think he took me for a spineless
jellyfish."
643,4510,3,8,71,82,1.170731707317073,0.051490514905149054,666,"There’s no medical, but I get to work my own hours."
674,4510,2,10,70,82,1.170731707317073,0.048478438536580806,666,"Don't look at me like that, it was a good gig for Shamu!"
702,4510,2,10,70,82,1.170731707317073,0.048478438536580806,666,"Listen, it's my job to follow orders and the mermaid princess said she wanted human legs."
704,4510,1,12,69,82,1.170731707317073,0.045266376933577414,666,Did you see the top half anywhere?
717,4510,2,10,70,82,1.170731707317073,0.048478438536580806,666,I’m elevating my cuisine.
754,4510,1,12,69,82,1.170731707317073,0.045266376933577414,666,Yeah I guess I'll miss him after I eat him.
765,4510,1,12,69,82,1.170731707317073,0.045266376933577414,666,Is this enough for dinner?
827,4510,1,12,69,82,1.170731707317073,0.045266376933577414,666,This ride-sharing gig I signed up for isn’t paying the dividends I expected.
850,4510,3,8,71,82,1.170731707317073,0.051490514905149054,666,"You see, dogs aren't the only ones that can do this trick."
855,4510,3,8,71,82,1.170731707317073,0.051490514905149054,666,How about a casual lunch?
885,4510,3,8,71,82,1.170731707317073,0.051490514905149054,666,I prefer breast meet.
899,4510,0,14,68,82,1.170731707317073,0.04180826184428594,666,I've been under a lot of pressure lately.
1022,4510,2,10,70,82,1.170731707317073,0.048478438536580806,666,I'm working part time for Uber Eats
1029,4510,1,12,69,82,1.170731707317073,0.045266376933577414,666,"I sim for uber a
few"
1054,4510,2,10,70,82,1.170731707317073,0.048478438536580806,666,Where is John Williams when you need him?
1116,4510,1,12,69,82,1.170731707317073,0.045266376933577414,666,Shark obedience school
1124,4510,2,10,70,82,1.170731707317073,0.048478438536580806,666,"I don't like this ""gig economy"" thing as much as I thought I would."
1138,4510,0,14,68,82,1.170731707317073,0.04180826184428594,666,Lyft was looking for divers and I needed the chub change
573,4510,3,8,71,82,1.170731707317073,0.051490514905149054,666,This generation really needs a Jaws remake.
1164,4510,3,8,71,82,1.170731707317073,0.051490514905149054,666,Don't you think I would take the legs if I knew how to walk?
564,4510,1,12,69,82,1.170731707317073,0.045266376933577414,666,"I’m too committed at this point so, no, I won’t go to dinner with you."
548,4510,1,12,69,82,1.170731707317073,0.045266376933577414,666,This new device gives me outside 360 degree vision.
2547,4510,2,10,70,82,1.170731707317073,0.048478438536580806,666,You’re welcome to the top half first.
24,4510,2,10,70,82,1.170731707317073,0.048478438536580806,666,"Do you remember, when I told you my new cleaner fish is a bit different?"
72,4510,1,12,69,82,1.170731707317073,0.045266376933577414,666,Wait! Look at the surprise on his face.
81,4510,2,10,70,82,1.170731707317073,0.048478438536580806,666,This overcrowding has got to stop.
116,4510,2,10,70,82,1.170731707317073,0.048478438536580806,666,Terry swears they’re more tender when they don’t see it coming.
156,4510,1,12,69,82,1.170731707317073,0.045266376933577414,666,The wife's busy. She told me to pick up delivery on the way home.
196,4510,0,14,68,82,1.170731707317073,0.04180826184428594,666,"Hey man, watch this trick."
201,4510,2,10,70,82,1.170731707317073,0.048478438536580806,666,It’s the new “functional fitness” trend
205,4510,2,10,70,82,1.170731707317073,0.048478438536580806,666,Little help?
276,4510,3,8,71,82,1.170731707317073,0.051490514905149054,666,This new ride-sharing job really helps put food on my table.
281,4510,0,14,68,82,1.170731707317073,0.04180826184428594,666,300 hours of court ordered community service.
285,4510,3,8,71,82,1.170731707317073,0.051490514905149054,666,"He thinks I'm a rock. A rock! Judy, do I look like a rock to you?"
359,4510,1,12,69,82,1.170731707317073,0.045266376933577414,666,Being in the gig economy sure beats chasing fish all day.
362,4510,2,10,70,82,1.170731707317073,0.048478438536580806,666,Since becoming a vegetarian I've been making a living as a surf board.
370,4510,4,6,72,82,1.170731707317073,0.05433587440586293,666,Flip a doubloon?
386,4510,2,10,70,82,1.170731707317073,0.048478438536580806,666,You’ve got to be careful. They often mistake us for surfboards.
406,4510,2,10,70,82,1.170731707317073,0.048478438536580806,666,"Sure, it's just like those other ride-share services, but in addition to earning a few extra bucks I can eat the day's last fare."
476,4510,1,12,69,82,1.170731707317073,0.045266376933577414,666,I'm bringing dinner to my in-laws'. I figured I'd bring fresh food.
513,4510,1,12,69,82,1.170731707317073,0.045266376933577414,666,It is important that you  accept  what  the  deer and the antelope played at  on the range!
555,4510,1,12,69,82,1.170731707317073,0.045266376933577414,666,I't's called Human yoga. We used to just eat them.
1165,4510,2,10,70,82,1.170731707317073,0.048478438536580806,666,I'm waiting patiently for him to jump the shark.
251,4510,2,10,70,82,1.170731707317073,0.048478438536580806,666,The lengths I have to go to get a good Ashiatsu massage!
2254,4510,2,10,70,82,1.170731707317073,0.048478438536580806,666,"He says its a symbiotic relationship, but I'd have to dive to test that."
1868,4510,3,8,71,82,1.170731707317073,0.051490514905149054,666,It's been one of those weeks.
1887,4510,1,12,69,82,1.170731707317073,0.045266376933577414,666,"He thinks it’s a cheap ride, but wait until he finds out about surge pricing."
1911,4510,1,12,69,82,1.170731707317073,0.045266376933577414,666,Human yoga.
1939,4510,3,8,71,82,1.170731707317073,0.051490514905149054,666,As fishing lures go... this is the best bobber yet.
1966,4510,2,10,70,82,1.170731707317073,0.048478438536580806,666,He's my snack for later.
2009,4510,2,10,70,82,1.170731707317073,0.048478438536580806,666,What would Beavis and Butthead do?
2018,4510,3,8,71,82,1.170731707317073,0.051490514905149054,666,I'm not convinced about becoming the new luxury inflatable pool toy.
2062,4510,2,10,70,82,1.170731707317073,0.048478438536580806,666,They don't do delivery in my zip code
2085,4510,3,8,71,82,1.170731707317073,0.051490514905149054,666,"But mom, I like to play with my food!"
2086,4510,3,8,71,82,1.170731707317073,0.051490514905149054,666,"Oh, he is so gonna get the shark and awe treatment."
2126,4510,1,12,69,82,1.170731707317073,0.045266376933577414,666,Lunch delivery for Mr. Fin.
2190,4510,1,12,69,82,1.170731707317073,0.045266376933577414,666,"It could be worse, I could be soup!"
2202,4510,2,10,70,82,1.170731707317073,0.048478438536580806,666,"Heads up, this guy is a bit peeved by the transfer delay."
2505,4510,2,10,70,82,1.170731707317073,0.048478438536580806,666,‘It just goes with being a dogfish.’
2480,4510,1,12,69,82,1.170731707317073,0.045266376933577414,666,My back is itchy
2212,4510,2,10,70,82,1.170731707317073,0.048478438536580806,666,I'm getting tired of this 'professional courtesy' thing -  he's my next meal.
2232,4510,0,14,68,82,1.170731707317073,0.04180826184428594,666,Now I know how it feels to be taken for a ride.
2419,4510,1,12,69,82,1.170731707317073,0.045266376933577414,666,Are you going to tell him or shall I?
2309,4510,2,10,70,82,1.170731707317073,0.048478438536580806,666,You know ice cream sales are up this month
1816,4510,1,12,69,82,1.170731707317073,0.045266376933577414,666,Fetish? I thought you said feetfish.
2355,4510,1,12,69,82,1.170731707317073,0.045266376933577414,666,The invitation said “potluck.”
1811,4510,2,10,70,82,1.170731707317073,0.048478438536580806,666,What can I say?  it’s a living.
1798,4510,3,8,71,82,1.170731707317073,0.051490514905149054,666,And this dude calls himself a surfer.
1240,4510,0,14,68,82,1.170731707317073,0.04180826184428594,666,"What, the legal intern? Just getting his feet wet."
1285,4510,0,14,68,82,1.170731707317073,0.04180826184428594,666,I’m gonna need a bigger stomach.
1307,4510,3,8,71,82,1.170731707317073,0.051490514905149054,666,"I found the legs to unappetizing, but know you'll eat anything!"
1345,4510,3,8,71,82,1.170731707317073,0.051490514905149054,666,"Hi, I’m your Uber"
1364,4510,2,10,70,82,1.170731707317073,0.048478438536580806,666,"I know it looks stupid, but working for Under helps me
 put more fish on the table."
1451,4510,2,10,70,82,1.170731707317073,0.048478438536580806,666,I thought I'd try a decoy.
1508,4510,0,14,68,82,1.170731707317073,0.04180826184428594,666,"Yeah, but he gives me five stars."
1522,4510,0,14,68,82,1.170731707317073,0.04180826184428594,666,"I like the whole massage aspect of it, but I'm getting hungry."
1801,4510,2,10,70,82,1.170731707317073,0.048478438536580806,666,"Got any ideas how I break it to him that I'm not a sand bar?


-- D. Parker, San Francisco"
2335,4510,1,12,69,82,1.170731707317073,0.045266376933577414,666,He's looking for a pair of fins. Any interest?
1629,4510,1,12,69,82,1.170731707317073,0.045266376933577414,666,I'll never do this Salomon Brothers internship thing again.
1633,4510,2,10,70,82,1.170731707317073,0.048478438536580806,666,The upper portion was yummy
1660,4510,2,10,70,82,1.170731707317073,0.048478438536580806,666,"Bothersome ?
Not at all. But if you want him,he is all yours."
1709,4510,3,8,71,82,1.170731707317073,0.051490514905149054,666,I feel like hrs just treading water. Should I just cut him off?
1710,4510,2,10,70,82,1.170731707317073,0.048478438536580806,666,Dinner AND toothpicks.
1717,4510,1,12,69,82,1.170731707317073,0.045266376933577414,666,I’m moonlighting as a water UBER. Ocean times are tougher than ever.
1783,4510,2,10,70,82,1.170731707317073,0.048478438536580806,666,If Shorty appears kiss him.
1564,4510,1,12,69,82,1.170731707317073,0.045266376933577414,666,These back massages don't last long enough!
5276,4702,2,11,75,88,1.1704545454545454,0.046343834769941326,666,A few extra bucks driving for Uber? Totally not worth it!
3613,4702,3,9,76,88,1.1704545454545454,0.049081402191026816,666,It's Caribbean Tai Chi.  We're working on cultivating stillness and improving balance.
2922,4704,1,16,89,106,1.169811320754717,0.03901689019197877,666,"The idiot, I told him to walk on water, not on me!"
342,4704,3,12,91,106,1.169811320754717,0.04337864404159322,666,"It's a ""take home"" dinner."
4662,4706,2,10,71,83,1.1686746987951808,0.04793495540400366,666,"On the upside, things are looking pretty well"
3397,4706,0,14,69,83,1.1686746987951808,0.04135266894703558,666,"It's called a foot massage, Phil. Like you've never had one."
3416,4706,3,8,72,83,1.1686746987951808,0.050907939556165197,666,"If 'Jaws' could make it big, why can't 'Upper Back?'"
3662,4706,3,8,72,83,1.1686746987951808,0.050907939556165197,666,"Somehow, I'm getting the loveliest back message."
3682,4706,2,10,71,83,1.1686746987951808,0.04793495540400366,666,"Well, they're all the rage in Surf City, and best of all, if I get hungry, they're edible."
3686,4706,2,10,71,83,1.1686746987951808,0.04793495540400366,666,Its a new sensor I am trying out
3843,4706,4,6,73,83,1.1686746987951808,0.053716633086265925,666,He still thinks he's in the kitty pool.
4038,4706,2,10,71,83,1.1686746987951808,0.04793495540400366,666,"He thinks he's on solid ground, but in a minute he won't have a leg to stand on."
4044,4706,1,12,70,83,1.1686746987951808,0.044764959391397526,666,They call it 'shurfing.'
4073,4706,2,10,71,83,1.1686746987951808,0.04793495540400366,666,Want to try a leg of lamb?
4081,4706,3,8,72,83,1.1686746987951808,0.050907939556165197,666,"I know, but it beats being an Uber driver."
4093,4706,1,12,70,83,1.1686746987951808,0.044764959391397526,666,"Ugh, millenials! Am I right?"
4310,4706,1,12,70,83,1.1686746987951808,0.044764959391397526,666,"No thank you, I'm full.  I'm saving this half for dinner."
4329,4706,2,10,71,83,1.1686746987951808,0.04793495540400366,666,It's called foot massage.  You really oughta try it.
4575,4706,3,8,72,83,1.1686746987951808,0.050907939556165197,666,It works great!  They never see you coming.
4593,4706,3,8,72,83,1.1686746987951808,0.050907939556165197,666,I hope he's a good tipper.
3390,4706,3,8,72,83,1.1686746987951808,0.050907939556165197,666,We only charge for a one-way ride
2929,4706,2,10,71,83,1.1686746987951808,0.04793495540400366,666,Beach Informant...
3379,4706,0,14,69,83,1.1686746987951808,0.04135266894703558,666,I picked him up off Cape Town. He thinks i'm taking him to New York.
3323,4706,2,10,71,83,1.1686746987951808,0.04793495540400366,666,"I can't eat him, he's going to vote for Trump"
2850,4706,3,8,72,83,1.1686746987951808,0.050907939556165197,666,"It's a quick hundo, so they can tell their friends they know how to water ski."
2987,4706,1,12,70,83,1.1686746987951808,0.044764959391397526,666,I call dibs.
2847,4706,1,12,70,83,1.1686746987951808,0.044764959391397526,666,I can't seem to get this monkey off my back
2833,4706,2,10,71,83,1.1686746987951808,0.04793495540400366,666,"Yeah, say what you want about the company, but I’m making good money with Uber Pool."
3064,4706,1,12,70,83,1.1686746987951808,0.044764959391397526,666,I think at this point it's too late to ask their name.
2669,4706,2,10,71,83,1.1686746987951808,0.04793495540400366,666,Edible?  You bet.
3088,4706,2,10,71,83,1.1686746987951808,0.04793495540400366,666,"You just bribe the skinny ones to lookout for the chubby ones.
He taps his foot twice when"
3154,4706,2,10,71,83,1.1686746987951808,0.04793495540400366,666,Is that you dear? Thanks for the foot massage.
3178,4706,1,12,70,83,1.1686746987951808,0.044764959391397526,666,This guy thinks he called an Uber.
3197,4706,1,12,70,83,1.1686746987951808,0.044764959391397526,666,Can you give me a lift?
3281,4706,1,12,70,83,1.1686746987951808,0.044764959391397526,666,Are you sure this is an outstanding meal?
3309,4706,1,12,70,83,1.1686746987951808,0.044764959391397526,666,I really want to eat him!
3321,4706,1,12,70,83,1.1686746987951808,0.044764959391397526,666,Wait knuckling it ‘til my gig’s done at Sea World
2649,4706,4,6,73,83,1.1686746987951808,0.053716633086265925,666,I am a breast man.
2531,4706,2,10,71,83,1.1686746987951808,0.04793495540400366,666,Sea World scout.
3363,4706,2,10,71,83,1.1686746987951808,0.04793495540400366,666,It's a new service called Lyft Shark.
4681,4706,0,14,69,83,1.1686746987951808,0.04135266894703558,666,I'm under foot. Can you give me a hand?
6301,4706,3,8,72,83,1.1686746987951808,0.050907939556165197,666,"Remind me again, why did we go vegan?"
4738,4706,1,12,70,83,1.1686746987951808,0.044764959391397526,666,It's a new Uber service. Helps pay the bills.
5745,4706,3,8,72,83,1.1686746987951808,0.050907939556165197,666,He has me on retainer.
5814,4706,2,10,71,83,1.1686746987951808,0.04793495540400366,666,I don't wanna let him down!
5868,4706,2,10,71,83,1.1686746987951808,0.04793495540400366,666,I already ate the torso. Do you want a leg or not?
5885,4706,2,10,71,83,1.1686746987951808,0.04793495540400366,666,But it feels so good.
5923,4706,2,10,71,83,1.1686746987951808,0.04793495540400366,666,"""Without the music, I get no respect"""
5929,4706,1,12,70,83,1.1686746987951808,0.044764959391397526,666,"Humans are friends, not food."
5944,4706,1,12,70,83,1.1686746987951808,0.044764959391397526,666,I guess it takes a couple of seasons to work up to jumping.
5692,4706,0,14,69,83,1.1686746987951808,0.04135266894703558,666,"Beep beep, George. It's peak hours."
5982,4706,3,8,72,83,1.1686746987951808,0.050907939556165197,666,Like my new hood ornament?
6166,4706,3,8,72,83,1.1686746987951808,0.050907939556165197,666,We don't get paid unless he wins.
2526,4706,2,10,71,83,1.1686746987951808,0.04793495540400366,666,How about a game of ping pong?
6247,4706,1,12,70,83,1.1686746987951808,0.044764959391397526,666,You can't see it but he's top heavy.
6285,4706,2,10,71,83,1.1686746987951808,0.04793495540400366,666,I hate it when I order the Prime Rib and I end up with Leg of Human.
6308,4706,2,10,71,83,1.1686746987951808,0.04793495540400366,666,But the water is warmer over here.
6302,4706,2,10,71,83,1.1686746987951808,0.04793495540400366,666,"With the diminishing food supply, I took a gig with Uber."
6291,4706,2,10,71,83,1.1686746987951808,0.04793495540400366,666,Piscine William Tell
6149,4706,1,12,70,83,1.1686746987951808,0.044764959391397526,666,Notes of gym sock infuse the robust bouquet of toe jam.
4710,4706,3,8,72,83,1.1686746987951808,0.050907939556165197,666,All I hear is blah blah blah....
5610,4706,4,6,73,83,1.1686746987951808,0.053716633086265925,666,"With rare exceptions,I skip the fiction."
5605,4706,2,10,71,83,1.1686746987951808,0.04793495540400366,666,"I told you, it's called the gig economy."
4749,4706,1,12,70,83,1.1686746987951808,0.044764959391397526,666,"When I was told that I was going surfing, this was not what I had in mind."
4767,4706,2,10,71,83,1.1686746987951808,0.04793495540400366,666,"We made a deal--I let him scratch my head, then I get rid of his bunions."""
4848,4706,1,12,70,83,1.1686746987951808,0.044764959391397526,666,The poor guy couldn't get an Uber.
4866,4706,1,12,70,83,1.1686746987951808,0.044764959391397526,666,"The koi say it’s big where they’re from, but frankly I’m just not feeling it."
4897,4706,1,12,70,83,1.1686746987951808,0.044764959391397526,666,It's part of the re-branding we started after Jaws.
5007,4706,0,14,69,83,1.1686746987951808,0.04135266894703558,666,My second cousin was a dolphin.
5081,4706,1,12,70,83,1.1686746987951808,0.044764959391397526,666,Jaws” therap
5606,4706,1,12,70,83,1.1686746987951808,0.044764959391397526,666,He’ll be fine. I prefer Manhattan Chowder over New England.
5117,4706,2,10,71,83,1.1686746987951808,0.04793495540400366,666,"He thinks he's on a park ride. My concept, lunch to go."
5398,4706,1,12,70,83,1.1686746987951808,0.044764959391397526,666,Close your eyes and make a wish.
5423,4706,2,10,71,83,1.1686746987951808,0.04793495540400366,666,Surfing is so last year dude. Say hello to sharfing.
5484,4706,1,12,70,83,1.1686746987951808,0.044764959391397526,666,My regular masseuse was booked.
5498,4706,0,14,69,83,1.1686746987951808,0.04135266894703558,666,I invited him out for dinner.  He said he has to fix his hair.
5499,4706,0,14,69,83,1.1686746987951808,0.04135266894703558,666,These mellinial parasites just won't move out.
5542,4706,0,14,69,83,1.1686746987951808,0.04135266894703558,666,This th-thing is c-c-cold.
5586,4706,1,12,70,83,1.1686746987951808,0.044764959391397526,666,"It's the gig economy, stupid!"
5280,4706,3,8,72,83,1.1686746987951808,0.050907939556165197,666,I’m down to bone on bone .
2503,4706,0,14,69,83,1.1686746987951808,0.04135266894703558,666,"What do you think, Marge? I picked it at Jaws's Secret; they had a special on head wear."""
3173,4706,0,14,69,83,1.1686746987951808,0.04135266894703558,666,Really? You think the bowler worked better?
2420,4706,2,10,71,83,1.1686746987951808,0.04793495540400366,666,My fitness coach says I need to get food off my mind.
927,4706,1,12,70,83,1.1686746987951808,0.044764959391397526,666,I wish he would replace his surfboard so I could taste a new one.
825,4706,1,12,70,83,1.1686746987951808,0.044764959391397526,666,Can I get a doggie shark baggie for the bottom half?
804,4706,5,4,74,83,1.1686746987951808,0.05638559240085067,666,"You know, one day at a time."
803,4706,4,6,73,83,1.1686746987951808,0.053716633086265925,666,I got the massage and lunch combo.
744,4706,3,8,72,83,1.1686746987951808,0.050907939556165197,666,Uber Sharking needs to implement a better dress code
734,4706,1,12,70,83,1.1686746987951808,0.044764959391397526,666,They're easy to capture with an adjustable-rate mortgage.
723,4706,2,10,71,83,1.1686746987951808,0.04793495540400366,666,He is really weighing in on our conversation.
689,4706,2,10,71,83,1.1686746987951808,0.04793495540400366,666,I'm Shark Weak
671,4706,1,12,70,83,1.1686746987951808,0.044764959391397526,666,Too soon...
642,4706,3,8,72,83,1.1686746987951808,0.050907939556165197,666,Sharfing
634,4706,1,12,70,83,1.1686746987951808,0.044764959391397526,666,This Uber gig is not good for my back.
627,4706,1,12,70,83,1.1686746987951808,0.044764959391397526,666,He's paying me in exposure.
580,4706,2,10,71,83,1.1686746987951808,0.04793495540400366,666,It sucks being a pet shark.
539,4706,0,14,69,83,1.1686746987951808,0.04135266894703558,666,I doubt he's seen Jaws.
518,4706,2,10,71,83,1.1686746987951808,0.04793495540400366,666,I’ m just working for SCUBER  until I get my degree
502,4706,2,10,71,83,1.1686746987951808,0.04793495540400366,666,"How do you do, fellow shark?"
483,4706,2,10,71,83,1.1686746987951808,0.04793495540400366,666,"Yes sir, would you like tonight’s hor doevre? We call it “lower half.”"
457,4706,3,8,72,83,1.1686746987951808,0.050907939556165197,666,Seen anything to eat?
453,4706,2,10,71,83,1.1686746987951808,0.04793495540400366,666,Say Finny
434,4706,3,8,72,83,1.1686746987951808,0.050907939556165197,666,Hey Tony...is there something on my back!
275,4706,1,12,70,83,1.1686746987951808,0.044764959391397526,666,There are advantages to being a sand shark.
261,4706,0,14,69,83,1.1686746987951808,0.04135266894703558,666,He says he's a Finn.
204,4706,2,10,71,83,1.1686746987951808,0.04793495540400366,666,Of course this will work!”
174,4706,1,12,70,83,1.1686746987951808,0.044764959391397526,666,Time to mingle and get a bite to eat.
120,4706,4,6,73,83,1.1686746987951808,0.053716633086265925,666,The best he can do is 24.99% APR.
111,4706,1,12,70,83,1.1686746987951808,0.044764959391397526,666,"Don't you just hate it, when people walk all over you"
2483,4706,0,14,69,83,1.1686746987951808,0.04135266894703558,666,I’m getting tired of these lawyers.
932,4706,0,14,69,83,1.1686746987951808,0.04135266894703558,666,"I'm trying to make up for all the bad rap we've gotten since that horrid movie with Richard Dreyfus, Roy Scheider and Robert Shaw."
937,4706,1,12,70,83,1.1686746987951808,0.044764959391397526,666,He is directing Shark Week this year.
614,4706,2,10,71,83,1.1686746987951808,0.04793495540400366,666,"Sorry, a couple of  heels held me up."
984,4706,1,12,70,83,1.1686746987951808,0.044764959391397526,666,It's like Uber but in the ocean.
2404,4706,1,12,70,83,1.1686746987951808,0.044764959391397526,666,"I know it's an aquarium, but I'm hungry."
970,4706,2,10,71,83,1.1686746987951808,0.04793495540400366,666,"Jumped the shark?  That's a thing.  Jumped on the shark, not so much."
2217,4706,2,10,71,83,1.1686746987951808,0.04793495540400366,666,you mean he isnt a remora?
2144,4706,3,8,72,83,1.1686746987951808,0.050907939556165197,666,It's from the new carry-out place on Washburn.
2117,4706,2,10,71,83,1.1686746987951808,0.04793495540400366,666,Does he understand?
2099,4706,2,10,71,83,1.1686746987951808,0.04793495540400366,666,"I said Eat Him , not Eastham. Besides, he's from Truro!"
2058,4706,3,8,72,83,1.1686746987951808,0.050907939556165197,666,"Honestly, it's not what it looks like.
Patricia Lewis, Alliston, ON"
1986,4706,1,12,70,83,1.1686746987951808,0.044764959391397526,666,"You can have him, I just had lunch."
1951,4706,1,12,70,83,1.1686746987951808,0.044764959391397526,666,"He tips well"""
1819,4706,1,12,70,83,1.1686746987951808,0.044764959391397526,666,I’m allergic to sunblock.  Bon appetit.
1800,4706,0,14,69,83,1.1686746987951808,0.04135266894703558,666,You up for a chicken fight? Winner eats all.
1513,4706,0,14,69,83,1.1686746987951808,0.04135266894703558,666,"To make matters worse, his feet smell!"
1503,4706,1,12,70,83,1.1686746987951808,0.044764959391397526,666,He promised I could be in his movie.
2229,4706,3,8,72,83,1.1686746987951808,0.050907939556165197,666,Do you want the top or bottom half this time?
1348,4706,2,10,71,83,1.1686746987951808,0.04793495540400366,666,I told you the stand-up comics are going to the sharks.
1434,4706,0,14,69,83,1.1686746987951808,0.04135266894703558,666,He will give me food if I take him across the Pacific
999,4706,1,12,70,83,1.1686746987951808,0.044764959391397526,666,He's taking testing the waters to a new level.
1142,4706,4,6,73,83,1.1686746987951808,0.053716633086265925,666,AirBnB. Covers half my mortgage.
1159,4706,1,12,70,83,1.1686746987951808,0.044764959391397526,666,Shark Week keeps me downtrodden. I don't get it.
1409,4706,2,10,71,83,1.1686746987951808,0.04793495540400366,666,I  wish he would jump this shark now.
1180,4706,2,10,71,83,1.1686746987951808,0.04793495540400366,666,I took a bite out of his surfboard. It was expensive.
1404,4706,0,14,69,83,1.1686746987951808,0.04135266894703558,666,"It doesn't pay much, but every little bit helps."
1397,4706,0,14,69,83,1.1686746987951808,0.04135266894703558,666,I'd rather have plastic
1255,4706,2,10,71,83,1.1686746987951808,0.04793495540400366,666,"Missed. 
Got the surf board
Have you seen him?"
1463,4706,2,10,71,83,1.1686746987951808,0.04793495540400366,666,My experiential concept will be a first on Shark Tank
1770,4841,3,11,87,101,1.1683168316831682,0.04465335557932548,666,Skinny is still tasty.
1586,4842,2,10,72,84,1.1666666666666667,0.047403413087928364,666,I am working on my lifesaving badge.
4099,4842,2,10,72,84,1.1666666666666667,0.047403413087928364,666,That aquarium gig is starting to look a helluva lot better
1658,4844,2,10,73,85,1.1647058823529413,0.046883426633143835,666,"It's my Carmen Miranda hat."""
3693,4845,1,11,67,79,1.1645569620253164,0.04568487714355834,666,Should we count this as an uber or an under ride?
3761,4845,2,9,68,79,1.1645569620253164,0.04910883774276407,666,That’s what happens when you get too friendly with them
3626,4845,1,11,67,79,1.1645569620253164,0.04568487714355834,666,The monkey on my back evolved.
2122,4845,3,7,69,79,1.1645569620253164,0.05230915683958439,666,Hunting in China it's way too easy...
3383,4845,2,9,68,79,1.1645569620253164,0.04910883774276407,666,Open wide and I will flip him!
3577,4845,2,9,68,79,1.1645569620253164,0.04910883774276407,666,It's a stupid human trick.
3886,4845,0,13,66,79,1.1645569620253164,0.04198259228297974,666,"The only parascope  I could find, on short notice."
3150,4845,1,11,67,79,1.1645569620253164,0.04568487714355834,666,This is just plain HUMILIATING!
2935,4845,3,7,69,79,1.1645569620253164,0.05230915683958439,666,Who the hell is William Tell?
2804,4845,2,9,68,79,1.1645569620253164,0.04910883774276407,666,Any Good Bites Today ? I have lunch ready see you around.
2740,4845,2,9,68,79,1.1645569620253164,0.04910883774276407,666,I’m not that hungry right now so I just got carry-out.
2651,4845,2,9,68,79,1.1645569620253164,0.04910883774276407,666,You can have the other half.  I’m stuffed!
3622,4845,1,11,67,79,1.1645569620253164,0.04568487714355834,666,Can you scratch my back? It feels itchy.
3945,4845,2,9,68,79,1.1645569620253164,0.04910883774276407,666,Sea Segway.
4742,4845,0,13,66,79,1.1645569620253164,0.04198259228297974,666,We're having a potluck over at the reef.
4558,4845,1,11,67,79,1.1645569620253164,0.04568487714355834,666,Did you remember the blood sausage for the appetizer course?
6079,4845,1,11,67,79,1.1645569620253164,0.04568487714355834,666,"Pity I'm not hungry. Are you, buddy?"
5785,4845,2,9,68,79,1.1645569620253164,0.04910883774276407,666,You're complaining to me about a load on your shoulders?
6137,4845,2,9,68,79,1.1645569620253164,0.04910883774276407,666,Don’t move. It’s Damien Hirst.
6212,4845,4,5,70,79,1.1645569620253164,0.0553246584633954,666,"If you are interested, the top 1/2 is a short swim behind me."
5762,4845,3,7,69,79,1.1645569620253164,0.05230915683958439,666,I've picked up an Uber Eats side gig.
5842,4845,2,9,68,79,1.1645569620253164,0.04910883774276407,666,"It's the latest in gnarly rides for boarders."""
6059,4845,0,13,66,79,1.1645569620253164,0.04198259228297974,666,He’s looking for investors
5438,4845,1,11,67,79,1.1645569620253164,0.04568487714355834,666,"I make my own hours, but they pay me a lot less than anticipated."
5137,4845,1,11,67,79,1.1645569620253164,0.04568487714355834,666,"Don’t move, looks like you’ve picked up a parasite"
5125,4845,2,9,68,79,1.1645569620253164,0.04910883774276407,666,"All odds aside, this guy is pushing it."
4858,4845,3,7,69,79,1.1645569620253164,0.05230915683958439,666,I told you I would bring dinner.
4843,4845,3,7,69,79,1.1645569620253164,0.05230915683958439,666,"Forgot to pack lunch? No problem, I'll share."
4688,4845,1,11,67,79,1.1645569620253164,0.04568487714355834,666,Look away!
4680,4845,2,9,68,79,1.1645569620253164,0.04910883774276407,666,The Republicans were right - this dude married me as soon as that Kennedy opinion was issued.
4675,4845,1,11,67,79,1.1645569620253164,0.04568487714355834,666,He’s my service human.
4143,4845,2,9,68,79,1.1645569620253164,0.04910883774276407,666,Let's wait for someone to come along to save this one! He feels too light to be a tasty treat!
1797,4845,3,7,69,79,1.1645569620253164,0.05230915683958439,666,"Daddy Shark, what should I do-do-do-do-do-do?"
2529,4845,1,11,67,79,1.1645569620253164,0.04568487714355834,666,He gives a pretty good back massage.
1471,4845,2,9,68,79,1.1645569620253164,0.04910883774276407,666,"The portion was so big that I could only eat half, so I decided to get the rest to go..."
1689,4845,1,11,67,79,1.1645569620253164,0.04568487714355834,666,The wife told me to bring something home.
233,4845,2,9,68,79,1.1645569620253164,0.04910883774276407,666,Why do you think they call us Sand Sharks?
266,4845,2,9,68,79,1.1645569620253164,0.04910883774276407,666,Right or left?
317,4845,2,9,68,79,1.1645569620253164,0.04910883774276407,666,"No,you cant keep him"
378,4845,4,5,70,79,1.1645569620253164,0.0553246584633954,666,and I thought I was the predator here.
117,4845,2,9,68,79,1.1645569620253164,0.04910883774276407,666,Can pilot fish hold 'Free Dolphin Ride' signs?
418,4845,2,9,68,79,1.1645569620253164,0.04910883774276407,666,It scares the locals less than the fin.
658,4845,1,11,67,79,1.1645569620253164,0.04568487714355834,666,"What say I pull down, you bite, and we split the difference?"
1004,4845,3,7,69,79,1.1645569620253164,0.05230915683958439,666,"Sure it's annoying, but I'll take it over dealing with my kids."
1294,4845,1,11,67,79,1.1645569620253164,0.04568487714355834,666,"I know, but he needed help keeping his head above water."
417,4845,3,7,69,79,1.1645569620253164,0.05230915683958439,666,«I think he got away...»
1563,4891,4,5,71,80,1.1625,0.054667435288411496,666,"If he sings ""Baby Shark"" one more time... 
I'm going to bite his Great White legs off."
3085,4891,2,9,69,80,1.1625,0.0485346998405017,666,I don’t know!  He said he voted for HRC and I guess I felt sorry for him.
2974,4891,2,9,69,80,1.1625,0.0485346998405017,666,That G***** genie.
2954,4891,2,9,69,80,1.1625,0.0485346998405017,666,"Then he said, “jump the shark!”"
2835,4891,2,9,69,80,1.1625,0.0485346998405017,666,"Don't give me that  ""gone soft"" look. He's just a replica."""
2832,4891,2,9,69,80,1.1625,0.0485346998405017,666,"Eh, I already ate his sister, so I'll leave this one alone."
1918,4891,3,7,70,80,1.1625,0.05169209596069913,666,I get why no one visits Greenwich
1985,4891,3,7,70,80,1.1625,0.05169209596069913,666,"Yes, I would...but I’m also ticklish.."
1875,4891,2,9,69,80,1.1625,0.0485346998405017,666,He paid me a fin to do this.
1582,4891,2,9,69,80,1.1625,0.0485346998405017,666,I don't know if I can keep doing this until lunch time.
3181,4891,2,9,69,80,1.1625,0.0485346998405017,666,I really don't care for the dark meat
1322,4891,1,11,68,80,1.1625,0.04515707466615905,666,Would you like a leg or a thigh?
3524,4891,2,9,69,80,1.1625,0.0485346998405017,666,Think of it as an upgraded remora.
4301,4891,2,9,69,80,1.1625,0.0485346998405017,666,His Mar A Laga reservation includes professional courtesy.
3915,4891,2,9,69,80,1.1625,0.0485346998405017,666,I'm waiting for him to hang ten. I love toe jam.
3961,4891,2,9,69,80,1.1625,0.0485346998405017,666,"You're the one with the foot fetish, bitch!"
4076,4891,2,9,69,80,1.1625,0.0485346998405017,666,"Meet Kevin, my new investment banker!"
1265,4891,1,11,68,80,1.1625,0.04515707466615905,666,So he insisted I'm the Lyft he ordered.
4406,4891,1,11,68,80,1.1625,0.04515707466615905,666,Maybe we have been shouldering humans for too long
4559,4891,2,9,69,80,1.1625,0.0485346998405017,666,So now maybe people will stop saying he jumped the shark.
4856,4891,2,9,69,80,1.1625,0.0485346998405017,666,"I'm honest.  I don't betray.  
I want to be helpful.  I can't eat him."
4881,4891,1,11,68,80,1.1625,0.04515707466615905,666,Welcome to the Anthropocene.
5131,4891,3,7,70,80,1.1625,0.05169209596069913,666,"So I said,""How am I supposed to get my take-out home without a plastic bag?!"""
5162,4891,2,9,69,80,1.1625,0.0485346998405017,666,"I was gonna eat em', but look at those toenails! Yeesh!"
5217,4891,0,13,67,80,1.1625,0.0415054899525657,666,I saved you half
5464,4891,3,7,70,80,1.1625,0.05169209596069913,666,When do you want dinner?
5841,4891,0,13,67,80,1.1625,0.0415054899525657,666,Tourists are so dumb...I even told him I was not the cuddly kind.
3742,4891,1,11,68,80,1.1625,0.04515707466615905,666,Wanna split it with me?
1207,4891,2,9,69,80,1.1625,0.0485346998405017,666,He's having a word with my upstairs neighbor.
2375,4891,1,11,68,80,1.1625,0.04515707466615905,666,Is this what they mean about being a Good Samaritan?
928,4891,2,9,69,80,1.1625,0.0485346998405017,666,"Do you believe in global warming now?"" - R shar"
873,4891,1,11,68,80,1.1625,0.04515707466615905,666,"I should have listened when Grandpa told me, 'Go deep young shark.'"
527,4891,3,7,70,80,1.1625,0.05169209596069913,666,I thought the Lakers would make the playoffs.
524,4891,0,13,67,80,1.1625,0.0415054899525657,666,I got 50% equity.
459,4891,2,9,69,80,1.1625,0.0485346998405017,666,I thought a marinade might be nice.
1067,4891,2,9,69,80,1.1625,0.0485346998405017,666,"So Nicole, do you want to share some lunch ?"
283,4891,3,7,70,80,1.1625,0.05169209596069913,666,You can take the legs. Save the breast for me.
5773,4928,1,12,74,87,1.160919540229885,0.04286443578566523,666,It's part of my Anger Management therapy.
4088,4928,4,6,77,87,1.160919540229885,0.05137396689286534,666,"I know it looks a little weird, but it’s great for working my Core."
4686,4928,3,8,76,87,1.160919540229885,0.048702939007284646,666,He’s keeping me under. I can’t breathe.
4122,4931,3,8,77,88,1.1590909090909092,0.04818102954737957,666,That UBER thing is actually pretty cool!
4186,4932,3,7,72,82,1.1585365853658536,0.050500393370146945,666,You'd be grumpy too if your food was playing with you.
4677,4932,2,9,71,82,1.1585365853658536,0.04742547425474254,666,"It's right behind me, right now, isn't it?"
5397,4932,0,13,69,82,1.1585365853658536,0.04058259927336568,666,I’m just happy that this idiot doesn’t know what happened the last person who thought I was a dolphin
5546,4932,1,11,70,82,1.1585365853658536,0.04413684952548057,666,"Life is moving by pretty fast at my age, I’m just trying to slow down, not stop of course, and smell the roses"
1460,4932,2,9,71,82,1.1585365853658536,0.04742547425474254,666,I should have listened when you told me not to sign up for Uber.
3710,4932,3,7,72,82,1.1585365853658536,0.050500393370146945,666,"He plays a great ""Jaws"" theme on his tuba."
4111,4932,2,9,71,82,1.1585365853658536,0.04742547425474254,666,"I'd ask you to spell me for awhile, but I'm afraid we're *all* sort of supporting them."
1200,4939,2,12,87,101,1.1584158415841583,0.04158415841584158,666,service with a smile
4397,4940,2,7,61,70,1.1571428571428573,0.05241858238033226,666,Next on ‘Shark Weak’
1840,4940,2,7,61,70,1.1571428571428573,0.05241858238033226,666,Just duck under and come with me.
319,4942,2,9,72,83,1.1566265060240963,0.04688951917827399,666,No I will not shake!! I might get ticket for contamination!!
536,4942,2,9,72,83,1.1566265060240963,0.04688951917827399,666,I’m not sure this human yoga is worth the effort.
3566,4942,2,9,72,83,1.1566265060240963,0.04688951917827399,666,SMS: Shark Massage Service
1597,4942,0,13,70,83,1.1566265060240963,0.04013614690312244,666,This obviously isn't how I thought things would work out.
4201,4946,1,10,66,77,1.155844155844156,0.04552772158797496,666,It's a useful prop.
3931,4946,1,10,66,77,1.155844155844156,0.04552772158797496,666,He is not my soul brother.
4225,4946,1,10,66,77,1.155844155844156,0.04552772158797496,666,It's the finals
4228,4946,2,8,67,77,1.155844155844156,0.04913793781438531,666,I call it UUber;  Underwater Uber.
4279,4946,2,8,67,77,1.155844155844156,0.04913793781438531,666,You needn't look so shagreened...Snooze Ya lose!
4294,4946,1,10,66,77,1.155844155844156,0.04552772158797496,666,But I just had a big breakfast!
4179,4946,0,12,65,77,1.155844155844156,0.04160540750111606,666,I thought a foot massage would be more relaxing.
3831,4946,3,6,68,77,1.155844155844156,0.0525004803055042,666,I told you last week: not until the app is fully operational!
4523,4946,1,10,66,77,1.155844155844156,0.04552772158797496,666,You want my leftovers?
3632,4946,0,12,65,77,1.155844155844156,0.04160540750111606,666,Toenail fungus relieves the sonar headaches
3591,4946,1,10,66,77,1.155844155844156,0.04552772158797496,666,What do I do? What do I do? He tried to jump the shark and missed.
3385,4946,2,8,67,77,1.155844155844156,0.04913793781438531,666,Should  I call his bluff?
3376,4946,0,12,65,77,1.155844155844156,0.04160540750111606,666,"I just feel like he weighs me down, you know?"
3368,4946,1,10,66,77,1.155844155844156,0.04552772158797496,666,"He's got ID showing he's a remora, but so far no benefit"
3322,4946,1,10,66,77,1.155844155844156,0.04552772158797496,666,I'm saving this one for desert.
3864,4946,1,10,66,77,1.155844155844156,0.04552772158797496,666,Talk about being drunk to the gills.
4597,4946,2,8,67,77,1.155844155844156,0.04913793781438531,666,"He's part of my PR campaign to show a softer side."""
5667,4946,1,10,66,77,1.155844155844156,0.04552772158797496,666,Don't bother. It probably tastes worse than it smells.
4626,4946,2,8,67,77,1.155844155844156,0.04913793781438531,666,I am a photographer. Food delivery is just a way of making a little extra.
5472,4946,2,8,67,77,1.155844155844156,0.04913793781438531,666,"Patience, Larry. Patience..."
5912,4946,1,10,66,77,1.155844155844156,0.04552772158797496,666,"To tell you the truth, I enjoyed my time as a surfboard a whole lot more!"
2982,4946,2,8,67,77,1.155844155844156,0.04913793781438531,666,"Finally, the appetizers are here!"
5893,4946,1,10,66,77,1.155844155844156,0.04552772158797496,666,The real trick is to lull them into complacency.
5980,4946,1,10,66,77,1.155844155844156,0.04552772158797496,666,Got a to-go lunch today.
6058,4946,0,12,65,77,1.155844155844156,0.04160540750111606,666,We get a bad reputation when we react to a stunt like this.
6286,4946,0,12,65,77,1.155844155844156,0.04160540750111606,666,I know this is beneath me but Spielberg promised me a SAG card.
5821,4946,1,10,66,77,1.155844155844156,0.04552772158797496,666,"Don't even think about it, Steve. He gives the best massages."
5471,4946,2,8,67,77,1.155844155844156,0.04913793781438531,666,It’s pronounced “ah-shee-at-soo”
5186,4946,2,8,67,77,1.155844155844156,0.04913793781438531,666,Jerry? Is that you? I didn't know you were driving for Uber now.
5173,4946,0,12,65,77,1.155844155844156,0.04160540750111606,666,He wants to ride the Gulf Stream before the Arctic thaws.
4951,4946,1,10,66,77,1.155844155844156,0.04552772158797496,666,"Here’s how we’re different, Carl..
I would rather have a slow and steady bucket of sardines after every ride."
4818,4946,1,10,66,77,1.155844155844156,0.04552772158797496,666,These massages just aren't doing anything for my stress anymore.
4781,4946,1,10,66,77,1.155844155844156,0.04552772158797496,666,So I get $15/hr plus tips...not a bad gig these days
4721,4946,2,8,67,77,1.155844155844156,0.04913793781438531,666,"Well, it pays better than Uber."""
4616,4946,1,10,66,77,1.155844155844156,0.04552772158797496,666,I can't stand humans.
2916,4946,0,12,65,77,1.155844155844156,0.04160540750111606,666,It's some kind of selfie thing.
5074,4946,2,8,67,77,1.155844155844156,0.04913793781438531,666,I'm a service shark and if he doesn't like my service I'll just eat him.
2791,4946,1,10,66,77,1.155844155844156,0.04552772158797496,666,"I ate his surfboard, and he said this was only fair."
10,4946,0,12,65,77,1.155844155844156,0.04160540750111606,666,"I know, but I have a bad toothache."
36,4946,2,8,67,77,1.155844155844156,0.04913793781438531,666,"Yes, they have takeaway."
405,4946,0,12,65,77,1.155844155844156,0.04160540750111606,666,"It's a new business venture. Uber,but for surfers."
557,4946,0,12,65,77,1.155844155844156,0.04160540750111606,666,"My doctor said I had high cholesterol, so I’ve had to go vegan."
680,4946,1,10,66,77,1.155844155844156,0.04552772158797496,666,Because they were out of top hats.
761,4946,2,8,67,77,1.155844155844156,0.04913793781438531,666,It's being widely reported as another great white supremacist sighting.
915,4946,2,8,67,77,1.155844155844156,0.04913793781438531,666,It helps him feel taller.
1176,4946,2,8,67,77,1.155844155844156,0.04913793781438531,666,This was not my dream.
1264,4946,1,10,66,77,1.155844155844156,0.04552772158797496,666,I like his spunk.
2814,4946,0,12,65,77,1.155844155844156,0.04160540750111606,666,He's pretty scrawny but I think he'll go well with tilapia.
1436,4946,2,8,67,77,1.155844155844156,0.04913793781438531,666,I reached my quota for attacking humans this summer.
1482,4946,1,10,66,77,1.155844155844156,0.04552772158797496,666,The head and torso are the most delicious parts of a human.
1515,4946,1,10,66,77,1.155844155844156,0.04552772158797496,666,"Let’s eat him Dave, he’s not gonna stand around on me forever,plus my back hurts."
879,4946,2,8,67,77,1.155844155844156,0.04913793781438531,666,"The Return of Jaws: ""Man, Just get off my head! I'm not a surfboard!"""
1542,4946,2,8,67,77,1.155844155844156,0.04913793781438531,666,"Careful, he's dangerous."
1518,4946,2,8,67,77,1.155844155844156,0.04913793781438531,666,I feel like the tortoise in B. C.
2569,4946,1,10,66,77,1.155844155844156,0.04552772158797496,666,"It's not a bad gig. I take him fishing, then take home 40% of what he catches."
2476,4946,2,8,67,77,1.155844155844156,0.04913793781438531,666,"Sure, but it'll make the eventual betrayal WAY more shareable."
2440,4946,1,10,66,77,1.155844155844156,0.04552772158797496,666,Tails! I won!
2428,4946,1,10,66,77,1.155844155844156,0.04552772158797496,666,"I don't like the fishy odor, you can have him."
2307,4946,1,10,66,77,1.155844155844156,0.04552772158797496,666,Looks like he still won't let Nancy cut his toenails. It's weird that she wants to but she's so hot I'd bone her in a second with my weird two-pronged shark dick. I'ma calling her right now for some surfer-and-turfer or some shit. She's gonna love it
2692,4946,0,12,65,77,1.155844155844156,0.04160540750111606,666,This is different?
2248,4946,2,8,67,77,1.155844155844156,0.04913793781438531,666,They have it bad enough up there already
2239,4946,0,12,65,77,1.155844155844156,0.04160540750111606,666,I ordered wings!
1930,4946,0,12,65,77,1.155844155844156,0.04160540750111606,666,"I can’t, I’m full."
1842,4946,0,12,65,77,1.155844155844156,0.04160540750111606,666,Don't you dare. He's scratching where it itches.
1777,4946,0,12,65,77,1.155844155844156,0.04160540750111606,666,"I know it's awkward, but only my weekly ashiatsu gets the kinks out."
3651,5011,1,10,67,78,1.1538461538461537,0.04498463524619038,666,"You want to tell him I'm not his surfboard, or should I?"
3667,5011,2,8,68,78,1.1538461538461537,0.048545007377001466,666,It’s Sir Isaac Newton. He thinks I’m a giant.
3705,5011,1,10,67,78,1.1538461538461537,0.04498463524619038,666,What do you want? It's my midnight snack.
3759,5011,0,12,66,78,1.1538461538461537,0.041117114140372994,666,I said we'd split dinner. I got my half - Yours seems to have swum away... Sorry.
3786,5011,3,6,69,78,1.1538461538461537,0.05186152788178786,666,Don't worry. He crashed through the surface where they can't hurt us.  We're far from the shallow now.
3809,5011,1,10,67,78,1.1538461538461537,0.04498463524619038,666,"It's shark week, and he's a bit of a camera hog."
3836,5011,3,6,69,78,1.1538461538461537,0.05186152788178786,666,"No need for a credit card, we have that on file!  Enjoy your dinner!"
3870,5011,0,12,66,78,1.1538461538461537,0.041117114140372994,666,Is that a monkey on my back?
3606,5011,2,8,68,78,1.1538461538461537,0.048545007377001466,666,I'm making Uber money...carol wants a fin job
3879,5011,2,8,68,78,1.1538461538461537,0.048545007377001466,666,It does not weigh as much on your conscience if it’s happy meat.
3956,5011,1,10,67,78,1.1538461538461537,0.04498463524619038,666,"And it's Miami Beach so he's still paying $6,000 a month"
3997,5011,0,12,66,78,1.1538461538461537,0.041117114140372994,666,I'm really not a fan of body-surfing
4004,5011,1,10,67,78,1.1538461538461537,0.04498463524619038,666,"Nah, brah... this helps both of us get chicks."
4040,5011,1,10,67,78,1.1538461538461537,0.04498463524619038,666,Stop circling and do me and the rest of the world a favor!”
3854,5011,1,10,67,78,1.1538461538461537,0.04498463524619038,666,"Oh, how the mighty have fallen."
3604,5011,1,10,67,78,1.1538461538461537,0.04498463524619038,666,Here's your Uber Eats lunch delivery.
2956,5011,1,10,67,78,1.1538461538461537,0.04498463524619038,666,"Uber, what about you?"
3574,5011,1,10,67,78,1.1538461538461537,0.04498463524619038,666,My doctor put me on a no-Republican diet
2845,5011,1,10,67,78,1.1538461538461537,0.04498463524619038,666,Ready to do the aquatic surprise routine on the count of three?
2918,5011,0,12,66,78,1.1538461538461537,0.041117114140372994,666,He thinks he is standing on a shark.
4087,5011,0,12,66,78,1.1538461538461537,0.041117114140372994,666,My father always told me I was a shoe.
3011,5011,1,10,67,78,1.1538461538461537,0.04498463524619038,666,"Yes, yes, I know, I've got a human on my back...what's new with you?"
3049,5011,1,10,67,78,1.1538461538461537,0.04498463524619038,666,"Since Shamu retired, I’ve been working on a ‘Jaws’ theme idea."
3126,5011,1,10,67,78,1.1538461538461537,0.04498463524619038,666,I decided to the the ride sharing thing a try
3583,5011,2,8,68,78,1.1538461538461537,0.048545007377001466,666,He's insisting I nibble on his feet — something about a pedicure.
3136,5011,1,10,67,78,1.1538461538461537,0.04498463524619038,666,What? I've always wanted to be in someone's selfie.
3310,5011,2,8,68,78,1.1538461538461537,0.048545007377001466,666,That “Baby Shark” song has really ruined our reputation.
3418,5011,2,8,68,78,1.1538461538461537,0.048545007377001466,666,He told me his name was Remora.
3456,5011,1,10,67,78,1.1538461538461537,0.04498463524619038,666,Is this bro trying to do “ toes on the nose” board tricks?
3460,5011,2,8,68,78,1.1538461538461537,0.048545007377001466,666,"Who should break it to him, you or I?"
3510,5011,1,10,67,78,1.1538461538461537,0.04498463524619038,666,"Don’t be embarrassed man, everyone’s  working for a rideshare these days."
3531,5011,1,10,67,78,1.1538461538461537,0.04498463524619038,666,It's distantly related to having a monkey on your back.
3208,5011,0,12,66,78,1.1538461538461537,0.041117114140372994,666,This is how Uber got started.
4236,5011,1,10,67,78,1.1538461538461537,0.04498463524619038,666,"Damned if I know,but I did hear someone call him Fonz."
4985,5011,1,10,67,78,1.1538461538461537,0.04498463524619038,666,It was only supposed to be a part time gig.
4344,5011,1,10,67,78,1.1538461538461537,0.04498463524619038,666,"I'm afraid this one is shaken, not stirred."
5575,5011,1,10,67,78,1.1538461538461537,0.04498463524619038,666,uber made me an offer I couldnt refuse
5639,5011,1,10,67,78,1.1538461538461537,0.04498463524619038,666,"If he yells 'Cowabunga' one more time, I'm quitting."
5766,5011,2,8,68,78,1.1538461538461537,0.048545007377001466,666,My Broker says the housing market is getting weak.
5847,5011,1,10,67,78,1.1538461538461537,0.04498463524619038,666,"You know the old saying, Monkey on your back?"
5993,5011,0,12,66,78,1.1538461538461537,0.041117114140372994,666,I wish he'd get off my back about Shark Week.
5996,5011,0,12,66,78,1.1538461538461537,0.041117114140372994,666,Let’s take a deep dive and see if he can tread water.
5539,5011,1,10,67,78,1.1538461538461537,0.04498463524619038,666,"I love him, but I'm tired of doing all the heavy lifting in our relationship"
6012,5011,0,12,66,78,1.1538461538461537,0.041117114140372994,666,"Back off, I’m his surf board!"
6162,5011,3,6,69,78,1.1538461538461537,0.05186152788178786,666,My chiropractor recommended it.
6179,5011,3,6,69,78,1.1538461538461537,0.05186152788178786,666,"It's like Uber, but for surfboards."
6264,5011,0,12,66,78,1.1538461538461537,0.041117114140372994,666,"It's a new form of massage...""Shiarktsu"""
6270,5011,1,10,67,78,1.1538461538461537,0.04498463524619038,666,This way I burn off 300 calories before dinner.
6279,5011,2,8,68,78,1.1538461538461537,0.048545007377001466,666,"I am Aquaman’s personal chauffeur, not an Uber driver."
6295,5011,0,12,66,78,1.1538461538461537,0.041117114140372994,666,"Ok, I know the Sharks aren't the killers we think they are campaign is working well, but this is taking out too far."
6132,5011,1,10,67,78,1.1538461538461537,0.04498463524619038,666,It’s a brand thing:  deep-six that stigma of “A shark of lawyers” with “A stand of sharks.”
5422,5011,2,8,68,78,1.1538461538461537,0.048545007377001466,666,Of course I'm chagrined.
5416,5011,0,12,66,78,1.1538461538461537,0.041117114140372994,666,He's showing me how to be an apex predator.
5389,5011,2,8,68,78,1.1538461538461537,0.048545007377001466,666,"This back massage sucks, I wish I was six feet under."
4361,5011,3,6,69,78,1.1538461538461537,0.05186152788178786,666,Professional courtesy - he
4451,5011,1,10,67,78,1.1538461538461537,0.04498463524619038,666,"OK, we can share, but he's kinda skinny so I get the first bite."
4470,5011,2,8,68,78,1.1538461538461537,0.048545007377001466,666,I'm an Uber Diver now.
4490,5011,1,10,67,78,1.1538461538461537,0.04498463524619038,666,"Embarrassed, this is nothing, you should see me when I have to pull the kids around!"
4550,5011,0,12,66,78,1.1538461538461537,0.041117114140372994,666,"But when you're a Jet, you're a Jet all the way."
4587,5011,2,8,68,78,1.1538461538461537,0.048545007377001466,666,Fin massages are so underrated.
4752,5011,1,10,67,78,1.1538461538461537,0.04498463524619038,666,I feel bad for surfboards.
4773,5011,1,10,67,78,1.1538461538461537,0.04498463524619038,666,I'm always on the lookout for a balanced meal.
4887,5011,3,6,69,78,1.1538461538461537,0.05186152788178786,666,Uber is expanding again.
4908,5011,1,10,67,78,1.1538461538461537,0.04498463524619038,666,"He's my therapist. Weird as it sounds, my back does feel better."
4913,5011,1,10,67,78,1.1538461538461537,0.04498463524619038,666,First picture of Uber's expansion into ocean travel.
2780,5011,4,4,70,78,1.1538461538461537,0.05497834489354689,666,He's my lawyer. We can't eat our own kind.
5034,5011,0,12,66,78,1.1538461538461537,0.041117114140372994,666,"Coming unprepared to the Shark Tank, yet expecting help?
He’ll soon not have a leg to stand on!"
5090,5011,2,8,68,78,1.1538461538461537,0.048545007377001466,666,"Is it me, or do they seem preoccupied lately ?
Kevin Collins, Cleveland, Ohio"
5168,5011,3,6,69,78,1.1538461538461537,0.05186152788178786,666,He’s ours! Just play good carp.. ..bad carp
4267,5011,1,10,67,78,1.1538461538461537,0.04498463524619038,666,"I know I should bite his leg off, and I will as soon as he’s finished this amazing massage."
2776,5011,0,12,66,78,1.1538461538461537,0.041117114140372994,666,Uber Swim. Just doin’ it a bit on weekends.
2881,5011,1,10,67,78,1.1538461538461537,0.04498463524619038,666,"Just waiting for him to coax in the Mrs.  That's when
they learn there's no free ride."
2605,5011,1,10,67,78,1.1538461538461537,0.04498463524619038,666,The fin doesn't scare them anymore--they think their kids are playing--so I decided to wear half a body. It works every time.
1174,5011,1,10,67,78,1.1538461538461537,0.04498463524619038,666,"I've had a heavy day, I'm not in the mood!"
1143,5011,2,8,68,78,1.1538461538461537,0.048545007377001466,666,"It's called 'human yoga'."""
1099,5011,2,8,68,78,1.1538461538461537,0.048545007377001466,666,I thought we could use this part like a wish bone.
1087,5011,1,10,67,78,1.1538461538461537,0.04498463524619038,666,"Ya, it’s a pain but it pays the rent."
749,5011,1,10,67,78,1.1538461538461537,0.04498463524619038,666,I’m a wildly successful UberEats driver.
727,5011,1,10,67,78,1.1538461538461537,0.04498463524619038,666,Can I get a doggie bag for this?
706,5011,3,6,69,78,1.1538461538461537,0.05186152788178786,666,It's camp
678,5011,1,10,67,78,1.1538461538461537,0.04498463524619038,666,"What did you want me to do, they ran out of doggy bags?!"
585,5011,1,10,67,78,1.1538461538461537,0.04498463524619038,666,This is the closest he gets to owning sharkskin boots.
525,5011,0,12,66,78,1.1538461538461537,0.041117114140372994,666,I’m saving that for snack.
496,5011,2,8,68,78,1.1538461538461537,0.048545007377001466,666,We just cut off the legs and make a soup out of it.
480,5011,1,10,67,78,1.1538461538461537,0.04498463524619038,666,Only if I get the top half.
441,5011,0,12,66,78,1.1538461538461537,0.041117114140372994,666,Delivery in 30 minutes or it's free!
1197,5011,1,10,67,78,1.1538461538461537,0.04498463524619038,666,If can’t eat’m enjoy’m
422,5011,0,12,66,78,1.1538461538461537,0.041117114140372994,666,"Ever since I stopped eating them, I get the best massages."
311,5011,2,8,68,78,1.1538461538461537,0.048545007377001466,666,"Baby shark, doo doo doo doo doo doo..."
302,5011,1,10,67,78,1.1538461538461537,0.04498463524619038,666,I lost my appetite at Sea World.
2688,5011,1,10,67,78,1.1538461538461537,0.04498463524619038,666,Some people will  do anything to walk on water
260,5011,1,10,67,78,1.1538461538461537,0.04498463524619038,666,It’s called Uber.
243,5011,2,8,68,78,1.1538461538461537,0.048545007377001466,666,Working for Scuber in early retirement.
191,5011,1,10,67,78,1.1538461538461537,0.04498463524619038,666,"Thing is, he knows if I stop I'll die."
190,5011,0,12,66,78,1.1538461538461537,0.041117114140372994,666,I’ll eat him after he straightens out my back.
189,5011,0,12,66,78,1.1538461538461537,0.041117114140372994,666,They must have over-estimated the Mariana Trench
181,5011,1,10,67,78,1.1538461538461537,0.04498463524619038,666,I'm picking up some extra cash being an Uber-swimmer.
101,5011,1,10,67,78,1.1538461538461537,0.04498463524619038,666,I picked the wrong week to go vegan.
99,5011,0,12,66,78,1.1538461538461537,0.041117114140372994,666,"...it’s a reliable gig, two days a week."
55,5011,1,10,67,78,1.1538461538461537,0.04498463524619038,666,His toenails need trimming.
39,5011,2,8,68,78,1.1538461538461537,0.048545007377001466,666,hey are you holding?
376,5011,0,12,66,78,1.1538461538461537,0.041117114140372994,666,"If he gets away, he'll need arch supports."
1269,5011,1,10,67,78,1.1538461538461537,0.04498463524619038,666,"After I passed the Uber background check, I figured why not?  He better give me 5 stars."
284,5011,4,4,70,78,1.1538461538461537,0.05497834489354689,666,"I'm introducing a new ride sharing service called ""Unter."""
2294,5011,0,12,66,78,1.1538461538461537,0.041117114140372994,666,I really miss my Remora Fish.
1279,5011,0,12,66,78,1.1538461538461537,0.041117114140372994,666,Times like these make it almost impossible to keep up my juice cleanse.
2599,5011,1,10,67,78,1.1538461538461537,0.04498463524619038,666,Do you like my hat?
2515,5011,0,12,66,78,1.1538461538461537,0.041117114140372994,666,"I assume they've got everything sorted out above the waves, because they sure don't make much sense below them."
2486,5011,2,8,68,78,1.1538461538461537,0.048545007377001466,666,His Toe nails are Gross!
2258,5011,2,8,68,78,1.1538461538461537,0.048545007377001466,666,I volunteer with The Ocean Conservancy.
2257,5011,1,10,67,78,1.1538461538461537,0.04498463524619038,666,My Physical Therapist says I need this 30 minutes a day for the next 3 weeks.
2237,5011,2,8,68,78,1.1538461538461537,0.048545007377001466,666,I told you that you were shallow.
2179,5011,1,10,67,78,1.1538461538461537,0.04498463524619038,666,Want to play hopscotch?
2170,5011,2,8,68,78,1.1538461538461537,0.048545007377001466,666,It’s the new refined frenzy: Shiatsu plus dessert.
2061,5011,1,10,67,78,1.1538461538461537,0.04498463524619038,666,"I thought this day would never end, anyway this guy needs to be at Martha’s Vineyard by 4pm."
2055,5011,0,12,66,78,1.1538461538461537,0.041117114140372994,666,It's my emergency survival kit.
1971,5011,1,10,67,78,1.1538461538461537,0.04498463524619038,666,"First ectoparasites, then remoras, now this."
1932,5011,1,10,67,78,1.1538461538461537,0.04498463524619038,666,"Don't attack, he's promised a Jaws 5"
1925,5011,1,10,67,78,1.1538461538461537,0.04498463524619038,666,"I thought jumping the shark would hurt, but y'know it's more like a massage."
2110,5011,0,12,66,78,1.1538461538461537,0.041117114140372994,666,He won this 'experience' at a charity auction.
1881,5011,1,10,67,78,1.1538461538461537,0.04498463524619038,666,"Hey, I just heard that the new California State University Long Beach mascot is THE shark!"
1821,5011,3,6,69,78,1.1538461538461537,0.05186152788178786,666,Have you seen my latest move? Watch this soar to this surface.
1741,5011,1,10,67,78,1.1538461538461537,0.04498463524619038,666,"You win heads, I win tails."
1721,5011,0,12,66,78,1.1538461538461537,0.041117114140372994,666,Doesn’t he know what we represent!
1323,5011,2,8,68,78,1.1538461538461537,0.048545007377001466,666,"Shall we tell him first, or just...?"
1602,5011,2,8,68,78,1.1538461538461537,0.048545007377001466,666,This guy thinks he's standing on a surfboard.  Would you please disabuse him of the notion?
1590,5011,0,12,66,78,1.1538461538461537,0.041117114140372994,666,Ugh I know but we now live in a gig economy.
1578,5011,0,12,66,78,1.1538461538461537,0.041117114140372994,666,"He's my chiropractor, back off."
1556,5011,1,10,67,78,1.1538461538461537,0.04498463524619038,666,How can they be scared of our teeth with toenails like this?
1526,5011,1,10,67,78,1.1538461538461537,0.04498463524619038,666,I had to take a second job with Lyft to afford the rent.
1507,5011,2,8,68,78,1.1538461538461537,0.048545007377001466,666,"I’d hate to spoil it for him, but this guy’s looking for Westeros on his GPS."
1921,5011,3,6,69,78,1.1538461538461537,0.05186152788178786,666,"Rock, Paper, Scissors for who gets him!"
1402,5011,2,8,68,78,1.1538461538461537,0.048545007377001466,666,I just wish he'd get off my back.
1426,5011,1,10,67,78,1.1538461538461537,0.04498463524619038,666,"We each pull on a leg, and the one with the larger piece makes a wish."
5201,5145,1,13,84,98,1.153061224489796,0.03932964692106888,666,There's one in every crowd.
908,5146,2,9,74,85,1.1529411764705881,0.04585289580871799,666,The future of transportation is ridesharking.
1828,5147,2,7,63,72,1.1527777777777777,0.051044344702082634,666,I've maimed so many l've lost interest.
2390,5147,2,7,63,72,1.1527777777777777,0.051044344702082634,666,I need to get a bigger back.
399,5149,1,10,68,79,1.1518987341772151,0.04445423524410439,666,You think I should let him know?
2024,5149,1,10,68,79,1.1518987341772151,0.04445423524410439,666,"Yeah, I'm hungry, but this is just too easy."
2843,5151,3,5,65,73,1.1506849315068493,0.05402812587305586,666,"You were at my wedding, Denise..."
3980,5152,1,9,64,74,1.1486486486486487,0.04586747660388901,666,I already ate his surf board.
4275,5152,1,9,64,74,1.1486486486486487,0.04586747660388901,666,So you're the left shark that messed everything up at the Superbowl huh?  Humans are still riding this four years later...
3871,5152,1,9,64,74,1.1486486486486487,0.04586747660388901,666,I knew the Uber concept wouldn't work down here
3719,5152,3,5,66,74,1.1486486486486487,0.053331903246550814,666,They tell me it works with ducks.
3189,5152,1,9,64,74,1.1486486486486487,0.04586747660388901,666,"I promised him a short ride for a few fish, but he won’t get off!"
4017,5152,2,7,65,74,1.1486486486486487,0.04973991010198834,666,"Remember, we talked about sharing. I'll slowly dro..."
4095,5152,2,7,65,74,1.1486486486486487,0.04973991010198834,666,I disrupting ocean travel.
5754,5152,1,9,64,74,1.1486486486486487,0.04586747660388901,666,A tale of two heads.
3147,5152,0,11,63,74,1.1486486486486487,0.04163642831779319,666,I saved the dark meat for you.
2793,5152,1,9,64,74,1.1486486486486487,0.04586747660388901,666,"Yes, I've heard of  'jumping the shark'; but 'on the shark'? Reality show desperation if you ask me."
2652,5152,2,7,65,74,1.1486486486486487,0.04973991010198834,666,Ashiatsu barefoot massage. What are you having done?
2614,5152,2,7,65,74,1.1486486486486487,0.04973991010198834,666,"If you turn this upside-down, YOU'RE impossible!"
2491,5152,1,9,64,74,1.1486486486486487,0.04586747660388901,666,"It's a Faustian Bargain--after he wins the gold for synchronized swimming, I get to eat him"
2490,5152,0,11,63,74,1.1486486486486487,0.04163642831779319,666,"A new plastic free thrill. You'll see, it's a win win!"
2454,5152,5,1,68,74,1.1486486486486487,0.059872851926316396,666,I think it's high time we make a movie about how humans have stood on us for years. They make plenty of movies about us.
4314,5152,2,7,65,74,1.1486486486486487,0.04973991010198834,666,It's the new Uber and it doesn't matter if the riders disappear.
3186,5152,1,9,64,74,1.1486486486486487,0.04586747660388901,666,Have you ever heard of peaceful coexistence? How about three star Michelin chef?
4318,5152,1,9,64,74,1.1486486486486487,0.04586747660388901,666,"Get the net ready, here they come."
6060,5152,2,7,65,74,1.1486486486486487,0.04973991010198834,666,"It’s called Ashiatsu, a Japanese form of deep tissue foot massage, seeking to balance the yin and the yang.."
4508,5152,3,5,66,74,1.1486486486486487,0.053331903246550814,666,I’m waiting tables until I hear back about that role I’m up for in the next “Jaws” sequel
5654,5152,2,7,65,74,1.1486486486486487,0.04973991010198834,666,His business plan shark tanked!
5642,5152,2,7,65,74,1.1486486486486487,0.04973991010198834,666,Are you going to date him or eat him...
2418,5152,1,9,64,74,1.1486486486486487,0.04586747660388901,666,The human footprint is closer that I realized!
5792,5152,1,9,64,74,1.1486486486486487,0.04586747660388901,666,"I forgot our what you taught me.  ``Lend them $1,000, you own them.  Lend them $10 million, they own you.''  Alas!"
5830,5152,1,9,64,74,1.1486486486486487,0.04586747660388901,666,They say the adaptable survive.
5856,5152,1,9,64,74,1.1486486486486487,0.04586747660388901,666,I know it looks weird but you wouldn’t believe it’s a reception
6199,5152,1,9,64,74,1.1486486486486487,0.04586747660388901,666,Why don't we Eskimo kiss and move on
6211,5152,2,7,65,74,1.1486486486486487,0.04973991010198834,666,"Oh, that’s Finn."
6303,5152,3,5,66,74,1.1486486486486487,0.053331903246550814,666,We lost in surfboard litigation
5278,5152,1,9,64,74,1.1486486486486487,0.04586747660388901,666,Surf's Up???
5190,5152,0,11,63,74,1.1486486486486487,0.04163642831779319,666,Don't even think it...or you're shark bait!
4950,5152,1,9,64,74,1.1486486486486487,0.04586747660388901,666,........or do you prefer chocolate?
4912,5152,1,9,64,74,1.1486486486486487,0.04586747660388901,666,This guy says we are under arrest for being loan sharks.
4756,5152,2,7,65,74,1.1486486486486487,0.04973991010198834,666,Weird flex but okay.
4664,5152,1,9,64,74,1.1486486486486487,0.04586747660388901,666,The gig economy is hell on my back.
4654,5152,1,9,64,74,1.1486486486486487,0.04586747660388901,666,It looked a lot easier in “Jaws.”
4571,5152,0,11,63,74,1.1486486486486487,0.04163642831779319,666,He's such a dick.
4457,5152,1,9,64,74,1.1486486486486487,0.04586747660388901,666,I can't be bothered
2410,5152,1,9,64,74,1.1486486486486487,0.04586747660388901,666,He just wants me for his Jesus shoes.
2423,5152,1,9,64,74,1.1486486486486487,0.04586747660388901,666,"I know it's bad for you, but I can't resist carryout"
2377,5152,0,11,63,74,1.1486486486486487,0.04163642831779319,666,Baby shark kids all grown now!
214,5152,1,9,64,74,1.1486486486486487,0.04586747660388901,666,"If we eat him now, we will have to spend an hour without swimming later"
270,5152,1,9,64,74,1.1486486486486487,0.04586747660388901,666,I'm getting bikini-ready for the summer.
292,5152,1,9,64,74,1.1486486486486487,0.04586747660388901,666,"Yo bro, am I dreaming or is there some white dude standing on my head."
438,5152,1,9,64,74,1.1486486486486487,0.04586747660388901,666,I'm saving the rest for the NBA Finals
645,5152,2,7,65,74,1.1486486486486487,0.04973991010198834,666,He's my dentist. I have bills.
735,5152,1,9,64,74,1.1486486486486487,0.04586747660388901,666,"Too skiny, doesn't worth the effort. Waiting him to drop into my mouth"
792,5152,2,7,65,74,1.1486486486486487,0.04973991010198834,666,Technically I'm an Uber Pool independent contractor.
893,5152,1,9,64,74,1.1486486486486487,0.04586747660388901,666,It's a new community initiative
918,5152,0,11,63,74,1.1486486486486487,0.04163642831779319,666,I'm starting a ceding frenzy.
985,5152,1,9,64,74,1.1486486486486487,0.04586747660388901,666,How long are you gonna make me balance this before I can eat it?
1172,5152,1,9,64,74,1.1486486486486487,0.04586747660388901,666,"If my agent doesn't upgrade me from this carnival show to a Shark Week spot, I'm going to eat him alive."
1258,5152,3,5,66,74,1.1486486486486487,0.053331903246550814,666,I'm not in a play. I have to really break a leg.
1410,5152,2,7,65,74,1.1486486486486487,0.04973991010198834,666,He knows about our affair and demands payment in bitcoins.
1439,5152,0,11,63,74,1.1486486486486487,0.04163642831779319,666,Man to Man.  You lose!
982,5152,1,9,64,74,1.1486486486486487,0.04586747660388901,666,"He mentioned something about white privilege, and I don't even know what that is. Yet, here we are."
1661,5152,0,11,63,74,1.1486486486486487,0.04163642831779319,666,Go on 3. 1 2 ...
2344,5152,2,7,65,74,1.1486486486486487,0.04973991010198834,666,"It's my lucky lure; caught me a 290 lb. one last week. Too fatty to eat, but looks awesome hanging above my mantle."
2311,5152,0,11,63,74,1.1486486486486487,0.04163642831779319,666,"I feel guilty, he looked so happy when he stepped ""on that stone""."
1650,5152,2,7,65,74,1.1486486486486487,0.04973991010198834,666,"I try to do my bit for species preservation, especially when I'm not hungry."
2027,5152,0,11,63,74,1.1486486486486487,0.04163642831779319,666,"Don’t look up, Frank.
The Lord is testing our commitment to Veganuary."
1935,5152,1,9,64,74,1.1486486486486487,0.04586747660388901,666,Now I hope this will teach you never to bite inflatable whales you don’t know!
1917,5152,2,7,65,74,1.1486486486486487,0.04973991010198834,666,Surf’s down.
2397,5152,1,9,64,74,1.1486486486486487,0.04586747660388901,666,I'd say Bobby Darin is out of his depth.
2194,5152,3,5,66,74,1.1486486486486487,0.053331903246550814,666,I find that the fin just scares them away.
1862,5152,1,9,64,74,1.1486486486486487,0.04586747660388901,666,Ugh I’ve got snort-I mean legs sticking on by the snort that slips down your spine all wriggly like how’s the kids?
1815,5152,0,11,63,74,1.1486486486486487,0.04163642831779319,666,We know you're guilty. Now tell us how you did it.
1758,5152,0,11,63,74,1.1486486486486487,0.04163642831779319,666,The other kids laugh at him if he uses floaties.
1674,5152,0,11,63,74,1.1486486486486487,0.04163642831779319,666,He's no George Jefferson. But he'll do for now.
568,5221,1,11,76,88,1.1477272727272727,0.041332851083640286,666,lets show him some real shark fin soup
1666,5222,2,7,66,75,1.1466666666666667,0.049112238922818546,666,"Not tonight, darling, I have a bad headache."
2167,5222,2,7,66,75,1.1466666666666667,0.049112238922818546,666,"Steve and I were really looking forward to Spades night, but someone had to go and eat his partner, didn't he?"
2499,5222,1,9,65,75,1.1466666666666667,0.045295161459604626,666,I have a terrible headache.
2644,5222,2,7,66,75,1.1466666666666667,0.049112238922818546,666,You or me? Or should we skip the appetizer and go for a main course later?
2797,5222,2,7,66,75,1.1466666666666667,0.049112238922818546,666,Have you eaten yet?  I ordered take out.
3377,5222,2,7,66,75,1.1466666666666667,0.049112238922818546,666,White guys are friends not food.
3764,5222,2,7,66,75,1.1466666666666667,0.049112238922818546,666,I finally grew a pair.
5632,5222,2,7,66,75,1.1466666666666667,0.049112238922818546,666,"Employment condition, his ""Facade of decency"""
1613,5222,0,11,64,75,1.1466666666666667,0.04112531205098986,666,"They're so speciesist, keeping us down with their glass ceiling."
5886,5222,1,9,65,75,1.1466666666666667,0.045295161459604626,666,"Thanks for the invite, but I don't feel like I can leave right now."
5651,5222,1,9,65,75,1.1466666666666667,0.045295161459604626,666,I can't eat him. I need the five star reviews.
1456,5222,1,9,65,75,1.1466666666666667,0.045295161459604626,666,I love to go but I don't get off until 5.
1333,5222,2,7,66,75,1.1466666666666667,0.049112238922818546,666,"This is Glen's version of ""jumping the shark."""
3129,5235,2,8,73,83,1.144578313253012,0.04578158588104719,666,please leave him for me
4364,5235,1,10,72,83,1.144578313253012,0.042451092394817716,666,"I know. He's dum, but I'm sort of attached to him"
4830,5237,0,11,66,77,1.1428571428571428,0.04013939192492975,666,"Climate change killed my remora, and this clown's house is underwater, but he doesn't eat the scraps."
6153,5237,2,6,62,70,1.1428571428571428,0.051017450372708696,666,"He’s a ten-tied genius, man. Like gentle, but like totally deep tissue, my broheim."
1288,5237,4,3,70,77,1.1428571428571428,0.05457311410150662,666,So this dude says he’s a stand up guy but that he really needs a paddle.
2272,5237,2,6,62,70,1.1428571428571428,0.051017450372708696,666,Don't yuck my yum.
3967,5241,1,9,68,78,1.141025641025641,0.04366020435906115,666,You can have him. It's hardly an appetizer.
4731,5241,1,9,68,78,1.141025641025641,0.04366020435906115,666,I think he said something about ‘jumping.’
5625,5241,2,7,69,78,1.141025641025641,0.047320331546548945,666,Lucky for him my parents put me through Charm School.
3950,5244,1,8,63,72,1.1388888888888888,0.04556013565281042,666,I heard this will help with the knots in my cartilage.
4853,5244,2,6,64,72,1.1388888888888888,0.04966852391033734,666,"Leg food? Please, be my guest."
4589,5244,1,8,63,72,1.1388888888888888,0.04556013565281042,666,I thought being an Uber-predator would have been more exciting.
4586,5244,1,8,63,72,1.1388888888888888,0.04556013565281042,666,"No, no, he's really nice once you get to know him."
4496,5244,1,8,63,72,1.1388888888888888,0.04556013565281042,666,"He'll be okay; I'm a nurse shark."""
4373,5244,1,8,63,72,1.1388888888888888,0.04556013565281042,666,This gig economy has me now working for callus removal company too.
4309,5244,1,8,63,72,1.1388888888888888,0.04556013565281042,666,"I'm supposed to wait 30 minutes
after ingesting the upper torso."
4257,5244,1,8,63,72,1.1388888888888888,0.04556013565281042,666,We're in the wrong support group.
3897,5244,2,6,64,72,1.1388888888888888,0.04966852391033734,666,Bro his metatorsal is on my dorsal.
4145,5244,0,10,62,72,1.1388888888888888,0.04104253469235572,666,Don't even think about it. This is the best massage I've had since I stopped eating legs.
3707,5244,0,10,62,72,1.1388888888888888,0.04104253469235572,666,Daughter's new boyfriend.  Trying to keep an open mind. Hoping it doesn't last
3835,5244,1,8,63,72,1.1388888888888888,0.04556013565281042,666,"I got it to attract swimmers.  If you get one, have a blowfish inflate it!"
4049,5244,1,8,63,72,1.1388888888888888,0.04556013565281042,666,"What can I say,I've become a vegetarian !"
3964,5244,1,8,63,72,1.1388888888888888,0.04556013565281042,666,I'm giving him time to phone a friend
4306,5244,1,8,63,72,1.1388888888888888,0.04556013565281042,666,"Jealous, huh? This is my Uber Eats guy."
4929,5244,2,6,64,72,1.1388888888888888,0.04966852391033734,666,I told you that we do our food delivery on time.
5300,5244,1,8,63,72,1.1388888888888888,0.04556013565281042,666,"I dunno, I guess I'd thought I'd have more independence when I signed up with Uber"
5003,5244,0,10,62,72,1.1388888888888888,0.04104253469235572,666,"Dude, I brought lunch, I swear!  I don't know where I left it."
6103,5244,0,10,62,72,1.1388888888888888,0.04104253469235572,666,Do you think another one of these hackneyed leadership survival guides hit the bestseller list?
6171,5244,1,8,63,72,1.1388888888888888,0.04556013565281042,666,He used to hang twenty.
6186,5244,1,8,63,72,1.1388888888888888,0.04556013565281042,666,"You look skeptical, but I'm telling you this summer it's all about deep tissue."
6197,5244,1,8,63,72,1.1388888888888888,0.04556013565281042,666,I have a headache.  I have a 150 pounding headache.
6201,5244,2,6,64,72,1.1388888888888888,0.04966852391033734,666,"Ok Karen, I'll ask her to leave."
6213,5244,1,8,63,72,1.1388888888888888,0.04556013565281042,666,Want to feel the water get warm?.......
4973,5244,2,6,64,72,1.1388888888888888,0.04966852391033734,666,The IPO will pay off big after an extended period of private funding
6077,5244,1,8,63,72,1.1388888888888888,0.04556013565281042,666,Should I rock the boat on his free ride?
5895,5244,1,8,63,72,1.1388888888888888,0.04556013565281042,666,I always travel with snacks
5721,5244,1,8,63,72,1.1388888888888888,0.04556013565281042,666,The ocean version of Ellen’s “know or go” game
5382,5244,1,8,63,72,1.1388888888888888,0.04556013565281042,666,When I was a kid I always wanted to play submarine.
5356,5244,0,10,62,72,1.1388888888888888,0.04104253469235572,666,It's harder to eat when you drive for Uber.
5325,5244,1,8,63,72,1.1388888888888888,0.04556013565281042,666,My masseur has this Ashiatsu technique he is trying out.
3654,5244,0,10,62,72,1.1388888888888888,0.04104253469235572,666,You haven't heard? It's Uber's latest gig.
6028,5244,1,8,63,72,1.1388888888888888,0.04556013565281042,666,"Our image peaked with ""Jaws."" It has been all downhill since then."
3634,5244,1,8,63,72,1.1388888888888888,0.04556013565281042,666,His name is Rey Mora
4998,5244,2,6,64,72,1.1388888888888888,0.04966852391033734,666,This boogie board ride is going to end badly.
3206,5244,0,10,62,72,1.1388888888888888,0.04104253469235572,666,"Ja, ve call our new ride-sharing service Ü-ber."
3325,5244,2,6,64,72,1.1388888888888888,0.04966852391033734,666,I'll let him play apex predator for a little longer and then we'll have lunch.
9,5244,1,8,63,72,1.1388888888888888,0.04556013565281042,666,Whoever said these were shark infested waters is wrong Dad.
63,5244,0,10,62,72,1.1388888888888888,0.04104253469235572,666,I couldn't get a job coding.
220,5244,1,8,63,72,1.1388888888888888,0.04556013565281042,666,We're trying out for a new reality show.
541,5244,1,8,63,72,1.1388888888888888,0.04556013565281042,666,"Yes, I saw what they did to the wolves, Eddy."
593,5244,3,4,65,72,1.1388888888888888,0.05346212279886589,666,Meet Kevin O'Leary.
779,5244,2,6,64,72,1.1388888888888888,0.04966852391033734,666,"Yeah, shark surfing. It's a living."
793,5244,0,10,62,72,1.1388888888888888,0.04104253469235572,666,I am a gig worker for Uber Under.
955,5244,0,10,62,72,1.1388888888888888,0.04104253469235572,666,I'm going for the Carmen Miranda look
961,5244,2,6,64,72,1.1388888888888888,0.04966852391033734,666,Wait until he realizes I'm not a sandbar!
971,5244,1,8,63,72,1.1388888888888888,0.04556013565281042,666,Let's eat after my chiropractic session
973,5244,1,8,63,72,1.1388888888888888,0.04556013565281042,666,Best dorsal massage in the ocean.
1528,5244,0,10,62,72,1.1388888888888888,0.04104253469235572,666,This one is too skinny so we made a deal.  He gets ten minutes to find a fatter lunch morsel for me.
1589,5244,1,8,63,72,1.1388888888888888,0.04556013565281042,666,"If he finds out,they'll close the beach for weeks!"
381,5244,0,10,62,72,1.1388888888888888,0.04104253469235572,666,Help yourself. I've already had lunch.
2657,5244,1,8,63,72,1.1388888888888888,0.04556013565281042,666,"And then stir, before tasting..."
3103,5244,1,8,63,72,1.1388888888888888,0.04556013565281042,666,Not as humiliating as getting blown to bits by a scuba tank.
3157,5244,1,8,63,72,1.1388888888888888,0.04556013565281042,666,Transfer available?
2617,5244,1,8,63,72,1.1388888888888888,0.04556013565281042,666,Here honey—I know you like the drumsticks!
2408,5244,0,10,62,72,1.1388888888888888,0.04104253469235572,666,Does he know how tasteless his bare legs are!
2392,5244,2,6,64,72,1.1388888888888888,0.04966852391033734,666,I would've started Uber sooner but they had a pretty thorough background check.
2562,5244,2,6,64,72,1.1388888888888888,0.04966852391033734,666,I’ll hurl him up hard and you surface with jaws open.  He’ll never know what hit him.
2316,5244,1,8,63,72,1.1388888888888888,0.04556013565281042,666,"He's not the best, but most ashiatsu services don't do house calls."
2241,5244,1,8,63,72,1.1388888888888888,0.04556013565281042,666,"Its an ok decoy, but “Free Beer Guy” doesn’t work as well as “Big Breast Lady” ."
2220,5244,0,10,62,72,1.1388888888888888,0.04104253469235572,666,Way better than goat massage.
2150,5244,1,8,63,72,1.1388888888888888,0.04556013565281042,666,"I always pack a snack--low blood sugar, you know."
2334,5244,0,10,62,72,1.1388888888888888,0.04104253469235572,666,If humans can be vegetarian so can sharks
1692,5307,1,9,70,80,1.1375,0.042633817622437835,666,"Hey, we're friends. He's just a chum"
6074,5308,1,8,65,74,1.135135135135135,0.044398669826762854,666,I think I‘m having a long lasting sleep paralysis...
2886,5308,2,6,66,74,1.135135135135135,0.04838879136051528,666,I told you I'd get rven
4590,5310,2,5,61,68,1.1323529411764706,0.05091098018830443,666,What does cowabunga mean?
4607,5310,1,7,60,68,1.1323529411764706,0.0463998528118308,666,"And how sure are you about this ""heaven""?"
4605,5310,1,7,60,68,1.1323529411764706,0.0463998528118308,666,I’m feeling a little weighed down lately how ‘bout you Gary?
4926,5310,2,5,61,68,1.1323529411764706,0.05091098018830443,666,What did the top half taste like?
4449,5310,1,7,60,68,1.1323529411764706,0.0463998528118308,666,Successful Uber drivers always keep moving.
4407,5310,1,7,60,68,1.1323529411764706,0.0463998528118308,666,"I looked up ""periscope"" on Amazon. Why?"
4370,5310,0,9,59,68,1.1323529411764706,0.0414000577075105,666,Shark selfie.
4464,5310,1,7,60,68,1.1323529411764706,0.0463998528118308,666,So the caravan didn't work huh?
4612,5310,2,5,61,68,1.1323529411764706,0.05091098018830443,666,It's a synbiotic relationship. He gives me ashiatsu massages and I don't eat him.
4770,5310,1,7,60,68,1.1323529411764706,0.0463998528118308,666,"His official job title is VP for Consumer Development but we just call him ""bait."""
4644,5310,0,9,59,68,1.1323529411764706,0.0414000577075105,666,I've got to up my game.
4655,5310,2,5,61,68,1.1323529411764706,0.05091098018830443,666,"Honey, I think I might have a lyme disease?!?!"
4669,5310,2,5,61,68,1.1323529411764706,0.05091098018830443,666,His torso gave me indigestion.
4705,5310,1,7,60,68,1.1323529411764706,0.0463998528118308,666,"Taking selfies ""jumping the shark"" is where I draw the line. This ends now!"
4737,5310,0,9,59,68,1.1323529411764706,0.0414000577075105,666,Soups on.
4859,5310,2,5,61,68,1.1323529411764706,0.05091098018830443,666,It’s actually quite comfortable. I think everyone will be wearing one next season.
4835,5310,1,7,60,68,1.1323529411764706,0.0463998528118308,666,He’s adjusting his scuba gear
4837,5310,1,7,60,68,1.1323529411764706,0.0463998528118308,666,Lucky guy
4362,5310,0,9,59,68,1.1323529411764706,0.0414000577075105,666,Is it still there?
4630,5310,0,9,59,68,1.1323529411764706,0.0414000577075105,666,"Don’t fall for it. It’s shark bait from Jaws X, the reality show."
4351,5310,0,9,59,68,1.1323529411764706,0.0414000577075105,666,I took a bite out of his surfboard and it turned out he is a lawyer. We both agreed this is better than going to small claims court.
3670,5310,0,9,59,68,1.1323529411764706,0.0414000577075105,666,"Yeah, I was gonna eat him until he said we should all wait until the 2020 elections are over."
4312,5310,0,9,59,68,1.1323529411764706,0.0414000577075105,666,"Hey Doc, I have a tingling sensation on my back. Can you take a look?"
3473,5310,1,7,60,68,1.1323529411764706,0.0463998528118308,666,I caught really do with a bite right now.
3480,5310,0,9,59,68,1.1323529411764706,0.0414000577075105,666,"Well, I've picked up some extra cash working for ScUber, so I don't really mind."
3489,5310,1,7,60,68,1.1323529411764706,0.0463998528118308,666,My boss is riding me about making partner.
3512,5310,1,7,60,68,1.1323529411764706,0.0463998528118308,666,I brought takeout.  We're going to spend the evening sharing.
3522,5310,0,9,59,68,1.1323529411764706,0.0414000577075105,666,He says he’s from a TV show and wants to intern with us.
3528,5310,0,9,59,68,1.1323529411764706,0.0414000577075105,666,"It's Fonzie, again."
3617,5310,0,9,59,68,1.1323529411764706,0.0414000577075105,666,It's community service. I was caught shark-lifting.
3636,5310,2,5,61,68,1.1323529411764706,0.05091098018830443,666,I'm waiting for dinner time.  Want to come over?
4946,5310,0,9,59,68,1.1323529411764706,0.0414000577075105,666,"Happy to give him a leg up, but I'm taking one of the legs when all is said and done."
3677,5310,1,7,60,68,1.1323529411764706,0.0463998528118308,666,Indian poker? Who invented this stupid game?
3716,5310,0,9,59,68,1.1323529411764706,0.0414000577075105,666,"The apprentice in the shark tank is riding you. 
He won't drain the swamp."
3890,5310,0,9,59,68,1.1323529411764706,0.0414000577075105,666,Daddy human. Doo Doo Doo Doo Doo Doo. Daddy human. Doo Doo Doo Doo Doo Doo. Daddy human. Doo Doo Doo Doo Doo Doo. It's the end.
3944,5310,0,9,59,68,1.1323529411764706,0.0414000577075105,666,We expect to bring opportunity to people who would otherwise never access the exposure to liquidity or the mentorship the shark tank experience will provide.”
3978,5310,0,9,59,68,1.1323529411764706,0.0414000577075105,666,I’m not sure if these are snacks or the full body
4008,5310,1,7,60,68,1.1323529411764706,0.0463998528118308,666,"Hey, if you need a good massage..."
4046,5310,1,7,60,68,1.1323529411764706,0.0463998528118308,666,You can have the bottom half and I’ll have the top half.
4126,5310,2,5,61,68,1.1323529411764706,0.05091098018830443,666,As a Democrat I don’t charge them for the Rio Grande crossing.
4199,5310,2,5,61,68,1.1323529411764706,0.05091098018830443,666,thanks for thinking of me but i am not a leg man
4268,5310,1,7,60,68,1.1323529411764706,0.0463998528118308,666,"Ever since the Wreck beached me, I've been under foot."
4280,5310,1,7,60,68,1.1323529411764706,0.0463998528118308,666,The shorts aren't my taste.
4283,5310,2,5,61,68,1.1323529411764706,0.05091098018830443,666,"Remember, don't go for the toes!  My dorsal is still hurting from last time."
4342,5310,1,7,60,68,1.1323529411764706,0.0463998528118308,666,Hang ten my fins.
4948,5310,1,7,60,68,1.1323529411764706,0.0463998528118308,666,"What,Walter--nothing on the side?"
5375,5310,1,7,60,68,1.1323529411764706,0.0463998528118308,666,This is what I call an eco-friendly move.
5016,5310,0,9,59,68,1.1323529411764706,0.0414000577075105,666,"I had to take this Ride Share, or should I say Ride Shark, job to make ends meet."
5800,5310,0,9,59,68,1.1323529411764706,0.0414000577075105,666,"You go ahead, pal, I prefer breast meat."
5835,5310,1,7,60,68,1.1323529411764706,0.0463998528118308,666,Stick around. He’s very persuasive.
5857,5310,1,7,60,68,1.1323529411764706,0.0463998528118308,666,These humans have been all over my back about these recent attacks
5874,5310,0,9,59,68,1.1323529411764706,0.0414000577075105,666,"Go wide like you're really scared of me, then sneak up from behind."
5907,5310,2,5,61,68,1.1323529411764706,0.05091098018830443,666,"Eeny, meeny, miny, moe..."
5915,5310,0,9,59,68,1.1323529411764706,0.0414000577075105,666,Feeding in shallow waters offers a new menu.
5937,5310,1,7,60,68,1.1323529411764706,0.0463998528118308,666,Is it dinner or a snack?
5955,5310,1,7,60,68,1.1323529411764706,0.0463998528118308,666,An accessory I never should have bought
5958,5310,1,7,60,68,1.1323529411764706,0.0463998528118308,666,It's fine. He's filming a spot for 'Shark Week.
5796,5310,1,7,60,68,1.1323529411764706,0.0463998528118308,666,People these days are so lazy.
5971,5310,1,7,60,68,1.1323529411764706,0.0463998528118308,666,We need to keep our entrepreneurs a float.
6025,5310,3,3,62,68,1.1323529411764706,0.055053696211138176,666,He’s paying me an arm and a leg. There were not enough Uber boats so sharks had to step in.
6047,5310,0,9,59,68,1.1323529411764706,0.0414000577075105,666,"Being a driver pays great, and I just lie about the mandatory sleep."
6049,5310,1,7,60,68,1.1323529411764706,0.0463998528118308,666,It's payback. I chewed up his surfboard.
6050,5310,2,5,61,68,1.1323529411764706,0.05091098018830443,666,I was a stand up comedian before getting into the paddling business
6262,5310,1,7,60,68,1.1323529411764706,0.0463998528118308,666,"Apparently, it was either this or the network was going to cancel."
6272,5310,1,7,60,68,1.1323529411764706,0.0463998528118308,666,"An ocean full of scrawny, mindless kids.  I hate beach week."
3419,5310,0,9,59,68,1.1323529411764706,0.0414000577075105,666,"What can I say? The pay is good, and I get lunch for free!"
6152,5310,1,7,60,68,1.1323529411764706,0.0463998528118308,666,Every now and then it's good  to take a stab at  public relations.
6147,5310,0,9,59,68,1.1323529411764706,0.0414000577075105,666,It's part of the yoga class I'm taking.
5972,5310,1,7,60,68,1.1323529411764706,0.0463998528118308,666,Sharks finnnnnnnn
5771,5310,0,9,59,68,1.1323529411764706,0.0414000577075105,666,"PLease don't bite, he's my backscratcher."
5753,5310,1,7,60,68,1.1323529411764706,0.0463998528118308,666,"He only charges $60 an hour and I swear, it’ll change your life."
5729,5310,0,9,59,68,1.1323529411764706,0.0414000577075105,666,Now I will open my mouth and you just move aside with a sharp jerk.
5023,5310,0,9,59,68,1.1323529411764706,0.0414000577075105,666,He told me he’s a shark boarder
5033,5310,1,7,60,68,1.1323529411764706,0.0463998528118308,666,It's my retirement plan.
5044,5310,0,9,59,68,1.1323529411764706,0.0414000577075105,666,I'm going to need a bigger boy.
5068,5310,1,7,60,68,1.1323529411764706,0.0463998528118308,666,You've never heard of 'bait and switch'? The whole herd will have a smorgasbord for lunch!
5233,5310,0,9,59,68,1.1323529411764706,0.0414000577075105,666,"I remember the time he was dating you. He used to stay above water, no?"
5241,5310,2,5,61,68,1.1323529411764706,0.05091098018830443,666,Working for Uber to put food on the table.
5244,5310,2,5,61,68,1.1323529411764706,0.05091098018830443,666,He won't jump off!_
5246,5310,1,7,60,68,1.1323529411764706,0.0463998528118308,666,It is actually the devil and he walks on sharks.
5255,5310,2,5,61,68,1.1323529411764706,0.05091098018830443,666,It's time for my break now.
6176,5310,2,5,61,68,1.1323529411764706,0.05091098018830443,666,"I hate to let a good meal go to waist."""
5293,5310,2,5,61,68,1.1323529411764706,0.05091098018830443,666,"Our earth is dying. Humans are destroying our seas, our forests, and our atmosphere. We’re almost past the point of no return. This is not a joke."
5332,5310,1,7,60,68,1.1323529411764706,0.0463998528118308,666,Just warming up dinner.
5333,5310,1,7,60,68,1.1323529411764706,0.0463998528118308,666,Want to flip a coin?
5475,5310,0,9,59,68,1.1323529411764706,0.0414000577075105,666,Feels a little light for my taste.
5516,5310,0,9,59,68,1.1323529411764706,0.0414000577075105,666,Are you kidding me ?
5559,5310,0,9,59,68,1.1323529411764706,0.0414000577075105,666,Our special this evening is surf'in' turf.
5594,5310,1,7,60,68,1.1323529411764706,0.0463998528118308,666,I'm calling it 'MAXI-TAXI:WE TAKE YOU ALL THE WAY HOME'
5612,5310,2,5,61,68,1.1323529411764706,0.05091098018830443,666,No. We never promised a 20-minute delivery guarantee.
5666,5310,2,5,61,68,1.1323529411764706,0.05091098018830443,666,"On the count of three, I submerge and you grab."
5677,5310,1,7,60,68,1.1323529411764706,0.0463998528118308,666,This is too easy!
5687,5310,1,7,60,68,1.1323529411764706,0.0463998528118308,666,It's good for my back.
4972,5310,0,9,59,68,1.1323529411764706,0.0414000577075105,666,All clear up here
3396,5310,0,9,59,68,1.1323529411764706,0.0414000577075105,666,Leftovers again tonight!
5257,5310,0,9,59,68,1.1323529411764706,0.0414000577075105,666,People never really know they’re stepping on in the ocean
3350,5310,0,9,59,68,1.1323529411764706,0.0414000577075105,666,He thinks it's turtles all the way down.
813,5310,1,7,60,68,1.1323529411764706,0.0463998528118308,666,Sentencing for biting surfboards is getting tougher.
836,5310,2,5,61,68,1.1323529411764706,0.05091098018830443,666,‘This foot crisis is weighing me down.’
868,5310,2,5,61,68,1.1323529411764706,0.05091098018830443,666,He gives great massages. To bad i will have him for dinner.
904,5310,0,9,59,68,1.1323529411764706,0.0414000577075105,666,"I'm between jobs at the moment, but this Grubhub gig isn't too bad."
968,5310,1,7,60,68,1.1323529411764706,0.0463998528118308,666,I felt like this was one of those times I should call my sponsor.
3386,5310,0,9,59,68,1.1323529411764706,0.0414000577075105,666,Shark skin is the new pumice.
998,5310,2,5,61,68,1.1323529411764706,0.05091098018830443,666,You realize you’re letting your dinner walk all over you.
1017,5310,1,7,60,68,1.1323529411764706,0.0463998528118308,666,How come I always get the lower half?
1028,5310,0,9,59,68,1.1323529411764706,0.0414000577075105,666,My chiropractor recommend this
1042,5310,1,7,60,68,1.1323529411764706,0.0463998528118308,666,"I was just going to eat him, but I'll get bad reviews if I only use Uber for food"
1109,5310,1,7,60,68,1.1323529411764706,0.0463998528118308,666,"He brings me all the krill I can eat. If he ever stops, we’ll ..."
1134,5310,2,5,61,68,1.1323529411764706,0.05091098018830443,666,My wife said Phinn is supposed to help me be a little more discrete in public.
1193,5310,1,7,60,68,1.1323529411764706,0.0463998528118308,666,I got a Monkey on my back !
1235,5310,2,5,61,68,1.1323529411764706,0.05091098018830443,666,"„It‘s a Double Whopper, he‘s carrying a toddler!“"
1245,5310,0,9,59,68,1.1323529411764706,0.0414000577075105,666,"You wanna help me put the 'rip' in 'riptide?'"""
1278,5310,1,7,60,68,1.1323529411764706,0.0463998528118308,666,"You want to break the news to him, or shall I?"
1295,5310,2,5,61,68,1.1323529411764706,0.05091098018830443,666,Should we give him a standing ovation before his obliteration?
1384,5310,0,9,59,68,1.1323529411764706,0.0414000577075105,666,I'd go up there myself but I've got a bad back.
1386,5310,0,9,59,68,1.1323529411764706,0.0414000577075105,666,You take the left ankle I'm not all that hungry
751,5310,0,9,59,68,1.1323529411764706,0.0414000577075105,666,"Do you want to tell him, or should I?"
1403,5310,0,9,59,68,1.1323529411764706,0.0414000577075105,666,When I started swimming for Uber I thought I would be my own boss.
724,5310,1,7,60,68,1.1323529411764706,0.0463998528118308,666,When are they going to remake Jaws? This is getting ridiculous.
677,5310,0,9,59,68,1.1323529411764706,0.0414000577075105,666,I've got a lot on my mind.
59,5310,2,5,61,68,1.1323529411764706,0.05091098018830443,666,Don't you just hate it when you can't reach that last bit you your lunch?
75,5310,1,7,60,68,1.1323529411764706,0.0463998528118308,666,"Yeah, life hasn't been the same since I signed with Suber"
78,5310,0,9,59,68,1.1323529411764706,0.0414000577075105,666,Bait and switch.
153,5310,0,9,59,68,1.1323529411764706,0.0414000577075105,666,What?  Do I have a piece of human caught between my teeth?
158,5310,1,7,60,68,1.1323529411764706,0.0463998528118308,666,I packed my lunch today.
162,5310,0,9,59,68,1.1323529411764706,0.0414000577075105,666,"Uber Shark, doo doo doo doo doo doo
Uber Shark, doo doo doo doo doo doo"
217,5310,2,5,61,68,1.1323529411764706,0.05091098018830443,666,"I swallowed the surf board, but how did I miss the surfer?!?"
218,5310,2,5,61,68,1.1323529411764706,0.05091098018830443,666,"Ever since big pharma turned off the Internet pipes, they had to find some new form of amusement."
264,5310,2,5,61,68,1.1323529411764706,0.05091098018830443,666,Tell me when he moves. I'm hungry.
374,5310,1,7,60,68,1.1323529411764706,0.0463998528118308,666,"Remember ""the Fonz?""  Well, he tried it again!"
388,5310,0,9,59,68,1.1323529411764706,0.0414000577075105,666,I told you not eat so fast!
400,5310,1,7,60,68,1.1323529411764706,0.0463998528118308,666,Would you like a roll of toilet paper?
402,5310,1,7,60,68,1.1323529411764706,0.0463998528118308,666,Glue commercial
450,5310,2,5,61,68,1.1323529411764706,0.05091098018830443,666,He’s trying to protect the corral reef
467,5310,0,9,59,68,1.1323529411764706,0.0414000577075105,666,I feel the weight of life pushing me down.
473,5310,0,9,59,68,1.1323529411764706,0.0414000577075105,666,"What’s the matter, buddy? You’re looking at me like I’m out of fashion or something."
537,5310,0,9,59,68,1.1323529411764706,0.0414000577075105,666,I feel so guilty--I devoured his surf board.
565,5310,0,9,59,68,1.1323529411764706,0.0414000577075105,666,I like a good back massage before dinner.
579,5310,2,5,61,68,1.1323529411764706,0.05091098018830443,666,I'm baking the rest.
721,5310,0,9,59,68,1.1323529411764706,0.0414000577075105,666,Working for Uber makes me question myself.
1612,5310,2,5,61,68,1.1323529411764706,0.05091098018830443,666,Hungry?
1272,5310,1,7,60,68,1.1323529411764706,0.0463998528118308,666,Must be one of those bleeding heart 'live and let live' idiots.
1859,5310,0,9,59,68,1.1323529411764706,0.0414000577075105,666,"Hey look, I'm a surfboard!"
2760,5310,1,7,60,68,1.1323529411764706,0.0463998528118308,666,"I liked it better when they swam with us, not really into this paddle boarding thing"
2790,5310,1,7,60,68,1.1323529411764706,0.0463998528118308,666,What?  It just happened.
2802,5310,1,7,60,68,1.1323529411764706,0.0463998528118308,666,Don't go into the bay... tech bros are ruthless this time of year.
2820,5310,0,9,59,68,1.1323529411764706,0.0414000577075105,666,It’s human yoga followed by dinner
1653,5310,1,7,60,68,1.1323529411764706,0.0463998528118308,666,I think he said his last name was Remora
2869,5310,2,5,61,68,1.1323529411764706,0.05091098018830443,666,A Daring Feet
2898,5310,1,7,60,68,1.1323529411764706,0.0463998528118308,666,"I GET THE BOTTOM, you get the top half"
2899,5310,1,7,60,68,1.1323529411764706,0.0463998528118308,666,YOU  WOULDN'T  BELIEVE  HOW  GOOD  THIS  FEELS.
2925,5310,0,9,59,68,1.1323529411764706,0.0414000577075105,666,I told you they'd take advantage of us
2709,5310,0,9,59,68,1.1323529411764706,0.0414000577075105,666,That's my alter ego.
2958,5310,0,9,59,68,1.1323529411764706,0.0414000577075105,666,I sold our air rights to send the kids to school.
3031,5310,1,7,60,68,1.1323529411764706,0.0463998528118308,666,"Vegan.  Soooo, not worth it."
3096,5310,1,7,60,68,1.1323529411764706,0.0463998528118308,666,I can't get this monkey off my back.
3163,5310,1,7,60,68,1.1323529411764706,0.0463998528118308,666,They’ve broken my spirit with these sensors. My element of surprise is gone and they just toy with me.
3165,5310,1,7,60,68,1.1323529411764706,0.0463998528118308,666,"He thought *I* was a surfboard. Ironic, right?"
3169,5310,1,7,60,68,1.1323529411764706,0.0463998528118308,666,Uber is piloting this new service to prepare for climate change.
3172,5310,2,5,61,68,1.1323529411764706,0.05091098018830443,666,I'm accidentally grabbed the vegan option.
3205,5310,0,9,59,68,1.1323529411764706,0.0414000577075105,666,I get the bottom half
3215,5310,1,7,60,68,1.1323529411764706,0.0463998528118308,666,He gave me a fifty and said to follow that tuna and make it quick.
3348,5310,1,7,60,68,1.1323529411764706,0.0463998528118308,666,Shark skin pedicures are about all i can offer the gig economy these days
2959,5310,0,9,59,68,1.1323529411764706,0.0414000577075105,666,We're waitin' for our pastrami sandwich orders - they make beach front deliveries here at Margate.
2630,5310,0,9,59,68,1.1323529411764706,0.0414000577075105,666,"I thought he'd look good in the aquarium, turns blue and expands."
2844,5310,1,7,60,68,1.1323529411764706,0.0463998528118308,666,I already had half for dinner but I'm gonna hold on to the other half in case I want a late night snack.
2539,5310,0,9,59,68,1.1323529411764706,0.0414000577075105,666,"The dufus thought he was stepping into shallow water. In about five seconds I’m going flip up my head, open my mouth as wide as I can and swallow him whole."
1879,5310,2,5,61,68,1.1323529411764706,0.05091098018830443,666,I know. I know. But I like getting my belly waxed.
1931,5310,1,7,60,68,1.1323529411764706,0.0463998528118308,666,If I knew that this is what a paralegal had to do I would have studied something else.
1953,5310,1,7,60,68,1.1323529411764706,0.0463998528118308,666,This wasn't in my contract.
2549,5310,1,7,60,68,1.1323529411764706,0.0463998528118308,666,It's Mark Cuban again.
2042,5310,0,9,59,68,1.1323529411764706,0.0414000577075105,666,"No, I am not going down alone"
2155,5310,3,3,62,68,1.1323529411764706,0.055053696211138176,666,I’m trying to be the perfect host.
2163,5310,0,9,59,68,1.1323529411764706,0.0414000577075105,666,"Yes, Stan, it is frustrating that I cannot touch the top of my head."
2197,5310,1,7,60,68,1.1323529411764706,0.0463998528118308,666,One stomp - human edibles. Two stomps - a boat.
2207,5310,0,9,59,68,1.1323529411764706,0.0414000577075105,666,"These humans are taking their obsession with ""Baby Shark"" a bit too far."
1997,5310,2,5,61,68,1.1323529411764706,0.05091098018830443,666,I feel like we've come a long way since JAWS.
2295,5310,2,5,61,68,1.1323529411764706,0.05091098018830443,666,They are taking this Baby Shark song a bit too far.
2341,5310,2,5,61,68,1.1323529411764706,0.05091098018830443,666,Bro its Steven Spielberg. You can't eat him
2362,5310,1,7,60,68,1.1323529411764706,0.0463998528118308,666,These tourists walking all over us are starting to make me feel very salty.
2367,5310,1,7,60,68,1.1323529411764706,0.0463998528118308,666,I should have signed up as an Uber driver instead of letting this jerk ride me for free.
2388,5310,1,7,60,68,1.1323529411764706,0.0463998528118308,666,He's standing on my reputation.
2401,5310,2,5,61,68,1.1323529411764706,0.05091098018830443,666,I get paid by the pound!
2444,5310,1,7,60,68,1.1323529411764706,0.0463998528118308,666,"Next time, you get the take out!"
2452,5310,1,7,60,68,1.1323529411764706,0.0463998528118308,666,He thinks I'm his big brother with a mask and flippers.  Wish I could do a selfie when he wakes up!
2496,5310,1,7,60,68,1.1323529411764706,0.0463998528118308,666,"SUP""! ""SUP!"" Do you know anything about this 'SUP' frenzy"
2213,5310,1,7,60,68,1.1323529411764706,0.0463998528118308,666,These remoras are getting so annoying.
2348,5497,2,5,62,69,1.1304347826086956,0.050204371233880496,666,I love feet.
2590,5497,2,5,62,69,1.1304347826086956,0.050204371233880496,666,"We are sharks, but there is a person standing on me."
3063,5497,1,7,61,69,1.1304347826086956,0.04576266416505649,666,I feel like they fooled us with the reparation-contract for what we did in Jaws.
3990,5497,1,7,61,69,1.1304347826086956,0.04576266416505649,666,I started swimming for Uber to make a few clams on the side.
4080,5497,1,7,61,69,1.1304347826086956,0.04576266416505649,666,The doctor said I've got athlete's foot.
4144,5497,0,9,60,69,1.1304347826086956,0.040840714635988,666,The shark fin was too intimidating.
5741,5497,0,9,60,69,1.1304347826086956,0.040840714635988,666,You want to split it?
5152,5497,2,5,62,69,1.1304347826086956,0.050204371233880496,666,"Riding shark, doo doo"
5377,5497,1,7,61,69,1.1304347826086956,0.04576266416505649,666,One more carpet shark joke and I’m not sharing him with you.
5682,5497,1,7,61,69,1.1304347826086956,0.04576266416505649,666,I LOST MY PERISCOPE.
6098,5497,0,9,60,69,1.1304347826086956,0.040840714635988,666,"We're a new subsidiary, ""Uber.cool"""
2268,5497,2,5,62,69,1.1304347826086956,0.050204371233880496,666,Do we share?
4148,5497,1,7,61,69,1.1304347826086956,0.04576266416505649,666,They taste better exfoliated.
2128,5497,1,7,61,69,1.1304347826086956,0.04576266416505649,666,What? It’s a flavor saver.
4679,5497,1,7,61,69,1.1304347826086956,0.04576266416505649,666,Please.  Don't hate me.  I'm trying to be good.
1558,5497,0,9,60,69,1.1304347826086956,0.040840714635988,666,I decided to give pedicures for the summer this year.
1533,5497,1,7,61,69,1.1304347826086956,0.04576266416505649,666,"Do you want to get this guy off my back? You’re bid enough to swallow him whole so please don’t wait, his weight is killing me!"
1469,5497,1,7,61,69,1.1304347826086956,0.04576266416505649,666,I'm into the new sharing economy. Want a piece?
790,5497,0,9,60,69,1.1304347826086956,0.040840714635988,666,"They're a basic life form--eat, spawn, repeat."
485,5497,0,9,60,69,1.1304347826086956,0.040840714635988,666,After I get past the last sand bar I'll eat him.
407,5497,0,9,60,69,1.1304347826086956,0.040840714635988,666,I think I found the cure for my ennui. Shall we?
141,5497,1,7,61,69,1.1304347826086956,0.04576266416505649,666,Could you speak up? There's a guy stepping on my ears.
139,5497,1,7,61,69,1.1304347826086956,0.04576266416505649,666,Fin.
1942,5497,0,9,60,69,1.1304347826086956,0.040840714635988,666,Green party warfare doctrine: Down with submarines.
2071,5521,2,5,65,72,1.125,0.048197153144195225,666,Oh spare me your attitude.  He's my chiropractor.
1632,5521,2,5,65,72,1.125,0.048197153144195225,666,I like the President's confidence. Let's count to 3 and ...
3264,5523,0,8,57,65,1.123076923076923,0.04106568558473582,666,Are you kidding me? Where has the challenge gone?
4479,5523,0,8,57,65,1.123076923076923,0.04106568558473582,666,I'm going undercover to infiltrate Sea World...watch for my signal.
4319,5523,2,4,59,65,1.123076923076923,0.051458031385614056,666,Huyttyytgtgtt gghfjdh hfhghhgg hgfseffgyheuf which fun ufuudhfb using bchfb fbjdidhfhhrjhrodj chef jjjkf. Corked dinjeihrjofiei Xing Ivor jvifhejei j jrbncun
4293,5523,0,8,57,65,1.123076923076923,0.04106568558473582,666,"Not sure about this ""Uber"" thing!"
4211,5523,0,8,57,65,1.123076923076923,0.04106568558473582,666,I'm gonna need a bigger body.
3951,5523,0,8,57,65,1.123076923076923,0.04106568558473582,666,Aqua-ber Eats
3936,5523,1,6,58,65,1.123076923076923,0.046552763218885414,666,You can to set your own hours in the app.
3254,5523,2,4,59,65,1.123076923076923,0.051458031385614056,666,"Dude! If we can convince ten other sharks, we'll have an all-you-can-eat buffet."
3222,5523,0,8,57,65,1.123076923076923,0.04106568558473582,666,"They said he was going to jump the shark but here it is, another season, and he's still here"
3706,5523,0,8,57,65,1.123076923076923,0.04106568558473582,666,Now I really am a fluke.
3625,5523,1,6,58,65,1.123076923076923,0.046552763218885414,666,My handicap is human
3529,5523,1,6,58,65,1.123076923076923,0.046552763218885414,666,I just can't decide what to make for dinner.
3231,5523,0,8,57,65,1.123076923076923,0.04106568558473582,666,I'm starting to think it's not a new dorsal fin.
4641,5523,1,6,58,65,1.123076923076923,0.046552763218885414,666,He thinks he's not over his head
3270,5523,0,8,57,65,1.123076923076923,0.04106568558473582,666,Ride-sharing sucks!”
3837,5523,0,8,57,65,1.123076923076923,0.04106568558473582,666,I asked for Thai massage and this what I got.
4762,5523,0,8,57,65,1.123076923076923,0.04106568558473582,666,"But when /I/ do this to him, he freaks out . . ."
5303,5523,0,8,57,65,1.123076923076923,0.04106568558473582,666,He knows they'll believe he can really float vertically.
5096,5523,0,8,57,65,1.123076923076923,0.04106568558473582,666,"It's only fair. I ate his surfboard.""  -Stephen West, Laurel M"
6236,5523,0,8,57,65,1.123076923076923,0.04106568558473582,666,I wish these tourists would use pumice stones.
6221,5523,0,8,57,65,1.123076923076923,0.04106568558473582,666,No. I’m working my Uber gig.
6061,5523,0,8,57,65,1.123076923076923,0.04106568558473582,666,This is not what I meant when I agreed to be the shark to back him.
5990,5523,0,8,57,65,1.123076923076923,0.04106568558473582,666,"""It's not scary this way."""
5756,5523,1,6,58,65,1.123076923076923,0.046552763218885414,666,Should we save the leftovers?
5545,5523,0,8,57,65,1.123076923076923,0.04106568558473582,666,I woke up with the worst hangover.
5524,5523,1,6,58,65,1.123076923076923,0.046552763218885414,666,What you don’t know can’t hurt you.
5036,5523,1,6,58,65,1.123076923076923,0.046552763218885414,666,I saved him for lunch.
5436,5523,1,6,58,65,1.123076923076923,0.046552763218885414,666,Would you believe he thought “jump the shark” meant jump ONTO the shark?
5407,5523,0,8,57,65,1.123076923076923,0.04106568558473582,666,I heard this place has the best foot massages.
5405,5523,0,8,57,65,1.123076923076923,0.04106568558473582,666,The unintended consequences of Blackfish....
5366,5523,0,8,57,65,1.123076923076923,0.04106568558473582,666,"I acknowledge that the gig economy has its downsides, Justin."
5321,5523,0,8,57,65,1.123076923076923,0.04106568558473582,666,"And you wonder why they don't fear you, your letting them walk all over you!_""no this is how I make them think I respect & fear them"""
3177,5523,0,8,57,65,1.123076923076923,0.04106568558473582,666,"Look at those great toes, I will take the right leg!"
5231,5523,0,8,57,65,1.123076923076923,0.04106568558473582,666,OK--What'll ya give me for him?
5175,5523,0,8,57,65,1.123076923076923,0.04106568558473582,666,Am saving my lunch for later.
5426,5523,0,8,57,65,1.123076923076923,0.04106568558473582,666,You know what I hate Bruce? When the tourists from Arizona start hanging out at the beach and pretend to know what they are doing.
2921,5523,1,6,58,65,1.123076923076923,0.046552763218885414,666,I'm full. This time you can jump.
3072,5523,1,6,58,65,1.123076923076923,0.046552763218885414,666,Do you think we should let him know?
2697,5523,0,8,57,65,1.123076923076923,0.04106568558473582,666,Are you sure a diet rich in vitamin D is worth the effort?
1208,5523,0,8,57,65,1.123076923076923,0.04106568558473582,666,"Do something, quick!  His toe nails are killing me!"
1044,5523,0,8,57,65,1.123076923076923,0.04106568558473582,666,Don't you dare start singing 'Baby Humans.'
1014,5523,1,6,58,65,1.123076923076923,0.046552763218885414,666,Don't they realize they're swimming in our restaurant?
983,5523,0,8,57,65,1.123076923076923,0.04106568558473582,666,"When I move, we'll have lunch."
639,5523,0,8,57,65,1.123076923076923,0.04106568558473582,666,There's an upper half?
630,5523,0,8,57,65,1.123076923076923,0.04106568558473582,666,"It’s temporary, just until I get him a new board."
1246,5523,1,6,58,65,1.123076923076923,0.046552763218885414,666,It hurts me more than it will hurt him.
2757,5523,1,6,58,65,1.123076923076923,0.046552763218885414,666,"He saved Ernie by grabbing that harpoon, so yeah, just this one time ..."
262,5523,0,8,57,65,1.123076923076923,0.04106568558473582,666,Wanna end  a trend?
193,5523,0,8,57,65,1.123076923076923,0.04106568558473582,666,I had to --he was behaving like a fish out of water.
128,5523,0,8,57,65,1.123076923076923,0.04106568558473582,666,Lemme see you're slam dunk.
89,5523,0,8,57,65,1.123076923076923,0.04106568558473582,666,I've brought you a take out
88,5523,0,8,57,65,1.123076923076923,0.04106568558473582,666,His toenails are extra long so I’m waiting for my back itch to go away before I eat him.
1,5523,0,8,57,65,1.123076923076923,0.04106568558473582,666,Still trying to decide if I'll like the topping on this one.
413,5523,0,8,57,65,1.123076923076923,0.04106568558473582,666,"Well, I _am_ smiling."
1273,5523,1,6,58,65,1.123076923076923,0.046552763218885414,666,"I’m stuffed, Charlie. Want the other half?"
544,5523,0,8,57,65,1.123076923076923,0.04106568558473582,666,My new barber took some liberties.
1388,5523,1,6,58,65,1.123076923076923,0.046552763218885414,666,"Nope, sorry - there isn't any breast meat here!"
1346,5523,0,8,57,65,1.123076923076923,0.04106568558473582,666,Are you in or out on this deal?
2677,5523,0,8,57,65,1.123076923076923,0.04106568558473582,666,SSSShh! He thinks I'm his surfboard.
2514,5523,0,8,57,65,1.123076923076923,0.04106568558473582,666,"Yeah, I know. But he gives a great foot massage."
2235,5523,0,8,57,65,1.123076923076923,0.04106568558473582,666,Shooting humans in a barrel.
2208,5523,1,6,58,65,1.123076923076923,0.046552763218885414,666,"He thinks he's swimming with dolphins, hee,hee,hee..."
2180,5523,0,8,57,65,1.123076923076923,0.04106568558473582,666,His stability will soon prove to be fishy
2089,5523,1,6,58,65,1.123076923076923,0.046552763218885414,666,He’s a plastic surgeon
2265,5523,1,6,58,65,1.123076923076923,0.046552763218885414,666,My latest hanger on needs oxygen.
1989,5523,0,8,57,65,1.123076923076923,0.04106568558473582,666,Pilates.  It helps the spine.
1916,5523,0,8,57,65,1.123076923076923,0.04106568558473582,666,.My ichthyologist recommended shiatsu
1872,5523,0,8,57,65,1.123076923076923,0.04106568558473582,666,It's the only thing that makes my back feel better
1768,5523,1,6,58,65,1.123076923076923,0.046552763218885414,666,"Yea, but he scratches my back."
1760,5523,0,8,57,65,1.123076923076923,0.04106568558473582,666,He thought I was his Lyft
1421,5523,1,6,58,65,1.123076923076923,0.046552763218885414,666,"I don't know, I just downloaded the app..."
2021,5523,1,6,58,65,1.123076923076923,0.046552763218885414,666,"Well it did say Neptune Jnr. on his drivers licence"""
854,5595,2,5,67,74,1.1216216216216217,0.04694559031179952,666,"Don't swing at it, I'm allergic to them."
4205,5596,2,4,60,66,1.121212121212121,0.05070666827479246,666,"Sorry, he's MY client"
4548,5596,0,8,58,66,1.121212121212121,0.040481665913459045,666,You didn’t pack a lunch?
4501,5596,1,6,59,66,1.121212121212121,0.04587990563775582,666,"Do what you will, but not until my 90 min are up."
4487,5596,2,4,60,66,1.121212121212121,0.05070666827479246,666,I'm making a killing on this Scuber gig.
4447,5596,0,8,58,66,1.121212121212121,0.040481665913459045,666,He's from Chicago. He thinks I'm a dolphin.
4311,5596,0,8,58,66,1.121212121212121,0.040481665913459045,666,"Genius,he thinks he's touching bottom.I'll use him as an appetizer."
4245,5596,1,6,59,66,1.121212121212121,0.04587990563775582,666,Get off my back
4153,5596,1,6,59,66,1.121212121212121,0.04587990563775582,666,"I ate the top half for lunch but I'm saving the bottom half for later, it's an aphrodisiac."""
3237,5596,0,8,58,66,1.121212121212121,0.040481665913459045,666,"If I drop, will you share?"
4045,5596,1,6,59,66,1.121212121212121,0.04587990563775582,666,"I auditioned for the movies, and this is the role they gave me."
4011,5596,1,6,59,66,1.121212121212121,0.04587990563775582,666,I’d love to but I’ve had this stiff neck all week
3974,5596,0,8,58,66,1.121212121212121,0.040481665913459045,666,Yeah I'm swimming for Uber full time now.
2995,5596,0,8,58,66,1.121212121212121,0.040481665913459045,666,Will you cut his toenails?
3042,5596,0,8,58,66,1.121212121212121,0.040481665913459045,666,I feel my head a bit heavier than usual.
3635,5596,1,6,59,66,1.121212121212121,0.04587990563775582,666,Want a drumstick and a thigh?
4560,5596,0,8,58,66,1.121212121212121,0.040481665913459045,666,I got the surf.  You get the turf.
4060,5596,0,8,58,66,1.121212121212121,0.040481665913459045,666,No.  Nobody will see him because I bit him in half.
4667,5596,0,8,58,66,1.121212121212121,0.040481665913459045,666,I subscribed to that new ride sharing service.
6010,5596,0,8,58,66,1.121212121212121,0.040481665913459045,666,Is it me or does my remora smell like feet?
5048,5596,1,6,59,66,1.121212121212121,0.04587990563775582,666,"1. When do you think it is a good time to tell him you are not a surfboard?
2. And they thought the unlicensed taxi drivers were dangerous...
3. What do you call a man sitting on a shark? Fred a staire!"
2975,5596,0,8,58,66,1.121212121212121,0.040481665913459045,666,I was really looking forward to that back rub after lunch.
6280,5596,1,6,59,66,1.121212121212121,0.04587990563775582,666,"Sure it's annoying, but worthwhile at supper."
6203,5596,0,8,58,66,1.121212121212121,0.040481665913459045,666,"Honey, will you scratch my back?"
6290,5596,0,8,58,66,1.121212121212121,0.040481665913459045,666,Surf & Turf vacation contest.  Its actually incredibly difficult to win.
6005,5596,1,6,59,66,1.121212121212121,0.04587990563775582,666,OSHA said we present the workplace hazard to him?
6001,5596,1,6,59,66,1.121212121212121,0.04587990563775582,666,It sure would be easier if we met at the shallow end of the pool.
5891,5596,1,6,59,66,1.121212121212121,0.04587990563775582,666,"Bowling with sharks:  ""Make that spare!"""
5805,5596,1,6,59,66,1.121212121212121,0.04587990563775582,666,The top was outstanding too.
5670,5596,1,6,59,66,1.121212121212121,0.04587990563775582,666,It's your turn to remind them we're not dolphins.
5662,5596,2,4,60,66,1.121212121212121,0.05070666827479246,666,This way they never know they’re gonna be eaten.
5576,5596,0,8,58,66,1.121212121212121,0.040481665913459045,666,"I couldn't swim the sharks, I guess, and that's why I became an Uber driver."
5533,5596,1,6,59,66,1.121212121212121,0.04587990563775582,666,Hurry up and bring the other guys. I am getting tired of holding this food up for the feeding frenzy.
5522,5596,1,6,59,66,1.121212121212121,0.04587990563775582,666,This is what I hate about Veganuary.
5462,5596,1,6,59,66,1.121212121212121,0.04587990563775582,666,I told him he could say goodbye to his wife and kids.
5408,5596,0,8,58,66,1.121212121212121,0.040481665913459045,666,"Crazy, heck!!  I'm making twenty five bucks an hour, pal."
5362,5596,0,8,58,66,1.121212121212121,0.040481665913459045,666,"You may have his lower half, and I'll finish off the upper."
5069,5596,1,6,59,66,1.121212121212121,0.04587990563775582,666,They’re always this late — can’t we start eating without them?
4715,5596,0,8,58,66,1.121212121212121,0.040481665913459045,666,"It's a trade off.  I get a shiatsu,he gets to live."
2973,5596,0,8,58,66,1.121212121212121,0.040481665913459045,666,"I know it's a bad look, but it does wonders for the sore spot next to my dorsal fin."
3452,5596,1,6,59,66,1.121212121212121,0.04587990563775582,666,It’s very difficult to be a vegetarian in this world
2864,5596,0,8,58,66,1.121212121212121,0.040481665913459045,666,I let him survive because he entices much human flesh
1186,5596,0,8,58,66,1.121212121212121,0.040481665913459045,666,I am so hungry and I have a splitting headache.
1185,5596,1,6,59,66,1.121212121212121,0.04587990563775582,666,"I want to eat him, but I'm afraid he'll lose his balance."
1177,5596,1,6,59,66,1.121212121212121,0.04587990563775582,666,"""He calls himself  The Shark Rider. Not for long!"""
1041,5596,0,8,58,66,1.121212121212121,0.040481665913459045,666,He's not part of the South Beach diet.
974,5596,0,8,58,66,1.121212121212121,0.040481665913459045,666,"I guess I'll have to take it from here."""
941,5596,1,6,59,66,1.121212121212121,0.04587990563775582,666,I know we're running late but I don't want to be rude...
1247,5596,0,8,58,66,1.121212121212121,0.040481665913459045,666,"He was on a surfboard a second ago before he wiped out... you still hungry, we could split..."
934,5596,0,8,58,66,1.121212121212121,0.040481665913459045,666,"Now that the planet is over-flooded,I might as well be a Ferrari"
687,5596,1,6,59,66,1.121212121212121,0.04587990563775582,666,You here for a foot massage or to eat them?
641,5596,0,8,58,66,1.121212121212121,0.040481665913459045,666,I call him my 'Dorsal Tim'
615,5596,0,8,58,66,1.121212121212121,0.040481665913459045,666,"I keep telling ya, they need a bigger boat."
474,5596,1,6,59,66,1.121212121212121,0.04587990563775582,666,I thought I'd stop by for a massage and a quick lunch.
368,5596,0,8,58,66,1.121212121212121,0.040481665913459045,666,Shut up.
168,5596,0,8,58,66,1.121212121212121,0.040481665913459045,666,"Darling, John Williams is playing our song!"
775,5596,1,6,59,66,1.121212121212121,0.04587990563775582,666,What? I’m just an Uber...or at least that what he says I am...
1292,5596,0,8,58,66,1.121212121212121,0.040481665913459045,666,I'll split the take 50/50 if you get this jerk off my neck.
246,5596,0,8,58,66,1.121212121212121,0.040481665913459045,666,In this economy? A podiatrist job is all I could find.
1391,5596,0,8,58,66,1.121212121212121,0.040481665913459045,666,Let's split the legs. I'll take the left.
1312,5596,0,8,58,66,1.121212121212121,0.040481665913459045,666,"Oh, like you knew what Fintech was!"
2815,5596,0,8,58,66,1.121212121212121,0.040481665913459045,666,I can't seem to get rid of this hangover.
2774,5596,1,6,59,66,1.121212121212121,0.04587990563775582,666,"Swim away, doo doo doo doo doo doo."
2914,5596,1,6,59,66,1.121212121212121,0.04587990563775582,666,It really helps with my upper back pain.
2754,5596,0,8,58,66,1.121212121212121,0.040481665913459045,666,Wanna come over for dinner? There's enough here for both of us.
2673,5596,0,8,58,66,1.121212121212121,0.040481665913459045,666,I have a biting business proposal for a new line of swimwear!
2670,5596,0,8,58,66,1.121212121212121,0.040481665913459045,666,"I thought it wouldn't work out either, but he OWNS climate change!"
2855,5596,0,8,58,66,1.121212121212121,0.040481665913459045,666,"Really? The whole country is underwater, And this is what they’re serving?"
2356,5596,1,6,59,66,1.121212121212121,0.04587990563775582,666,"Hey Matey, SKIP the dishes, your Surfer dude!"
2140,5596,0,8,58,66,1.121212121212121,0.040481665913459045,666,It's symbiotic. He knows all the best places to eat.
2031,5596,0,8,58,66,1.121212121212121,0.040481665913459045,666,A real free loader!
1963,5596,1,6,59,66,1.121212121212121,0.04587990563775582,666,We're gonna need a bigger boot.
1846,5596,0,8,58,66,1.121212121212121,0.040481665913459045,666,I’ve been finding my lawyer to be a little scarier than the fin these days.
1608,5596,0,8,58,66,1.121212121212121,0.040481665913459045,666,"His kids were tempting, but so were his foot massages."
2464,5596,1,6,59,66,1.121212121212121,0.04587990563775582,666,of course you realize this means war?
1566,5596,0,8,58,66,1.121212121212121,0.040481665913459045,666,It's a new Uber service.
4181,5671,1,6,60,67,1.1194029850746268,0.045226141960648454,666,He’s a pre-lunch periscope”
4620,5672,1,5,56,62,1.1129032258064515,0.046591027055115,666,"I'm about to teach these humans they can't walk all over us.


Tom Seessel
109 Featherbed Ln
Hopewell NJ 08525
tseessel@verizon.net
(609) 466 2267"
4601,5672,0,7,55,62,1.1129032258064515,0.04052040316035677,666,"Oh, this? No, I'm just in it for the food."
4418,5672,0,7,55,62,1.1129032258064515,0.04052040316035677,666,"Hammertoe, not hammerhead."
4389,5672,1,5,56,62,1.1129032258064515,0.046591027055115,666,This gig economy is getting ridiculous
4358,5672,1,5,56,62,1.1129032258064515,0.046591027055115,666,Let's blow this Popsicle® stand
4296,5672,1,5,56,62,1.1129032258064515,0.046591027055115,666,"The remoras I'd been working with died because of all the plastic and shit in the water, so now I've got this intern fresh out of Oberlin. I can only catch like 50 percent of what he says, but I get the sense he's a total bitch."
4113,5672,0,7,55,62,1.1129032258064515,0.04052040316035677,666,So that's how it feels to be a surfboard.
4191,5672,1,5,56,62,1.1129032258064515,0.046591027055115,666,I’ll flip you
3941,5672,1,5,56,62,1.1129032258064515,0.046591027055115,666,"He said that if I helped him with his beach side theatre installation, he’d get his dad to grant me poaching immunity"
3824,5672,1,5,56,62,1.1129032258064515,0.046591027055115,666,This Thai massage is making me hungry!
3783,5672,1,5,56,62,1.1129032258064515,0.046591027055115,666,"When he proposed, 'Shark Tank,' this is not what I thought he meant!"
4751,5672,0,7,55,62,1.1129032258064515,0.04052040316035677,666,It's a job.
3683,5672,1,5,56,62,1.1129032258064515,0.046591027055115,666,He wanted to wave ‘goodbye’ to his family.
4281,5672,1,5,56,62,1.1129032258064515,0.046591027055115,666,I won’t be a stereotype.
4799,5672,0,7,55,62,1.1129032258064515,0.04052040316035677,666,"Just remember, I prefer them medium rare."
5707,5672,1,5,56,62,1.1129032258064515,0.046591027055115,666,I'm working for Underwater Uber. But meals are included.
4922,5672,0,7,55,62,1.1129032258064515,0.04052040316035677,666,"When I was told I was a cornerstone species, I didn't think that this is what they meant"
5192,5672,0,7,55,62,1.1129032258064515,0.04052040316035677,666,On the count of three I am going to flip him; see if you can get him in one bite!
5229,5672,1,5,56,62,1.1129032258064515,0.046591027055115,666,He's on loan from another shark who owes me fodder.
5248,5672,1,5,56,62,1.1129032258064515,0.046591027055115,666,Please tell me it's just seaweed.
5312,5672,1,5,56,62,1.1129032258064515,0.046591027055115,666,"Yes, it is annoying - but, professional courtesy."
5323,5672,0,7,55,62,1.1129032258064515,0.04052040316035677,666,"I don't think I look like a surfboard either, but here we are."
5459,5672,1,5,56,62,1.1129032258064515,0.046591027055115,666,He promised me sushi from the snack bar.”
5713,5672,1,5,56,62,1.1129032258064515,0.046591027055115,666,Ooh I just love a good Thai massage
5975,5672,0,7,55,62,1.1129032258064515,0.04052040316035677,666,"Nah, I really think it was John Williams' score that made it seem so appealing."
6029,5672,1,5,56,62,1.1129032258064515,0.046591027055115,666,Professional courtesy for lawyers has gone too far.
6065,5672,0,7,55,62,1.1129032258064515,0.04052040316035677,666,Shark Roulette
6117,5672,1,5,56,62,1.1129032258064515,0.046591027055115,666,"Luckily for him, I'm not feeling hungry; I'm too worried about picking up 'athlete's fin.'"
6120,5672,0,7,55,62,1.1129032258064515,0.04052040316035677,666,I really believe that nothing good should be busy.
3601,5672,0,7,55,62,1.1129032258064515,0.04052040316035677,666,Professional courtesy.  He's the guy got Doris and me that condo for half price last year.
4802,5672,1,5,56,62,1.1129032258064515,0.046591027055115,666,No it’s not a foot massage; he’s too dumb to eat.
3329,5672,1,5,56,62,1.1129032258064515,0.046591027055115,666,We're training for a new show called Shark du Soleil.
3234,5672,1,5,56,62,1.1129032258064515,0.046591027055115,666,He’s joining our Law firm.
3141,5672,0,7,55,62,1.1129032258064515,0.04052040316035677,666,I just cannot seem to shake this pain in my neck.
163,5672,1,5,56,62,1.1129032258064515,0.046591027055115,666,"I’m not getting it, I’m sorry."
296,5672,0,7,55,62,1.1129032258064515,0.04052040316035677,666,"Shark to shark - ""you've taken this sobriety this a bit too far!"""
322,5672,0,7,55,62,1.1129032258064515,0.04052040316035677,666,Remember how we were before SeaWorld?
339,5672,1,5,56,62,1.1129032258064515,0.046591027055115,666,I don’t care what you say. His name is Remora and I love him.
426,5672,0,7,55,62,1.1129032258064515,0.04052040316035677,666,Why would I eat him before the massage is finished?
561,5672,1,5,56,62,1.1129032258064515,0.046591027055115,666,I hear he comes from a long line of rodeo performers .
636,5672,1,5,56,62,1.1129032258064515,0.046591027055115,666,He must think I'm stuffed.
672,5672,0,7,55,62,1.1129032258064515,0.04052040316035677,666,He's last name is RAMORA
772,5672,1,5,56,62,1.1129032258064515,0.046591027055115,666,We don't want to evolve into surf boards
1026,5672,1,5,56,62,1.1129032258064515,0.046591027055115,666,He's gonna swim with the fishes for this!
1241,5672,0,7,55,62,1.1129032258064515,0.04052040316035677,666,I'm just waiting until happy hour is over for the main course.
1313,5672,1,5,56,62,1.1129032258064515,0.046591027055115,666,It feels like we’re about 2 feet from the surface.
1344,5672,0,7,55,62,1.1129032258064515,0.04052040316035677,666,I already ate dinner..
1205,5672,1,5,56,62,1.1129032258064515,0.046591027055115,666,"Don't judge, YOLO dude, it's on my bucket list"
1539,5672,0,7,55,62,1.1129032258064515,0.04052040316035677,666,"The A train was broken and Jets were at another rumble, so I took a Shark"
3032,5672,1,5,56,62,1.1129032258064515,0.046591027055115,666,"It's a franchise. If you can eat it, you can wear it."
2969,5672,0,7,55,62,1.1129032258064515,0.04052040316035677,666,So where is your dinner?*
2908,5672,1,5,56,62,1.1129032258064515,0.046591027055115,666,Your turn to jump the shark!
2770,5672,0,7,55,62,1.1129032258064515,0.04052040316035677,666,"Yes, I know... it's a test  to see if strict vegetarianism still helps you feel lighter!"
1400,5672,0,7,55,62,1.1129032258064515,0.04052040316035677,666,You want his left foot or right foot?
2365,5672,0,7,55,62,1.1129032258064515,0.04052040316035677,666,The hardest part is using the rideshare app underwater.
2653,5672,0,7,55,62,1.1129032258064515,0.04052040316035677,666,Really? That's jumping the shark?
2209,5672,0,7,55,62,1.1129032258064515,0.04052040316035677,666,He thinks it's a cool trick - I call it a snack
2148,5672,0,7,55,62,1.1129032258064515,0.04052040316035677,666,"He doesn’t know how to swim. He’s really nice but he doesn’t really get me. If I tell him it’s over, he’s going to be so crushed."
1715,5672,1,5,56,62,1.1129032258064515,0.046591027055115,666,I had a late lunch.
1690,5672,1,5,56,62,1.1129032258064515,0.046591027055115,666,I just can’t seem to shake this thing.
2225,5672,1,5,56,62,1.1129032258064515,0.046591027055115,666,"Don't bite, he promised another Sharknado"
5291,5733,1,5,57,63,1.1111111111111112,0.04588053629154694,666,"My mom takes school spirit week very seriously. You should have seen what she made me wear for ""Crazy Sock Day."""
2513,5733,1,5,57,63,1.1111111111111112,0.04588053629154694,666,It's just for the week Ed.
4455,5733,1,5,57,63,1.1111111111111112,0.04588053629154694,666,"And I thought ""$ 10.00 for an hour of professional ashiatsu massage is actually pretty reasonable""."
4425,5733,1,5,57,63,1.1111111111111112,0.04588053629154694,666,It's either acting as a surfboard or being hunted to extinction
3082,5733,0,7,56,63,1.1111111111111112,0.039912289339283334,666,Did you order the one with the pigeon legs?
2895,5733,1,5,57,63,1.1111111111111112,0.04588053629154694,666,"When he told me that we should reciprocate 'Shark Week' by instating 'Human Week,' I thought it made sense."
2431,5733,1,5,57,63,1.1111111111111112,0.04588053629154694,666,"Sooner or later I'll eat him, but for now it's really helping my back pain."
468,5733,1,5,57,63,1.1111111111111112,0.04588053629154694,666,You would think living in the zoo has at least some perks.
1899,5733,1,5,57,63,1.1111111111111112,0.04588053629154694,666,"he's walking around on those... what do you call them? oh right, sharks. get it? like the little mermaid? i should probably keep working on it. the All-Ocean Comedy Contest is still a week away. what's that? sure i'll go into detail about my comedy!"
2002,5733,0,7,56,63,1.1111111111111112,0.039912289339283334,666,"No one really understands until they've experienced this guy's feet doing a deep, deep pre-dorsal massage."
1499,5743,0,7,57,64,1.109375,0.039322054350368486,666,The price of gas must have gone  up again....
2665,5744,0,8,66,74,1.1081081081081081,0.03634325417788381,666,So is name Fut Fin or what?
3918,5745,1,5,59,65,1.1076923076923078,0.04452244962611625,666,This Sharkitsu Massage is another interwet scam!
5769,5746,1,5,60,66,1.106060606060606,0.04387303082685012,666,They say a human foot massage every so often is good for the cartilage.
3725,5746,0,7,59,66,1.106060606060606,0.038192176787049927,666,"I wish I had a really good reason to ask him to move... like, 'You're blocking my blowhole.'"
3989,5748,1,4,54,59,1.1016949152542372,0.0464704883270233,666,I don't have the heart to tell him that no shark is an island.
4757,5748,0,6,53,59,1.1016949152542372,0.03968693424047915,666,"For a Costco-size bag of Cheetos I gave Barron 60 minutes to keep Donald here,but WTF, let's just trade him back and forth for the hell of it."
3966,5748,2,2,55,59,1.1016949152542372,0.052382819905918594,666,Scuber driver.
4212,5748,0,6,53,59,1.1016949152542372,0.03968693424047915,666,I'M going to do a back flip.
4499,5748,0,6,53,59,1.1016949152542372,0.03968693424047915,666,Apparently the show hasn't jumped the shark yet.
4520,5748,0,6,53,59,1.1016949152542372,0.03968693424047915,666,"He's warning Cape Codders to stay out of the water"""
4531,5748,0,6,53,59,1.1016949152542372,0.03968693424047915,666,"Sorry, no walk-ins.  And it’s pronounced ‘Ashiatsu.’"
4746,5748,0,6,53,59,1.1016949152542372,0.03968693424047915,666,It relieves tension.
3724,5748,0,6,53,59,1.1016949152542372,0.03968693424047915,666,It's carry your lunch to school day!
4105,5748,1,4,54,59,1.1016949152542372,0.0464704883270233,666,My back itches.
4786,5748,0,6,53,59,1.1016949152542372,0.03968693424047915,666,Well I started driving for Lyft.
5350,5748,1,4,54,59,1.1016949152542372,0.0464704883270233,666,Now let's see if he can do that with one leg.
5194,5748,0,6,53,59,1.1016949152542372,0.03968693424047915,666,I'm two feet under water.
5297,5748,1,4,54,59,1.1016949152542372,0.0464704883270233,666,The hubby's birthday gift - exfoliation by natural species.
6226,5748,1,4,54,59,1.1016949152542372,0.0464704883270233,666,"He thinks I'm his surfboard, but that's all part of the plan."
5488,5748,0,6,53,59,1.1016949152542372,0.03968693424047915,666,I’m with Uber. Are you Lyft?
5491,5748,0,6,53,59,1.1016949152542372,0.03968693424047915,666,Don’t go in for the kill until I get to see his expressions.
5549,5748,0,6,53,59,1.1016949152542372,0.03968693424047915,666,Don't eat him until I get the tip receipt back from Uber.
5604,5748,1,4,54,59,1.1016949152542372,0.0464704883270233,666,The remora were making me itch.
5699,5748,0,6,53,59,1.1016949152542372,0.03968693424047915,666,I have an itch.
5757,5748,0,6,53,59,1.1016949152542372,0.03968693424047915,666,"Whadya mean, standing room only?"
6109,5748,0,6,53,59,1.1016949152542372,0.03968693424047915,666,Happy Anniversary!
3702,5748,1,4,54,59,1.1016949152542372,0.0464704883270233,666,"So, I have weak boundaries. Whaddaya gonna do? We’ll eat him next time."
4934,5748,1,4,54,59,1.1016949152542372,0.0464704883270233,666,"At least I'm not alone, shark!"
2923,5748,0,6,53,59,1.1016949152542372,0.03968693424047915,666,He's not a pilot fish?
859,5748,0,6,53,59,1.1016949152542372,0.03968693424047915,666,He calls himself Mr Magoo.
2525,5748,0,6,53,59,1.1016949152542372,0.03968693424047915,666,"You know I love that humans are less scared of us because all those documentaries, but this is a bit too far"
2859,5748,0,6,53,59,1.1016949152542372,0.03968693424047915,666,He can't swim!
43,5748,0,6,53,59,1.1016949152542372,0.03968693424047915,666,"He's a New Yorker, holds on with a straphanger."
430,5748,1,4,54,59,1.1016949152542372,0.0464704883270233,666,I think this must be à la cartilage.
442,5748,0,6,53,59,1.1016949152542372,0.03968693424047915,666,He should be lucky I’m not hungry
681,5748,1,4,54,59,1.1016949152542372,0.0464704883270233,666,"I'm working for Uber. Free snacks, if you catch my drift."
950,5748,0,6,53,59,1.1016949152542372,0.03968693424047915,666,Do you know what a remora fish is?
976,5748,1,4,54,59,1.1016949152542372,0.0464704883270233,666,"No, if you bite him in half, I'll have to make two trips."
1170,5748,1,4,54,59,1.1016949152542372,0.0464704883270233,666,"I told you, I get no respect."
1196,5748,0,6,53,59,1.1016949152542372,0.03968693424047915,666,"I’ve got a stupid one. What do you suggest?

Don Dechman 
Austin, T"
1373,5748,0,6,53,59,1.1016949152542372,0.03968693424047915,666,When I become a Gefilte Fish he'll be replaced by a carrot.
975,5748,1,4,54,59,1.1016949152542372,0.0464704883270233,666,I'm trying to make some extra money doing this rideshare thing.
1615,5748,1,4,54,59,1.1016949152542372,0.0464704883270233,666,"The worst part is that he insists I call him ""Danprey."""
1620,5748,2,2,55,59,1.1016949152542372,0.052382819905918594,666,Waist not...want not...
1734,5748,1,4,54,59,1.1016949152542372,0.0464704883270233,666,Remoras are sooooo passé.
1968,5748,0,6,53,59,1.1016949152542372,0.03968693424047915,666,I'm hoping this will help me sleep.
2001,5748,1,4,54,59,1.1016949152542372,0.0464704883270233,666,The fin just scared them.
2101,5748,1,4,54,59,1.1016949152542372,0.0464704883270233,666,He is convinced Mr. Wonderful will be impressed on Shark Tank.
2113,5748,1,4,54,59,1.1016949152542372,0.0464704883270233,666,This is the price I have to pay for a decent back rub.
2195,5748,1,4,54,59,1.1016949152542372,0.0464704883270233,666,Would you mind helping my passenger off so I can eat him?
1393,5748,1,4,54,59,1.1016949152542372,0.0464704883270233,666,"Then I'll do a double flip in the air and he'll land on your nose, arms outstretched but steady."
2330,5748,0,6,53,59,1.1016949152542372,0.03968693424047915,666,Didn't you pack a lunch?
5672,5796,1,5,63,69,1.1014492753623188,0.042033394835877404,666,I'm just trying to keep my head above water.
4135,5797,0,6,54,60,1.1,0.03905667329424718,666,I’m saving the bottom half for supper.
4328,5797,0,6,54,60,1.1,0.03905667329424718,666,Wait 'til you see what happens when I flip my head up.
4902,5797,0,6,54,60,1.1,0.03905667329424718,666,This dude’s so lame he couldn’t even jump the shark!
5743,5797,0,6,54,60,1.1,0.03905667329424718,666,Jake got the guy's upper half.
5267,5797,0,6,54,60,1.1,0.03905667329424718,666,"He said he was an ashiatsu massage therapist, but I think he just wanted to show off for his girlfriend."
5526,5797,1,4,55,60,1.1,0.04572084295183095,666,It was either this or Chairing the Truth and Reconciliation Commission
4129,5797,0,6,54,60,1.1,0.03905667329424718,666,It's a trophy I got when we beat the hammerheads.
5038,5797,1,4,55,60,1.1,0.04572084295183095,666,We’re practicing for the new olympics event.  After my lunch is practice for the special olympics.
3319,5797,1,4,55,60,1.1,0.04572084295183095,666,Being a Uber driver has its advantages in cutting down preying time
410,5797,0,6,54,60,1.1,0.03905667329424718,666,I've been sharking for Uber
3097,5797,1,4,55,60,1.1,0.04572084295183095,666,Malaysian Airlines?
2783,5797,0,6,54,60,1.1,0.03905667329424718,666,As long as he's up there I have a snack available any time I'm hungry
2405,5797,0,6,54,60,1.1,0.03905667329424718,666,"'Cheryl, you need to get off my back about some guy being on my back'"
1977,5797,0,6,54,60,1.1,0.03905667329424718,666,"Don't look at me that way.  I told you it's the new ""gig"" economy"
1330,5797,0,6,54,60,1.1,0.03905667329424718,666,Sorry can't join you... I brought my lunch today.
823,5797,0,6,54,60,1.1,0.03905667329424718,666,The growth started off Fukushima!
3263,5797,0,6,54,60,1.1,0.03905667329424718,666,Go ahead if you want. It's the state pen's field trip to the beach today and my wife's got me eating cage-free only!
4863,5814,1,4,57,62,1.096774193548387,0.0442916958370775,666,"For lunch, what's your preference: his fatty butt or his skinny legs?"
5918,5815,0,5,51,56,1.0892857142857142,0.038450387280282515,666,"He said, if I don't keep swimming, the relationship will die."
4932,5815,1,3,52,56,1.0892857142857142,0.04612789753884693,666,It's the latest in lures.
3969,5815,0,5,51,56,1.0892857142857142,0.038450387280282515,666,It's better than traditional ashiatsu because it comes with a snack at the end.
670,5815,0,5,51,56,1.0892857142857142,0.038450387280282515,666,"It's called ""native advertising"""
3773,5815,0,5,51,56,1.0892857142857142,0.038450387280282515,666,"I’d eat him, but the shiatsu’s too good."
5339,5820,1,4,63,68,1.088235294117647,0.04049352107666846,666,I just downloaded the Uber partner app and thry climb right on.
5811,5821,0,5,52,57,1.087719298245614,0.037802263481198896,666,You called Shuber Eats?
5337,5821,0,5,52,57,1.087719298245614,0.037802263481198896,666,I've been looking all over for a hat like that.
4515,5821,0,5,52,57,1.087719298245614,0.037802263481198896,666,I thought you WANTED a half-order!
3647,5821,0,5,52,57,1.087719298245614,0.037802263481198896,666,"We're going to need a bigger fridge."""
2926,5821,0,5,52,57,1.087719298245614,0.037802263481198896,666,This ride sharing fad is getting out of control.
2512,5821,1,3,53,57,1.087719298245614,0.04533847748151766,666,I was hungry. Now I'm just mad.
2081,5821,0,5,52,57,1.087719298245614,0.037802263481198896,666,I picked up some take-out at the beach.
2047,5821,0,5,52,57,1.087719298245614,0.037802263481198896,666,The top half was  delicious.You can have the rest.
1681,5821,0,5,52,57,1.087719298245614,0.037802263481198896,666,My mom is the harshest disciplinarian in the sea.
2920,5821,1,3,53,57,1.087719298245614,0.04533847748151766,666,...And he's got a monkey on his.
4621,5831,0,4,50,54,1.0740740740740742,0.035973550457676445,666,"In the absence of playing cards, this is the only way I could come up with to to play Oklahoma Forehead."
4533,5831,0,4,50,54,1.0740740740740742,0.035973550457676445,666,"And what's worse, there's no tipping."
4476,5831,0,4,50,54,1.0740740740740742,0.035973550457676445,666,you know?... everybody needs its own realm of dignity!
4210,5831,0,4,50,54,1.0740740740740742,0.035973550457676445,666,This is not my idea of surfing.
4189,5831,0,4,50,54,1.0740740740740742,0.035973550457676445,666,Someday they'll discover there's no such thing as a sandbar
4177,5831,1,2,51,54,1.0740740740740742,0.044642002106734975,666,You’ve never heard of an Ottoman shark?
4173,5831,0,4,50,54,1.0740740740740742,0.035973550457676445,666,It's a new swim-share called UNDR. It helps pay the bills.
6253,5831,1,2,51,54,1.0740740740740742,0.044642002106734975,666,He says that he is just along for the ride.
4134,5831,0,4,50,54,1.0740740740740742,0.035973550457676445,666,This is gonna be jawesome!
4114,5831,0,4,50,54,1.0740740740740742,0.035973550457676445,666,"Oh, the burden of humanity"
4106,5831,0,4,50,54,1.0740740740740742,0.035973550457676445,666,"Man, fuck this guy."
3873,5831,0,4,50,54,1.0740740740740742,0.035973550457676445,666,"Underwater UBER, I'm swimming back and forth anyway plus you get fisherman insurance protection."
3741,5831,1,2,51,54,1.0740740740740742,0.044642002106734975,666,I swear one more time he sings baby shark du doo du I will eat him up.
3739,5831,1,2,51,54,1.0740740740740742,0.044642002106734975,666,Wait...wait...OK!
3728,5831,1,2,51,54,1.0740740740740742,0.044642002106734975,666,I have a case of buyer’s remora.
3691,5831,0,4,50,54,1.0740740740740742,0.035973550457676445,666,It makes my back feel so much better.
3518,5831,1,2,51,54,1.0740740740740742,0.044642002106734975,666,I'll flip him and we can share
3139,5831,1,2,51,54,1.0740740740740742,0.044642002106734975,666,Right now it's all hearts and minds.
3105,5831,0,4,50,54,1.0740740740740742,0.035973550457676445,666,"Oh yeah? Well, You step on me metaphorically everyday"
4124,5831,0,4,50,54,1.0740740740740742,0.035973550457676445,666,I know it's not good for me but I just can't shake it.
4646,5831,0,4,50,54,1.0740740740740742,0.035973550457676445,666,"Oh my gosh Carol, these dry heels are killing me!"
4744,5831,1,2,51,54,1.0740740740740742,0.044642002106734975,666,You ordered dark meat!
4787,5831,0,4,50,54,1.0740740740740742,0.035973550457676445,666,He says he's not ready to jump.
2957,5831,0,4,50,54,1.0740740740740742,0.035973550457676445,666,"It's called 47 Meters Down.  It's a typical summer ""shark"" movie. Is it degrading? Well yes, but money's been tight, and you have to start somewhere in Hollywood."
6209,5831,0,4,50,54,1.0740740740740742,0.035973550457676445,666,"It's kinda like a Lyft gig, I run him over to Martha's Vineyard, hang around the beach for awhile, pick him up at 5:00 and take him back home. The only difference is, I eat him on the way back ."
6168,5831,1,2,51,54,1.0740740740740742,0.044642002106734975,666,"Well Jack, Hume In-n-Out only had legs left. They were out of torsos....... Again!"
6039,5831,1,2,51,54,1.0740740740740742,0.044642002106734975,666,"As a second job, being a Scuber driver is good for the cash but pretty humiliating"
5928,5831,1,2,51,54,1.0740740740740742,0.044642002106734975,666,You can also tip me in-app.
5822,5831,0,4,50,54,1.0740740740740742,0.035973550457676445,666,Sometimes I regret reading Kant.
5788,5831,0,4,50,54,1.0740740740740742,0.035973550457676445,666,"Ahhh, shiatsu massage is my favorite."
5777,5831,1,2,51,54,1.0740740740740742,0.044642002106734975,666,Do I look like a Carpet Shark to you?
5659,5831,0,4,50,54,1.0740740740740742,0.035973550457676445,666,Wanna come watch the swimmers when the two of us hit the beach?
5624,5831,1,2,51,54,1.0740740740740742,0.044642002106734975,666,No way! But you can have the wings and breasts.
5603,5831,0,4,50,54,1.0740740740740742,0.035973550457676445,666,He said he is looking for the site of a new movie.
5558,5831,0,4,50,54,1.0740740740740742,0.035973550457676445,666,"do you think I should eat him now, or should I wait for him to fatten up?"
5497,5831,1,2,51,54,1.0740740740740742,0.044642002106734975,666,I'm afraid I'm gonna put my foot in my mouth.
5489,5831,1,2,51,54,1.0740740740740742,0.044642002106734975,666,"You see son, this is what happens when ""Shark Attacks"" go down."
5296,5831,0,4,50,54,1.0740740740740742,0.035973550457676445,666,He likes to think he's protecting us against Quint.
5054,5831,1,2,51,54,1.0740740740740742,0.044642002106734975,666,Apparently seeing Trump's head & bare chest is scarier than seeing a shark fin.
4915,5831,0,4,50,54,1.0740740740740742,0.035973550457676445,666,I'm getting half of his Speedo endorsement.
4907,5831,1,2,51,54,1.0740740740740742,0.044642002106734975,666,"It's a new ride service. The pay isn't great, but there is always food on the table."
4842,5831,0,4,50,54,1.0740740740740742,0.035973550457676445,666,"Yes, I get tired of it...but a deal is a deal."
4728,5831,0,4,50,54,1.0740740740740742,0.035973550457676445,666,"He can't swim but says I'm definitely lactose intolerant. 
Does that really mean I can't eat meat?"
2742,5831,0,4,50,54,1.0740740740740742,0.035973550457676445,666,They pay me in sushi so it's a good deal.
1669,5831,0,4,50,54,1.0740740740740742,0.035973550457676445,666,I'm hoping the resistance training will help my vertical leap.
2601,5831,0,4,50,54,1.0740740740740742,0.035973550457676445,666,"It’s kind of like a back rub.  I don’t think he’d be tasty anyway.
Smelly feet."
1155,5831,1,2,51,54,1.0740740740740742,0.044642002106734975,666,"And we've still got a little old woman, a little old man, a barn full of threshers, a field full of mowers, a cow and a pig."
1128,5831,1,2,51,54,1.0740740740740742,0.044642002106734975,666,"I'll flip him, you catch."
1126,5831,1,2,51,54,1.0740740740740742,0.044642002106734975,666,"You've got to give me a holiday, I'm breaking my back here!"
1062,5831,1,2,51,54,1.0740740740740742,0.044642002106734975,666,"This was your branding idea for a calmer, gentler species; now can we make him disappear?"
1025,5831,0,4,50,54,1.0740740740740742,0.035973550457676445,666,"2 more sessions and I'll be good as new"" 
"" I told you to stay away from those rip currents"
846,5831,0,4,50,54,1.0740740740740742,0.035973550457676445,666,It helps loosen up my back muscles.
725,5831,0,4,50,54,1.0740740740740742,0.035973550457676445,666,He's like a horse-whisperer but for sharks.
654,5831,0,4,50,54,1.0740740740740742,0.035973550457676445,666,"‘ i wouldn’t bother, i hear they’re high in cholesterol’"
590,5831,0,4,50,54,1.0740740740740742,0.035973550457676445,666,Ate half. Are you hungry for the rest?
530,5831,1,2,51,54,1.0740740740740742,0.044642002106734975,666,I gave him my word that he will be able to keep his head above water level...
499,5831,0,4,50,54,1.0740740740740742,0.035973550457676445,666,"I already ate the last guy’s legs, Greg."
401,5831,0,4,50,54,1.0740740740740742,0.035973550457676445,666,This surfer is going for a new record.
320,5831,1,2,51,54,1.0740740740740742,0.044642002106734975,666,"Have you heard of Unter? It's like Uber, but for fish."
272,5831,1,2,51,54,1.0740740740740742,0.044642002106734975,666,Remora! I’m sick of remora!
140,5831,0,4,50,54,1.0740740740740742,0.035973550457676445,666,Do you remora me?
137,5831,0,4,50,54,1.0740740740740742,0.035973550457676445,666,"The vegan diet has been going well, but I don’t see it lasting much longer."
107,5831,0,4,50,54,1.0740740740740742,0.035973550457676445,666,Attenborough just won't get off my back.
7,5831,0,4,50,54,1.0740740740740742,0.035973550457676445,666,I'm going to brutally maim this bastard on top of me....friggen savage
2708,5831,0,4,50,54,1.0740740740740742,0.035973550457676445,666,"""It's like Uber, but for fish"
1188,5831,0,4,50,54,1.0740740740740742,0.035973550457676445,666,"I know, but he says it's a casting interview."
1209,5831,0,4,50,54,1.0740740740740742,0.035973550457676445,666,"He ain't heavy, he's my brother-in-law."
340,5831,0,4,50,54,1.0740740740740742,0.035973550457676445,666,"I know, Walter, I know. Just let these burdens roll off my shoulders!"
1435,5831,0,4,50,54,1.0740740740740742,0.035973550457676445,666,"baby shark, more like ""annoyed shark doo, doo, do, do, do, doo"""
1297,5831,1,2,51,54,1.0740740740740742,0.044642002106734975,666,We're running low on toothpicks. Do you want this one?
2595,5831,1,2,51,54,1.0740740740740742,0.044642002106734975,666,"Well, why on Earth would you suggest standing desks?"
2205,5831,0,4,50,54,1.0740740740740742,0.035973550457676445,666,It's not scratchy enough.
2097,5831,0,4,50,54,1.0740740740740742,0.035973550457676445,666,Climate change and the Uber strike provided an opportunity...doo doo doo doo doo doo!
2045,5831,0,4,50,54,1.0740740740740742,0.035973550457676445,666,Sssssh. Don't disturb our Dinner. He is drunk
1990,5831,0,4,50,54,1.0740740740740742,0.035973550457676445,666,"What do you think, should we make the earth move for this clueless guy?"
1981,5831,1,2,51,54,1.0740740740740742,0.044642002106734975,666,I don’t think he realizes Seaworld is just a show
1929,5831,0,4,50,54,1.0740740740740742,0.035973550457676445,666,I’ve been promoted from a skate board to a skate shark!
1775,5831,0,4,50,54,1.0740740740740742,0.035973550457676445,666,He’s just hitching a ride.
2012,5831,1,2,51,54,1.0740740740740742,0.044642002106734975,666,We met at a vegetarian support group. I am helping him show his friends that he can walk on water.
1738,5831,0,4,50,54,1.0740740740740742,0.035973550457676445,666,"It's called ""shurfing"" and I don't like it one bit."
1719,5831,1,2,51,54,1.0740740740740742,0.044642002106734975,666,"I feel the urge to scratch, but lack the appendages to make it happen."
1685,5831,1,2,51,54,1.0740740740740742,0.044642002106734975,666,"OK, but I get the top half."
1649,5831,0,4,50,54,1.0740740740740742,0.035973550457676445,666,It’s my version of the bite squad.
1611,5831,0,4,50,54,1.0740740740740742,0.035973550457676445,666,"You can have this one, he's not heavy enough for me."
1577,5831,0,4,50,54,1.0740740740740742,0.035973550457676445,666,I 'm no longer practicing law. I'm trying Uber for a while.
1562,5831,1,2,51,54,1.0740740740740742,0.044642002106734975,666,I know but I don't like to eat between meals.
1529,5831,0,4,50,54,1.0740740740740742,0.035973550457676445,666,Stop.  This is just my side hustle.
1761,5831,1,2,51,54,1.0740740740740742,0.044642002106734975,666,You can eat the bottom half.
1514,5831,0,4,50,54,1.0740740740740742,0.035973550457676445,666,He's all yours if I can leave early tomorrow.
4036,5920,0,3,47,50,1.06,0.033926691677251195,666,"Shall I ‘share’ him and his cranial-sacral work, with you?"
4063,5920,0,3,47,50,1.06,0.033926691677251195,666,I am your better half!
4137,5920,0,3,47,50,1.06,0.033926691677251195,666,"Sure, I can eat it at anytime, but the ashiatsu is worth the wait!"
4224,5920,0,3,47,50,1.06,0.033926691677251195,666,Marinating them in salt water helps tenderize the meat.
4341,5920,0,3,47,50,1.06,0.033926691677251195,666,This ride share business is for the birds.
4602,5920,0,3,47,50,1.06,0.033926691677251195,666,"I let the last guy ""walk on water"" first, and then I ate him!"
4434,5920,0,3,47,50,1.06,0.033926691677251195,666,"Your foot fetish is bigger than your stomach, Donald."
4512,5920,1,1,48,50,1.06,0.04435478484645721,666,"He is not worth eating ,he is on prednisone ."
4663,5920,1,1,48,50,1.06,0.04435478484645721,666,Works better as a line in Rilke's poem.  Actually standing on a fish is slippery and stinky!
3922,5920,0,3,47,50,1.06,0.033926691677251195,666,"Wait, Joey, you can’t bail on the chicken fight now!!!"
4678,5920,0,3,47,50,1.06,0.033926691677251195,666,Shark Week Uber
4420,5920,0,3,47,50,1.06,0.033926691677251195,666,"Well, you know me, he asked for a last request so I just had to."
3913,5920,0,3,47,50,1.06,0.033926691677251195,666,I'd jump through hoops to get back into the viewing tank.
3268,5920,0,3,47,50,1.06,0.033926691677251195,666,Uber or Lyft?
3785,5920,0,3,47,50,1.06,0.033926691677251195,666,It's Fonzie!
3708,5920,1,1,48,50,1.06,0.04435478484645721,666,Always check the fine print on timeshare agreements.
3665,5920,0,3,47,50,1.06,0.033926691677251195,666,I’m leaving the other half for the gulls.
3661,5920,0,3,47,50,1.06,0.033926691677251195,666,Wasn't this part of the pool deeper?
3560,5920,0,3,47,50,1.06,0.033926691677251195,666,"What does ""Executive Privilege"" mean?"
3434,5920,0,3,47,50,1.06,0.033926691677251195,666,"I used to be a hammerhead, now I'm just a hammer toed shark."
3425,5920,0,3,47,50,1.06,0.033926691677251195,666,"Yeah, it's professional courtesy, basically."
3395,5920,0,3,47,50,1.06,0.033926691677251195,666,Man:is this my surf board?!!!
3354,5920,0,3,47,50,1.06,0.033926691677251195,666,This shark-hailing business is killing me.
3195,5920,0,3,47,50,1.06,0.033926691677251195,666,‘’Just another passing fad…like planking …sigh.”
3061,5920,1,1,48,50,1.06,0.04435478484645721,666,It’s my dorsal feet
2872,5920,0,3,47,50,1.06,0.033926691677251195,666,You should really try going vegan.
4806,5920,0,3,47,50,1.06,0.033926691677251195,666,Don't look now; there's a monkey on your back.
3850,5920,0,3,47,50,1.06,0.033926691677251195,666,See you in court.  My guy will be above water.
4831,5920,0,3,47,50,1.06,0.033926691677251195,666,Would you like your human raw or seared?
5904,5920,0,3,47,50,1.06,0.033926691677251195,666,Bite safety? Talk to Uber. They're the ones taking a bite out of ride-share compensation.
4923,5920,0,3,47,50,1.06,0.033926691677251195,666,I can’t decide between the meal or the delivery guy.
6310,5920,0,3,47,50,1.06,0.033926691677251195,666,They don't get that the plastic isn't the real problem.
6275,5920,0,3,47,50,1.06,0.033926691677251195,666,He’s with the crew of ‘Shark Week’
6250,5920,0,3,47,50,1.06,0.033926691677251195,666,You've lost your mascot!
6240,5920,0,3,47,50,1.06,0.033926691677251195,666,How could I say ‘no’ to Mark Cuban?
6129,5920,0,3,47,50,1.06,0.033926691677251195,666,"What are you lookin’ at, you never heard of Uber?"
6069,5920,0,3,47,50,1.06,0.033926691677251195,666,"Yea, I know it's bad for our image, but I'm vegan now."
5998,5920,0,3,47,50,1.06,0.033926691677251195,666,Just doing some pro bono work at the latest sunami
2848,5920,0,3,47,50,1.06,0.033926691677251195,666,"Now that they all have cell phones, the thrill of the hunt is gone."
5859,5920,0,3,47,50,1.06,0.033926691677251195,666,Eat him! What an appalling idea! You won't find a better Ashiatsu master for miles!
5726,5920,0,3,47,50,1.06,0.033926691677251195,666,"This Ashiatsu massage is the only relief after working another episode of ""Shark Tank"""
5640,5920,0,3,47,50,1.06,0.033926691677251195,666,Just earning some extra chum through Uber
5619,5920,0,3,47,50,1.06,0.033926691677251195,666,I'm starting to drown so i might as well even him
5502,5920,0,3,47,50,1.06,0.033926691677251195,666,He's doing important research.
5453,5920,0,3,47,50,1.06,0.033926691677251195,666,Where does he think he is? Sea World?
5432,5920,0,3,47,50,1.06,0.033926691677251195,666,Who let him into the shark tank.
5372,5920,0,3,47,50,1.06,0.033926691677251195,666,"The hot stones were nice, but this is just unnecessary."
5358,5920,0,3,47,50,1.06,0.033926691677251195,666,"You like drumsticks, so I saved these for you.

Don Smith
Repton, Alabama"
5320,5920,0,3,47,50,1.06,0.033926691677251195,666,And we thought that eating their surfboards would make them go away...
5273,5920,0,3,47,50,1.06,0.033926691677251195,666,I really cant believe I've been mistaken for Shamu
5171,5920,0,3,47,50,1.06,0.033926691677251195,666,"I know.  After our next America,s got Talent 
Performance I'm gonna eat him."
5143,5920,0,3,47,50,1.06,0.033926691677251195,666,I signed up for one of those SharkShare programs. The benefits are terrible but at least I make my own hours.
5086,5920,0,3,47,50,1.06,0.033926691677251195,666,He said just to consider him a harmless parasite and swim around a little while.
5051,5920,0,3,47,50,1.06,0.033926691677251195,666,"A candidate for the Darwin Award? 

I shouldn’t have signed up for Uber!"
5014,5920,0,3,47,50,1.06,0.033926691677251195,666,"I know, I know, but I promised my wife no more attacks"
5012,5920,0,3,47,50,1.06,0.033926691677251195,666,Can you foot this one? My patience has run fin.
4968,5920,0,3,47,50,1.06,0.033926691677251195,666,Tourists- they'll stand on anything they can find.
4941,5920,0,3,47,50,1.06,0.033926691677251195,666,This new Uber pool gig isn't really working out for me.
4891,5920,0,3,47,50,1.06,0.033926691677251195,666,It's take away.
2834,5920,0,3,47,50,1.06,0.033926691677251195,666,Whatever happened to just plain old paddle boarding?
4238,5920,0,3,47,50,1.06,0.033926691677251195,666,"This new ""ride the shark"" attraction isn't eco-tourism, it's bull shark."
2819,5920,0,3,47,50,1.06,0.033926691677251195,666,Your DoorDash order is here.
1732,5920,0,3,47,50,1.06,0.033926691677251195,666,"His idea is to jump from one of us to the other and back, for the idiots watching through the glass.  Let's drop him."
1730,5920,0,3,47,50,1.06,0.033926691677251195,666,Oprah's giving everyone a piece.  You want a leg or a wing?
1720,5920,0,3,47,50,1.06,0.033926691677251195,666,"I’ve always wanted to “hang ten,” but I’ve never been able to resist eating them."
1682,5920,0,3,47,50,1.06,0.033926691677251195,666,Now I'm looking for something to top it off.
1654,5920,0,3,47,50,1.06,0.033926691677251195,666,Would you prefer the top half or the bottom half ?
1506,5920,0,3,47,50,1.06,0.033926691677251195,666,My wife is making me try this vegetarian thing...
1383,5920,0,3,47,50,1.06,0.033926691677251195,666,Something's been weighing on my mind recently ...
1163,5920,0,3,47,50,1.06,0.033926691677251195,666,I've got to stop being an Uber driver in my spare time...
1108,5920,0,3,47,50,1.06,0.033926691677251195,666,What a terrible weight on my back! Can you bite him please?
1037,5920,0,3,47,50,1.06,0.033926691677251195,666,I'm beta testing a new combination rideshare and meal delivery service. It's called Uber Blacktip Eats.
992,5920,0,3,47,50,1.06,0.033926691677251195,666,My school only serves vegan now.
900,5920,0,3,47,50,1.06,0.033926691677251195,666,Let's wishbone him Bud!
895,5920,0,3,47,50,1.06,0.033926691677251195,666,Let's hear his pitch before we devour him.
1739,5920,0,3,47,50,1.06,0.033926691677251195,666,Can you do it? I don't have the heart to tell him.
894,5920,0,3,47,50,1.06,0.033926691677251195,666,He's obviously never read The Gingerbread Man.
728,5920,0,3,47,50,1.06,0.033926691677251195,666,Get off my back Dad!
538,5920,0,3,47,50,1.06,0.033926691677251195,666,I'm saving these bits till last.
477,5920,0,3,47,50,1.06,0.033926691677251195,666,I was full after eating the breast and wings
415,5920,0,3,47,50,1.06,0.033926691677251195,666,"Hey, look at this: They double as a backscratcher!""
""Don't play with your food, Kevin."
341,5920,1,1,48,50,1.06,0.04435478484645721,666,"If you must know, it’s a dorsal Huck."
314,5920,0,3,47,50,1.06,0.033926691677251195,666,"Pull the shorts down, it said, pant-ing."
304,5920,1,1,48,50,1.06,0.04435478484645721,666,"I told you, you should have worn shorts."
222,5920,0,3,47,50,1.06,0.033926691677251195,666,They’re less afraid of us since ‘Baby Shark.’
216,5920,0,3,47,50,1.06,0.033926691677251195,666,These waters suffer from foot fungus.
127,5920,0,3,47,50,1.06,0.033926691677251195,666,"Doctor Fish, Nurse Shark, a pedicure's a pedicure."
40,5920,0,3,47,50,1.06,0.033926691677251195,666,"George and I just have to learn to adjust, that's all."
3,5920,0,3,47,50,1.06,0.033926691677251195,666,It’s shark surfin USA.
2827,5920,0,3,47,50,1.06,0.033926691677251195,666,I am getting paid by Uber.
816,5920,0,3,47,50,1.06,0.033926691677251195,666,He thinks he’s Aquaman and I was full.
1756,5920,0,3,47,50,1.06,0.033926691677251195,666,"Honey, not vegetarian tonight."
439,5920,0,3,47,50,1.06,0.033926691677251195,666,"It’s the ‘Treading Deep Water Massage’.  You have to try it, really limbers you up for attack."
1860,5920,0,3,47,50,1.06,0.033926691677251195,666,We can eat after the message is done.
2753,5920,0,3,47,50,1.06,0.033926691677251195,666,This and with a monetary donation. I feel we need to support humans with special needs.
1838,5920,0,3,47,50,1.06,0.033926691677251195,666,What ever you do don’t make any sudden movements
2724,5920,1,1,48,50,1.06,0.04435478484645721,666,Give me a little time...I'm still digesting the top half!
2715,5920,0,3,47,50,1.06,0.033926691677251195,666,I'm prepping ingredients for tonight's human fin soup.  That's why.
2694,5920,0,3,47,50,1.06,0.033926691677251195,666,You hungry?
2679,5920,0,3,47,50,1.06,0.033926691677251195,666,They taste better if a little sun-warmed.
2632,5920,0,3,47,50,1.06,0.033926691677251195,666,Buzz off -- he's on the lookout for fish.
2619,5920,0,3,47,50,1.06,0.033926691677251195,666,"Hurry up to the water-sports center, such smorgas-boards are their new thing"""
2557,5920,0,3,47,50,1.06,0.033926691677251195,666,I can't stand humans but they can sure stand me.
2534,5920,0,3,47,50,1.06,0.033926691677251195,666,"I Know ! I know !! 
He is too skinny. I hired him to
find me dinner."
2477,5920,0,3,47,50,1.06,0.033926691677251195,666,I'll bet you a fin I could  throw him off.
2455,5920,0,3,47,50,1.06,0.033926691677251195,666,Going vegan is really killing my mojo!
2416,5920,0,3,47,50,1.06,0.033926691677251195,666,I'm building my social media presence.
2384,5920,0,3,47,50,1.06,0.033926691677251195,666,The doctor said it's just growing pains.
2658,5920,0,3,47,50,1.06,0.033926691677251195,666,"Shark:"" Sorry Jeff! Shark Uber is the latest boat transportation!"""
2340,5920,0,3,47,50,1.06,0.033926691677251195,666,Uber.
2366,5920,0,3,47,50,1.06,0.033926691677251195,666,Is he worth attacking?
1900,5920,0,3,47,50,1.06,0.033926691677251195,666,I get the middle part.
2073,5920,0,3,47,50,1.06,0.033926691677251195,666,"I dunno, man - sometimes it's just too easy."
2074,5920,1,1,48,50,1.06,0.04435478484645721,666,And then they wonder why we attach.
1910,5920,0,3,47,50,1.06,0.033926691677251195,666,"I was already depressed. Now this idiot's treating me like I'm an underwater uber! Bite me,Georgie. Just bite me!"
2160,5920,0,3,47,50,1.06,0.033926691677251195,666,"What with Ubereats and Grubhub, I can’t compete."
2111,5920,0,3,47,50,1.06,0.033926691677251195,666,Must be Uber Ocean summer surge.
2178,5920,0,3,47,50,1.06,0.033926691677251195,666,Are you ready for lunch?
2247,5920,0,3,47,50,1.06,0.033926691677251195,666,"With the orcas leaving, there’s an opening at SeaWorld.”"
2276,5920,0,3,47,50,1.06,0.033926691677251195,666,Serve man?  Get a life.
2291,5920,0,3,47,50,1.06,0.033926691677251195,666,"Contrary to what people believe, it's not easy being a shark!"
2297,5920,0,3,47,50,1.06,0.033926691677251195,666,We have a fee-sharing arrangement.
4235,6042,0,2,45,47,1.0425531914893618,0.029760791752350448,666,Would you please eat at least one of his legs? I promise to share the rest of him.
4165,6042,0,2,45,47,1.0425531914893618,0.029760791752350448,666,He's been standing on me all day...how long until I can eat him?
4242,6042,0,2,45,47,1.0425531914893618,0.029760791752350448,666,Finding someone to give house call massages is harder than you think.
4251,6042,0,2,45,47,1.0425531914893618,0.029760791752350448,666,He has a new business model he wants to show us.
4372,6042,1,0,46,47,1.0425531914893618,0.04255319148936171,666,Bite his dick off!
4392,6042,0,2,45,47,1.0425531914893618,0.029760791752350448,666,I”am teaching him shark surfing
4195,6042,0,2,45,47,1.0425531914893618,0.029760791752350448,666,"Of course I support those Uber drivers,but a guy's got to make a living."
4699,6042,0,2,45,47,1.0425531914893618,0.029760791752350448,666,"Sorry, dear. I was the closet ride."
4763,6042,0,2,45,47,1.0425531914893618,0.029760791752350448,666,"I’m getting tired of this surfer dude, dude, dude, do, do, do, do."
4714,6042,0,2,45,47,1.0425531914893618,0.029760791752350448,666,He thinks he's touched bottom and I haven't the heart to disillusion him. Your go.
6215,6042,0,2,45,47,1.0425531914893618,0.029760791752350448,666,"When did you switch from Uber to Lyft?

Sigute Miller, Valley Village, CA"
4718,6042,0,2,45,47,1.0425531914893618,0.029760791752350448,666,"Excuse me, is this 1943 Jaws Avenue?"
4769,6042,0,2,45,47,1.0425531914893618,0.029760791752350448,666,"His board? I dunno,""cept now I have to take him in"
4771,6042,0,2,45,47,1.0425531914893618,0.029760791752350448,666,Nah — don’t like the texture and tastes kinda gamey.
4798,6042,0,2,45,47,1.0425531914893618,0.029760791752350448,666,"You like it? Made 'er myself last weekend, the red-shorted bronzeskins usually bite hard this time of year."
4159,6042,0,2,45,47,1.0425531914893618,0.029760791752350448,666,"Apparently, they pay extra."
4825,6042,0,2,45,47,1.0425531914893618,0.029760791752350448,666,How's does my new hat look ?
4823,6042,0,2,45,47,1.0425531914893618,0.029760791752350448,666,I saved this one for a late night snack.
4708,6042,0,2,45,47,1.0425531914893618,0.029760791752350448,666,Don't look at me. I'm hideous.
4151,6042,0,2,45,47,1.0425531914893618,0.029760791752350448,666,It's easier than goat yoga.
3516,6042,0,2,45,47,1.0425531914893618,0.029760791752350448,666,Hey Ben... new hat?
4118,6042,0,2,45,47,1.0425531914893618,0.029760791752350448,666,I promised his mother I would chew off his ankles for the 1st half hour after he eats.
3201,6042,0,2,45,47,1.0425531914893618,0.029760791752350448,666,"I saw it on the ""Jeffersons"". It really does feel good."
4889,6042,0,2,45,47,1.0425531914893618,0.029760791752350448,666,I already told him he’s out of his head.
3256,6042,0,2,45,47,1.0425531914893618,0.029760791752350448,666,I'm watching my weight. So I ate half earlier and I'll finish off the rest this evening.
3301,6042,0,2,45,47,1.0425531914893618,0.029760791752350448,666,I never eat below the waist.
3313,6042,0,2,45,47,1.0425531914893618,0.029760791752350448,666,Guess what we are having for lunch?
3345,6042,0,2,45,47,1.0425531914893618,0.029760791752350448,666,I was hungry and  Disney bought my rights for a couple of mackerel.
3408,6042,0,2,45,47,1.0425531914893618,0.029760791752350448,666,"He sure looks better, than the surfboard I just ate!"
3413,6042,0,2,45,47,1.0425531914893618,0.029760791752350448,666,"Ever have an itch you just can’t scratch?

Tanya Braganti, Marblehead, MA"
3541,6042,0,2,45,47,1.0425531914893618,0.029760791752350448,666,He promised to let me know if there are any jellyfish around
3607,6042,0,2,45,47,1.0425531914893618,0.029760791752350448,666,It's a gig economy out there and he needed a lift!
3760,6042,0,2,45,47,1.0425531914893618,0.029760791752350448,666,"It’s foot-on-head disease, a precursor to foot-in-mouth disease."
3763,6042,0,2,45,47,1.0425531914893618,0.029760791752350448,666,He's much lighter since somebody ate his top.
3775,6042,0,2,45,47,1.0425531914893618,0.029760791752350448,666,"Get lost, I'm chumming for a bigger fish than you!"
3795,6042,1,0,46,47,1.0425531914893618,0.04255319148936171,666,"OK..I’ ll toss him, you catch him and we’ll do lunch"
3804,6042,0,2,45,47,1.0425531914893618,0.029760791752350448,666,He thinks he is surfing!
3806,6042,0,2,45,47,1.0425531914893618,0.029760791752350448,666,He is too skinny; I want to wait for a fatter prey.
3933,6042,0,2,45,47,1.0425531914893618,0.029760791752350448,666,You need to eat your whole meal before you swim away!
3996,6042,0,2,45,47,1.0425531914893618,0.029760791752350448,666,surfboard shark...doo doo doo doo
4024,6042,0,2,45,47,1.0425531914893618,0.029760791752350448,666,Working for Lyft has its drawbacks.
4142,6042,0,2,45,47,1.0425531914893618,0.029760791752350448,666,"I can let you have this guy NOW, pay me back 3 on Sunday."
4967,6042,0,2,45,47,1.0425531914893618,0.029760791752350448,666,Ya oooh yum dessert
5844,6042,0,2,45,47,1.0425531914893618,0.029760791752350448,666,The sand here is even softer than in the Bahamas!
5030,6042,0,2,45,47,1.0425531914893618,0.029760791752350448,666,"Well I'm no megalodon and I don't have shoulders, but I think he is seeing further, why?"
5691,6042,0,2,45,47,1.0425531914893618,0.029760791752350448,666,"It's Mr. Kintner....Isn't it?"""
5710,6042,0,2,45,47,1.0425531914893618,0.029760791752350448,666,He said he had to change a light bulb.
5719,6042,0,2,45,47,1.0425531914893618,0.029760791752350448,666,This is taking detente too far.
5728,6042,0,2,45,47,1.0425531914893618,0.029760791752350448,666,"Bruce, what on your mind for dinner?"
5758,6042,0,2,45,47,1.0425531914893618,0.029760791752350448,666,This will be as easy as shooting humans in a barrel
5854,6042,0,2,45,47,1.0425531914893618,0.029760791752350448,666,Online dating has me feeling used...
5913,6042,0,2,45,47,1.0425531914893618,0.029760791752350448,666,I think we're going to need a bigger human.
5949,6042,0,2,45,47,1.0425531914893618,0.029760791752350448,666,Some I drive. Some I deliver.
5951,6042,0,2,45,47,1.0425531914893618,0.029760791752350448,666,And that's only the half of it!
5986,6042,0,2,45,47,1.0425531914893618,0.029760791752350448,666,It’s better a pain in the back than a pain in the Jaws
5987,6042,0,2,45,47,1.0425531914893618,0.029760791752350448,666,He got tired of surfboarding.
6040,6042,0,2,45,47,1.0425531914893618,0.029760791752350448,666,He's on the lookout for Jaws 4.
6043,6042,0,2,45,47,1.0425531914893618,0.029760791752350448,666,He said he'll take me out for shrimp later if I help him just this once.
6063,6042,0,2,45,47,1.0425531914893618,0.029760791752350448,666,This standoff is aboveboard.  It's clearly not bait-and-switch.
6119,6042,0,2,45,47,1.0425531914893618,0.029760791752350448,666,Sometimes I just don't bother.
6130,6042,0,2,45,47,1.0425531914893618,0.029760791752350448,666,"It's called a ""lure"" and yes, it was ""as seen on TV""."
6205,6042,0,2,45,47,1.0425531914893618,0.029760791752350448,666,Its's only fair. You got the first half.
6207,6042,0,2,45,47,1.0425531914893618,0.029760791752350448,666,"Yeah, I finally became a ScUber driver."
3130,6042,0,2,45,47,1.0425531914893618,0.029760791752350448,666,Just waiting for the other half to fall.
5671,6042,0,2,45,47,1.0425531914893618,0.029760791752350448,666,When the bottom drops out you have ten seconds to neutralize him.
5013,6042,0,2,45,47,1.0425531914893618,0.029760791752350448,666,Any ideas about how to get rid of back pain?
5655,6042,0,2,45,47,1.0425531914893618,0.029760791752350448,666,"The wife said she wanted to fix the den, so I said I’d Uber to raise some cash."
5601,6042,0,2,45,47,1.0425531914893618,0.029760791752350448,666,It's the new under-water shiatsu. They won't bite.
5072,6042,0,2,45,47,1.0425531914893618,0.029760791752350448,666,Corporate Attorney!
5099,6042,0,2,45,47,1.0425531914893618,0.029760791752350448,666,"He was an easy catch.  And at lunchtime, I'll do a backflip and eat."
5155,6042,0,2,45,47,1.0425531914893618,0.029760791752350448,666,I guess it beats rolling a rock up a hill.
5209,6042,0,2,45,47,1.0425531914893618,0.029760791752350448,666,I volunteer with Oceana.
5214,6042,0,2,45,47,1.0425531914893618,0.029760791752350448,666,i`m his handler for the terra firma world exhibit
5237,6042,0,2,45,47,1.0425531914893618,0.029760791752350448,666,You should try it. It does wonders for back pain with the added bonus of a tasty snack.
5256,6042,0,2,45,47,1.0425531914893618,0.029760791752350448,666,Let me introduce myself... I am a hammertoe head shark
5285,6042,0,2,45,47,1.0425531914893618,0.029760791752350448,666,Offer him 10% participation.
5327,6042,0,2,45,47,1.0425531914893618,0.029760791752350448,666,Too many options...
5342,6042,0,2,45,47,1.0425531914893618,0.029760791752350448,666,They’re getting so close to shore that I’m terrified to even go in the water.
5363,6042,0,2,45,47,1.0425531914893618,0.029760791752350448,666,I'm gonna dump this guy if he doesn't cut his toenails.
5431,6042,0,2,45,47,1.0425531914893618,0.029760791752350448,666,"No more pink mustaches, but I'm still an independent contractor."
5443,6042,0,2,45,47,1.0425531914893618,0.029760791752350448,666,"One, Two, Three......."
5454,6042,0,2,45,47,1.0425531914893618,0.029760791752350448,666,"I know our ratings are down, but that jump-the-shark publicity stunt was a desperate measure. And now we have a standing invitation to deal with? Talk about overkill!"
5456,6042,0,2,45,47,1.0425531914893618,0.029760791752350448,666,I didn't realize it was an Uber Pool so now I've got to go pick up another dude.
5507,6042,1,0,46,47,1.0425531914893618,0.04255319148936171,666,"Once I get the vest, we can fly, he says."
5534,6042,0,2,45,47,1.0425531914893618,0.029760791752350448,666,"We're trying to economize, so I've decided to bring lunch from home"
5547,6042,0,2,45,47,1.0425531914893618,0.029760791752350448,666,"It beats fishing for a living, but I wish they’d  keep their toe nails clipped."
5588,6042,0,2,45,47,1.0425531914893618,0.029760791752350448,666,"This is no seal, Bill."
5647,6042,0,2,45,47,1.0425531914893618,0.029760791752350448,666,"He complained that Uber costs an arm and a leg, so I'm only charging him a leg."
3095,6042,0,2,45,47,1.0425531914893618,0.029760791752350448,666,"If I wasn’t so full and ate the bottom half, I wouldn’t be in this position."
1915,6042,0,2,45,47,1.0425531914893618,0.029760791752350448,666,Dinner or foot massage?
3039,6042,0,2,45,47,1.0425531914893618,0.029760791752350448,666,"Feet are food, not friends!"
917,6042,0,2,45,47,1.0425531914893618,0.029760791752350448,666,It’s called  “Drown the Shark”
949,6042,0,2,45,47,1.0425531914893618,0.029760791752350448,666,Remoras are just so passé.
1051,6042,0,2,45,47,1.0425531914893618,0.029760791752350448,666,I always try to get a massage when I swim to Bangkok
1055,6042,0,2,45,47,1.0425531914893618,0.029760791752350448,666,"After we do the film...well...""Sharky"" might have to get his just desserts...if they try to pay off in jumbo shrimp."
1070,6042,0,2,45,47,1.0425531914893618,0.029760791752350448,666,I've been eating the Impossible Surfer and now I've lost the taste for the real thing.
1090,6042,0,2,45,47,1.0425531914893618,0.029760791752350448,666,If I dive I want half
1125,6042,0,2,45,47,1.0425531914893618,0.029760791752350448,666,"I'm up for the next Sharknado movie, that's why!!"
1144,6042,0,2,45,47,1.0425531914893618,0.029760791752350448,666,"I would eat him, but he bribed me not to..."
906,6042,0,2,45,47,1.0425531914893618,0.029760791752350448,666,Somebody this stupid can't taste good!
1204,6042,0,2,45,47,1.0425531914893618,0.029760791752350448,666,"He thinks he is waist deep, wanna see total hysteria, then you can have him, I do owe you one."
1261,6042,0,2,45,47,1.0425531914893618,0.029760791752350448,666,"....you laugh but its like Hello Fresh for busy on the go sea carnivores, they deliver it right to you."
1338,6042,0,2,45,47,1.0425531914893618,0.029760791752350448,666,"I know, I know, but I’m trying to improve my image with those guys!"
1375,6042,0,2,45,47,1.0425531914893618,0.029760791752350448,666,"Just between you and me, I think he needs a different boat."
1380,6042,0,2,45,47,1.0425531914893618,0.029760791752350448,666,"With regular accupressure treatments, I'm able to thrash without back pain."
1417,6042,0,2,45,47,1.0425531914893618,0.029760791752350448,666,He thinks I’m rubber
1455,6042,0,2,45,47,1.0425531914893618,0.029760791752350448,666,"Can't join you, Larry. I work for Uber now."
1538,6042,0,2,45,47,1.0425531914893618,0.029760791752350448,666,I've taken up surfing.
1554,6042,0,2,45,47,1.0425531914893618,0.029760791752350448,666,He's mine - from here it's just a flip and a gulp.
1248,6042,0,2,45,47,1.0425531914893618,0.029760791752350448,666,Getting their feet wet with their showboating ecotourism is killing my back—not to mention the environment.
1584,6042,0,2,45,47,1.0425531914893618,0.029760791752350448,666,"Get off my fin, doo doo doo doo doo doo."
806,6042,0,2,45,47,1.0425531914893618,0.029760791752350448,666,We can't. He's a corporate lawyer and he's family.
740,6042,0,2,45,47,1.0425531914893618,0.029760791752350448,666,"I keep getting supporting roles, like Jaw’s younger goofy brother.
I could of been a contender."
11,6042,0,2,45,47,1.0425531914893618,0.029760791752350448,666,I would but skin bones isn’t worth the effort
98,6042,0,2,45,47,1.0425531914893618,0.029760791752350448,666,A snack just in case.
112,6042,0,2,45,47,1.0425531914893618,0.029760791752350448,666,It's this gig economy.
253,6042,0,2,45,47,1.0425531914893618,0.029760791752350448,666,Do you want to know what's more annoying than being attached to a suckerfish?
268,6042,0,2,45,47,1.0425531914893618,0.029760791752350448,666,I like to give back before I take.
271,6042,0,2,45,47,1.0425531914893618,0.029760791752350448,666,Wha-da-ya say we each take a leg and play Wishbone?
286,6042,0,2,45,47,1.0425531914893618,0.029760791752350448,666,"ALL VISITORS:
""For the well-being of our marine life, please remove your shoes before entering tank."""
365,6042,0,2,45,47,1.0425531914893618,0.029760791752350448,666,"Hey, it might look like I'm not a killer anymore but the foot massages this dude gives are the best.  The best, I tell you."
757,6042,0,2,45,47,1.0425531914893618,0.029760791752350448,666,It's like Uber for the ocean.
394,6042,0,2,45,47,1.0425531914893618,0.029760791752350448,666,Roadpop...
592,6042,0,2,45,47,1.0425531914893618,0.029760791752350448,666,I felt bad-I chomped his surfboard in half
604,6042,0,2,45,47,1.0425531914893618,0.029760791752350448,666,humans always pretend they can swim
618,6042,0,2,45,47,1.0425531914893618,0.029760791752350448,666,Ashiatsu back walking massage really relieves the tightness in my back. Hard to find a therapist willing to do it in water though.
666,6042,0,2,45,47,1.0425531914893618,0.029760791752350448,666,"Actually, my appetite has been a bit off lately..."
673,6042,0,2,45,47,1.0425531914893618,0.029760791752350448,666,Oh no! Mr. Wonderful?
686,6042,0,2,45,47,1.0425531914893618,0.029760791752350448,666,I hate it when he digs his toes in.
694,6042,0,2,45,47,1.0425531914893618,0.029760791752350448,666,This Ride-a-Shark business is really cramping my style!
699,6042,0,2,45,47,1.0425531914893618,0.029760791752350448,666,Didn't you get my message...it's BYO lunch this week!
588,6042,0,2,45,47,1.0425531914893618,0.029760791752350448,666,He's thinking either shoes or a suit.
1606,6042,1,0,46,47,1.0425531914893618,0.04255319148936171,666,I recommend the thighs.
1599,6042,0,2,45,47,1.0425531914893618,0.029760791752350448,666,Sometimes dinner just really weighs me down.
1643,6042,0,2,45,47,1.0425531914893618,0.029760791752350448,666,He says he’s the apex predator.
2325,6042,0,2,45,47,1.0425531914893618,0.029760791752350448,666,I just can't bring myself to correct him.
2372,6042,0,2,45,47,1.0425531914893618,0.029760791752350448,666,I still can't believe we let them bring the gig economy to the ocean...
2378,6042,0,2,45,47,1.0425531914893618,0.029760791752350448,666,"When they said ""Shark Tank"" I never expected to be on TV."
2387,6042,0,2,45,47,1.0425531914893618,0.029760791752350448,666,"Don't go there yet, obviously he thinks he's on a surfboard."
2393,6042,0,2,45,47,1.0425531914893618,0.029760791752350448,666,I blame this kind of boldness on Lady Gaga and Bradley Cooper
2399,6042,0,2,45,47,1.0425531914893618,0.029760791752350448,666,They call it chicken.
2417,6042,0,2,45,47,1.0425531914893618,0.029760791752350448,666,I'd much rather be a 'fish out of water' at this point.
2451,6042,0,2,45,47,1.0425531914893618,0.029760791752350448,666,What I won't do to make it on Shark Week
2552,6042,0,2,45,47,1.0425531914893618,0.029760791752350448,666,"-Shark Walk-
“Risking your Shame, by Brene Brown.”"
2622,6042,0,2,45,47,1.0425531914893618,0.029760791752350448,666,"I already ate,but I couldn't stand watching him try to swim."
2664,6042,0,2,45,47,1.0425531914893618,0.029760791752350448,666,Do I swallow him whole or only what I can see.
2696,6042,0,2,45,47,1.0425531914893618,0.029760791752350448,666,"No, your first bite should be his knees."
2728,6042,0,2,45,47,1.0425531914893618,0.029760791752350448,666,"No idea. He booked me with an app, apparently."
2842,6042,0,2,45,47,1.0425531914893618,0.029760791752350448,666,They eliminated the whole 'jumping part' at orientation...
2862,6042,0,2,45,47,1.0425531914893618,0.029760791752350448,666,It's your turn!
2917,6042,0,2,45,47,1.0425531914893618,0.029760791752350448,666,I hate humans
2960,6042,0,2,45,47,1.0425531914893618,0.029760791752350448,666,"And I swear I can hear him humming ""Mack the Knife."""
3036,6042,0,2,45,47,1.0425531914893618,0.029760791752350448,666,"Don't ask, it's a deal we made."
3037,6042,0,2,45,47,1.0425531914893618,0.029760791752350448,666,"His trust  has changed me from a predator to
a support shark!"
1622,6042,0,2,45,47,1.0425531914893618,0.029760791752350448,666,Surfer beaches are more trouble than they're worth.
2277,6042,0,2,45,47,1.0425531914893618,0.029760791752350448,666,I believe in a balanced diet and he is surface to requirements.
2284,6042,0,2,45,47,1.0425531914893618,0.029760791752350448,666,It's the warm spots that piss me off.
2221,6042,0,2,45,47,1.0425531914893618,0.029760791752350448,666,I'm working for Lyft now.
1665,6042,0,2,45,47,1.0425531914893618,0.029760791752350448,666,I bet the stupid doctor put me on the low fat diet just so he can hog all the good food .
1733,6042,0,2,45,47,1.0425531914893618,0.029760791752350448,666,Mako?  No.  Macho.
1750,6042,0,2,45,47,1.0425531914893618,0.029760791752350448,666,My rating's at 4.6 stars and it helps with my herniated disc.
1759,6042,0,2,45,47,1.0425531914893618,0.029760791752350448,666,I let him live if he agreed to them the water was safe.
1814,6042,0,2,45,47,1.0425531914893618,0.029760791752350448,666,Jumped my shark.. :(
1833,6042,0,2,45,47,1.0425531914893618,0.029760791752350448,666,Uber Eats with your Italian.
2227,6042,0,2,45,47,1.0425531914893618,0.029760791752350448,666,Just doing a little bit to help with global climate change problems. He's changing the torch light in the Statue of Liberty.
1909,6042,0,2,45,47,1.0425531914893618,0.029760791752350448,666,He's mine; I found him first!
1924,6042,0,2,45,47,1.0425531914893618,0.029760791752350448,666,This is the best bait I've ever used!
1873,6042,0,2,45,47,1.0425531914893618,0.029760791752350448,666,What? I  could only eat a half portion.
2043,6042,0,2,45,47,1.0425531914893618,0.029760791752350448,666,It's a gig economy... things are changing fast. You better keep up.
2051,6042,0,2,45,47,1.0425531914893618,0.029760791752350448,666,"You  know the old saying, shark eat shark”"
2052,6042,0,2,45,47,1.0425531914893618,0.029760791752350448,666,"No, let's pull his pants down... Then eat him."
2057,6042,0,2,45,47,1.0425531914893618,0.029760791752350448,666,"With global warming and rising seas, I’ve decided to stay ahead of the curve... I call it SharkLyft!"
2084,6042,0,2,45,47,1.0425531914893618,0.029760791752350448,666,Why do I always have to carry the heavy load?
2108,6042,0,2,45,47,1.0425531914893618,0.029760791752350448,666,Shall we flip for it?
2198,6042,0,2,45,47,1.0425531914893618,0.029760791752350448,666,' I gotta new job as a loan shark'
2218,6042,0,2,45,47,1.0425531914893618,0.029760791752350448,666,Please help me.  There’s something not fishy about this weight!
2032,6042,0,2,45,47,1.0425531914893618,0.029760791752350448,666,His other half is in my stomach.
3075,6042,0,2,45,47,1.0425531914893618,0.029760791752350448,666,I just hope my headache heels soon.
3464,6220,0,2,46,48,1.0416666666666667,0.029147663515556005,666,"It gives new meaning to the term, 'Sharkbait.'"""
5966,6220,0,2,46,48,1.0416666666666667,0.029147663515556005,666,I hate to sound so 80's but can we do lunch?
5306,6220,0,2,46,48,1.0416666666666667,0.029147663515556005,666,STOP HOVERING — you’ll get lunch after my massage
4108,6220,0,2,46,48,1.0416666666666667,0.029147663515556005,666,I'm also on Lyft.
2136,6220,0,2,46,48,1.0416666666666667,0.029147663515556005,666,Jerry had a key lime pie instead of a wedding cake
2010,6220,0,2,46,48,1.0416666666666667,0.029147663515556005,666,"He's getting ready to jump over us, again and again."
1845,6220,0,2,46,48,1.0416666666666667,0.029147663515556005,666,...and I just went on a vegan diet.
182,6220,0,2,46,48,1.0416666666666667,0.029147663515556005,666,He thought I was a *cart* shark!
3405,6220,0,2,46,48,1.0416666666666667,0.029147663515556005,666,I’m tired of the people encroaching in our space. We need to have a BarBQ!
3838,6229,0,1,42,43,1.0232558139534884,0.023531040266750583,666,Shark Yoga
3911,6229,0,1,42,43,1.0232558139534884,0.023531040266750583,666,"Hey, it's not baiting, it's waiting."
4154,6229,0,1,42,43,1.0232558139534884,0.023531040266750583,666,I warned The Fonz.
4408,6229,0,1,42,43,1.0232558139534884,0.023531040266750583,666,It's my penance for eating too many baby seals!
4502,6229,0,1,42,43,1.0232558139534884,0.023531040266750583,666,I'd rather snack than shark-boarding.
4988,6229,0,1,42,43,1.0232558139534884,0.023531040266750583,666,The tuba player is on break...
3790,6229,0,1,42,43,1.0232558139534884,0.023531040266750583,666,I saw Shamu do this once!
5615,6229,0,1,42,43,1.0232558139534884,0.023531040266750583,666,I got trunk fever.
5673,6229,0,1,42,43,1.0232558139534884,0.023531040266750583,666,Payback to the Shark Conservancy
5867,6229,0,1,42,43,1.0232558139534884,0.023531040266750583,666,"Apparently, you’ve earned yourself quite the reputation."
6118,6229,0,1,42,43,1.0232558139534884,0.023531040266750583,666,Loading...
4812,6229,0,1,42,43,1.0232558139534884,0.023531040266750583,666,Don’t judge...it’s fake.
3557,6229,0,1,42,43,1.0232558139534884,0.023531040266750583,666,I tell you he swore he was going to jump.
4526,6229,0,1,42,43,1.0232558139534884,0.023531040266750583,666,This is NOT what I meant by a loan.
2831,6229,0,1,42,43,1.0232558139534884,0.023531040266750583,666,"You get hungry sometimes, but that's food delivery for you."
3445,6229,0,1,42,43,1.0232558139534884,0.023531040266750583,666,The royal we? More like the royal symbiosis
108,6229,0,1,42,43,1.0232558139534884,0.023531040266750583,666,It's just until I can afford an aardvark. Burp! I'm a shark.
602,6229,0,1,42,43,1.0232558139534884,0.023531040266750583,666,I'm trying to eat low-fat.
616,6229,0,1,42,43,1.0232558139534884,0.023531040266750583,666,He’s taking the “stand your ground” law pretty seriously.
839,6229,0,1,42,43,1.0232558139534884,0.023531040266750583,666,"Uber is gonna have to offer better insurance, because this is getting ridiculous."
1530,6229,0,1,42,43,1.0232558139534884,0.023531040266750583,666,This is how Bruce got his start
620,6229,0,1,42,43,1.0232558139534884,0.023531040266750583,666,"Just give it a week, and there will be enough for everyone."
1857,6229,0,1,42,43,1.0232558139534884,0.023531040266750583,666,I'm just waiting till he 'hangs ten.' Then the fun begins.
2415,6229,0,1,42,43,1.0232558139534884,0.023531040266750583,666,"I told you, stay away from the shore, these humans are dangerous."
2437,6229,0,1,42,43,1.0232558139534884,0.023531040266750583,666,"If you use my referral code, we'll both get a bonus."
2462,6229,0,1,42,43,1.0232558139534884,0.023531040266750583,666,It really irks me to be walked on like somebody's surfboard.
2731,6229,0,1,42,43,1.0232558139534884,0.023531040266750583,666,He wants a ride to the island.
2771,6229,0,1,42,43,1.0232558139534884,0.023531040266750583,666,I signed up at UberForTourists.com to pick up a little extra snacks
4323,6257,0,1,43,44,1.0227272727272727,0.022990024493585143,666,Jesus hired meB
3689,6257,0,1,43,44,1.0227272727272727,0.022990024493585143,666,He promised if I let him do this for a day he
4009,6257,0,1,43,44,1.0227272727272727,0.022990024493585143,666,He had a shark themed surfboard. It's a win-win situation.
6192,6257,0,1,43,44,1.0227272727272727,0.022990024493585143,666,Welcome to the gig economy.
4071,6257,0,1,43,44,1.0227272727272727,0.022990024493585143,666,Do we tell him I'm not a reef? Or do I just toss him in the air and we both make a go at taking a bite of him?
4303,6257,0,1,43,44,1.0227272727272727,0.022990024493585143,666,my nickname is buoyancy
3540,6257,0,1,43,44,1.0227272727272727,0.022990024493585143,666,Wait... I want to know what happens at the end of this story
4480,6257,0,1,43,44,1.0227272727272727,0.022990024493585143,666,I'm not hungry yet so I've just been trading up.
5669,6257,0,1,43,44,1.0227272727272727,0.022990024493585143,666,They promise they’ll feature me in the next documentary.
4917,6257,0,1,43,44,1.0227272727272727,0.022990024493585143,666,"It’s Steven Spielberg, I don’t know what I should do !"
5287,6257,0,1,43,44,1.0227272727272727,0.022990024493585143,666,"""He's a goober who thinks he's on Uber."""
5447,6257,0,1,43,44,1.0227272727272727,0.022990024493585143,666,They call it “Uber”!
5535,6257,0,1,43,44,1.0227272727272727,0.022990024493585143,666,A day in the life of the Mueller shark.
5635,6257,0,1,43,44,1.0227272727272727,0.022990024493585143,666,"When they hired me to ensure the water polo team would win, this was not what I had in mind."
5852,6257,0,1,43,44,1.0227272727272727,0.022990024493585143,666,Blue waveshark 2020
5862,6257,0,1,43,44,1.0227272727272727,0.022990024493585143,666,"Ever since Katy Perry’s half time show, the left shark seems to get more respect."
3342,6257,0,1,43,44,1.0227272727272727,0.022990024493585143,666,And you thought suckerfish were bad.
4810,6257,0,1,43,44,1.0227272727272727,0.022990024493585143,666,"Hey can we talk?"" I have got something on my mind."
2976,6257,0,1,43,44,1.0227272727272727,0.022990024493585143,666,"It allows me to attack without exposing my dorsal fin.
Joe Souvignier, Colorado Springs, Colorado"
1444,6257,0,1,43,44,1.0227272727272727,0.022990024493585143,666,"I missed, and ate his Boogie board instead."
2684,6257,0,1,43,44,1.0227272727272727,0.022990024493585143,666,"I might take an arm, maybe a leg, but good golly Mr. Wonderful, I was on Dancing with the Stars.  You know. Brand recognition."
257,6257,0,1,43,44,1.0227272727272727,0.022990024493585143,666,He's a lawyer. We're pals.
278,6257,0,1,43,44,1.0227272727272727,0.022990024493585143,666,Let's see how long he has his legs once I flip him over.
440,6257,0,1,43,44,1.0227272727272727,0.022990024493585143,666,"He said he's a podiatrist testing some new exfoliation treatment. Can you eat him, I can't reach...."
448,6257,0,1,43,44,1.0227272727272727,0.022990024493585143,666,Steven is really going the lengths for this movie.
489,6257,0,1,43,44,1.0227272727272727,0.022990024493585143,666,It's the newest in the underwater massage!
567,6257,0,1,43,44,1.0227272727272727,0.022990024493585143,666,I've been having these weird cravings lately...
679,6257,0,1,43,44,1.0227272727272727,0.022990024493585143,666,This is just my side hustle.
228,6257,0,1,43,44,1.0227272727272727,0.022990024493585143,666,It’s called Uber Ocean.
791,6257,0,1,43,44,1.0227272727272727,0.022990024493585143,666,I'm trying to be more environmentally friendly.
1257,6257,0,1,43,44,1.0227272727272727,0.022990024493585143,666,"He keeps saying, ""Don't stop moving."""
1270,6257,0,1,43,44,1.0227272727272727,0.022990024493585143,666,"If I can help somebody, my living will not be in vain."
1327,6257,0,1,43,44,1.0227272727272727,0.022990024493585143,666,I got this idea from the finless ones. I'm using this scrawny one to lure a big one into the water.
1488,6257,0,1,43,44,1.0227272727272727,0.022990024493585143,666,It's an event that will bring new life to the summer olympics!
1675,6257,0,1,43,44,1.0227272727272727,0.022990024493585143,666,You want to share some athlete's foot?
2429,6257,0,1,43,44,1.0227272727272727,0.022990024493585143,666,"""He's a plaintiff's attorney looking for a new case."""
2497,6257,0,1,43,44,1.0227272727272727,0.022990024493585143,666,My yogi told me ashiatsu would realign my chakras in time for the equinox.
1141,6257,0,1,43,44,1.0227272727272727,0.022990024493585143,666,Where's a humpback when you need one
2962,6257,0,1,43,44,1.0227272727272727,0.022990024493585143,666,It's supposed to be another kind of remora.
6313,6296,0,1,44,45,1.0222222222222221,0.022473328748774737,666,"We all have to do our part in the gig economy, right?"
837,6297,0,0,39,39,1.0,0.025976216673306556,666,"Another day, another topless beach."
5810,6297,0,0,39,39,1.0,0.025976216673306556,666,I decided to try out this Uber thing for awhile
5661,6297,0,0,39,39,1.0,0.025976216673306556,666,I'm wai
5180,6297,0,0,39,39,1.0,0.025976216673306556,666,"wouldn't you know, another back-packing student , touring on five  dollars a  day.''"
5147,6297,0,0,39,39,1.0,0.025976216673306556,666,He's looking for an island. I support him on this.
5060,6297,0,0,39,39,1.0,0.025976216673306556,666,Care for the first bite?
4949,6297,0,0,39,39,1.0,0.025976216673306556,666,He thinks swimming with the dolphins will clear up the mystery of life. But standing? Not so much.
4308,6297,0,0,39,39,1.0,0.025976216673306556,666,We're having Geisha for dinner.
6230,6297,0,0,39,39,1.0,0.025976216673306556,666,Disneys new Reverse-boot “The large Terrestrial Man”
3865,6297,0,0,39,39,1.0,0.025976216673306556,666,"We want to speed off and he wants to speed off but, why can’t he ask nicely ?"
3336,6297,0,0,39,39,1.0,0.025976216673306556,666,She's scratching my back in a place I cannot reach.
3143,6297,0,0,39,39,1.0,0.025976216673306556,666,"I know he looks tasty, but now I make a killing with Uber."
2860,6297,0,0,39,39,1.0,0.025976216673306556,666,"Agreed, and we can give the crafties a break."
2781,6297,0,0,39,39,1.0,0.025976216673306556,666,"No, I'm a hydro-fool, that's what I am."
2592,6297,0,0,39,39,1.0,0.025976216673306556,666,I'm a top half only guy.
1594,6297,0,0,39,39,1.0,0.025976216673306556,666,They call it survival of the fittest
1305,6297,0,0,39,39,1.0,0.025976216673306556,666,Shark bait oh-ha-ha
3666,6297,0,0,39,39,1.0,0.025976216673306556,666,I'm getting pretty tired of being a doormat for the homo sapiens!
6243,6297,0,0,39,39,1.0,0.025976216673306556,666,He's doing such a great job massaging my back with his feet that I'm seriously considering not eating him.
