target_id,rank,funny,somewhat_funny,unfunny,count,score,precision,contest,caption
922,1,89,72,58,219,2.141552511415525,0.05465470271213422,673,I'm sure it works. I was involved in the original research.
1319,2,240,282,169,691,2.1027496382054993,0.029026182958640116,673,These should help with the hallucinations.
3402,3,340,376,273,989,2.0677451971688576,0.024953977603117926,673,There are no side effects to worry about.  I take this myself.
3136,4,288,464,396,1148,1.9059233449477353,0.02262172148051732,673,It's totally safe. I've been on it for years.
3994,5,60,101,86,247,1.894736842105263,0.04855693100656339,673,This is for the hallucinations.
1445,6,193,340,296,829,1.8757539203860072,0.02633925409756705,673,Call me if you notice anything unusual.
519,7,16,40,30,86,1.8372093023255813,0.07733676621123158,673,"Of course there are no side effects, I take it myself."
541,8,144,186,245,575,1.8243478260869566,0.03353889138104874,673,We take Blue Cross or Blue Cheese.
2856,9,143,215,255,613,1.8172920065252856,0.0317229555062571,673,Most of us go into research
1220,10,122,160,215,497,1.812877263581489,0.03600664958687249,673,"No, I said I was a rodent scholar."
3664,11,178,307,331,816,1.8125,0.026874355687614978,673,Side effects? You know I wouldn't give you anything I haven't tried myself.
369,12,140,129,250,519,1.788053949903661,0.036931637736958046,673,Be sure to take the pills with cheese.
3261,13,113,208,237,558,1.7777777777777777,0.03220940871159846,673,It’s completely safe. I participated in the trials myself.
3470,14,77,156,184,417,1.7434052757793765,0.036691883274965024,673,Side effects?  Maybe an enhanced sense of smell...
2294,15,61,123,156,340,1.7205882352941178,0.04064975081694379,673,Take 2 with either cheese or peanut butter...
2539,16,58,116,150,324,1.7160493827160495,0.04168833781232228,673,"No, no side effects.  Why?"
1672,17,70,107,168,345,1.7159420289855072,0.04208125243954268,673,I take it myself and as far as I can tell there is only ONE side effect.
981,18,63,104,155,322,1.7142857142857142,0.04306721474528332,673,"Here, this should help with the hallucinations."
3117,19,58,110,151,319,1.70846394984326,0.04234402177448527,673,We tested it in humans.
4207,20,59,89,147,295,1.7016949152542373,0.045524874009792,673,I take them myself.  There’s only one serious side effect -
2058,21,53,94,139,286,1.6993006993006994,0.04514726786968313,673,"Yep, worked my way up from the lab."
1961,22,48,90,128,266,1.699248120300752,0.046427157073700875,673,"Whatever you do, and I speak from experience, do not exceed the recommended dosage."
451,23,52,81,135,268,1.6902985074626866,0.04747742138517855,673,I wouldn't prescribe you anything I haven't tested on myself.
3419,24,43,85,121,249,1.6867469879518073,0.047540606098440075,673,"Every time I give you one of these, touch the keypad with your nose and I’ll give you another"
388,25,52,75,134,261,1.685823754789272,0.048593168446184505,673,This should take care of the hallucinations.
2223,26,47,82,128,257,1.6848249027237354,0.0476641288649749,673,"'Has it been tested on animals'?  What the hell kind of question is that?!"""
3683,27,20,39,57,116,1.6810344827586208,0.06991013500321029,673,Stop the medication right away if your cats take sudden interest in you.
3676,28,19,49,60,128,1.6796875,0.06365429529727988,673,"Trust me, this is the best treatment for your hallucinations."
165,29,44,77,123,244,1.6762295081967213,0.04883831130173508,673,"Listen, I don't prescribe anything I wouldn't test on myself."
925,30,37,88,115,240,1.675,0.04698919725105405,673,Minimal side effects.  I take it myself.
2761,31,38,79,114,231,1.670995670995671,0.04889050808139371,673,"I won't lie, there are some side effects."
1081,32,37,80,113,230,1.6695652173913043,0.048694160382910426,673,Sure it’s safe.  I’ve been taking it for years.
3051,33,38,80,115,233,1.6695278969957081,0.04857630638077466,673,You came to the right place. I DO give a rat's ass about your problem.
639,34,40,70,115,225,1.6666666666666667,0.050787450018337,673,This might help with your hallucinations. I think we'll work on your trust issues later.
3480,35,33,80,107,220,1.6636363636363636,0.048878898926378284,673,"If you can't swallow pills, have your wife hide them in your food."
4202,36,41,67,117,225,1.6622222222222223,0.05124034730795507,673,This’ll do the trick. My wife’s already produced four litters this year.
2111,37,34,77,108,219,1.6621004566210045,0.049503300097031085,673,"There are no side-effects, I've been on it for years and have not noticed anything."
1044,38,35,74,109,218,1.6605504587155964,0.050129990822818556,673,I suggest more exercise.  Do you have a wheel at home?
3627,39,35,70,109,214,1.6542056074766356,0.05096825092775086,673,"Why yes, my medical career did start with lab testing."
1111,40,35,69,109,213,1.6525821596244132,0.05118211943716154,673,I can vouch for the efficacy of this medication having participated in its clinical trial.
2517,41,34,60,104,198,1.6464646464646464,0.05388380291987819,673,We're conducting tests on humans to determine if it's safe for rats.
4469,42,29,68,98,195,1.646153846153846,0.05207424075250817,673,"Of course, there are side effects."
3450,43,32,67,104,203,1.645320197044335,0.05190208681069467,673,Take as needed for hallucinations.
998,44,27,67,94,188,1.6436170212765957,0.052560542822347595,673,Don't worry.  I've had a long career in medical research.
4077,45,34,59,105,198,1.6414141414141414,0.05395224359605393,673,This time we are having humans test it first.
3842,46,29,67,99,195,1.641025641025641,0.05214707917061922,673,Safe? Of course it is safe. I use it myself.
2271,47,29,61,97,187,1.6363636363636365,0.05395963178917651,673,I’m a rat. What you need is an ophthalmologist.
2597,48,28,60,95,183,1.633879781420765,0.054373915706681875,673,This new prescription should help with your hallucinations.
3900,49,25,63,91,179,1.6312849162011174,0.053637038588276835,673,Let’s hold off on the CAT scan
1329,50,27,56,92,175,1.6285714285714286,0.05581377164575861,673,"Before this, I spent some time in the lab."
537,51,21,67,87,175,1.6228571428571428,0.052243138605141015,673,The human trials have gone well so far.
1303,52,22,59,85,166,1.6204819277108433,0.05507814536934659,673,"I know, I know no one looks like their drivers license picture."
2556,53,24,56,89,169,1.6153846153846154,0.05567283572736507,673,"I tried lab work for a while, but I missed the patient contact."
2616,54,24,48,85,157,1.6114649681528663,0.059014776775751294,673,I’m also a lawyer.
857,55,23,49,84,156,1.608974358974359,0.05864031333575588,673,Take 2 of these and scurry back in the morning.
3702,56,26,41,86,153,1.607843137254902,0.06167823652212152,673,It will stop you from hallucinating.
729,57,22,52,84,158,1.6075949367088607,0.05737930241436816,673,"Don't worry, it's been tested on humans first"
767,58,24,43,83,150,1.6066666666666667,0.06123024114783173,673,Trust me: I would never prescribe an experimental drug that I haven't tried myself.
3839,58,21,49,80,150,1.6066666666666667,0.05899733939071066,673,Side effects?  Nothing serious.  Why do you ask?
1393,60,21,50,81,152,1.605263157894737,0.058413657177006084,673,I know it works. I was part of the clinical trial.
3412,61,22,46,81,149,1.604026845637584,0.06009454425081304,673,"If you'll just take your medications, I'll quit being a pest."
2774,62,22,44,80,146,1.6027397260273972,0.06107171655941798,673,This prescription in very effective in quelling anthropomorphic delusions.
753,63,6,21,28,55,1.6,0.09211323729436763,673,"No, we don't test on mice any more."""
1657,63,24,36,80,140,1.6,0.06475505273789343,673,"I understand your concern Mr. Phipps, but ask yourself this - if I were really a rat, would I have been able to write you this anti-psychotic prescription?"
2614,63,20,50,80,150,1.6,0.0583133554796246,673,"I started out as a lab rat,and worked my way up."
2087,66,18,55,79,152,1.5986842105263157,0.05621055095603639,673,The pharmacy is at the end of the hall and through the maze.
2181,67,18,53,78,149,1.5973154362416107,0.0570763147333592,673,I have taken this medicine for years  without any unusual side effects.
460,68,24,38,82,144,1.5972222222222223,0.0633494676759144,673,"And here's a prescription for a rabies shot, with my sincerest apologies for what happened earlier."
2275,68,19,48,77,144,1.5972222222222223,0.05939300943037183,673,My staff and I are highly experienced navigating the health care maze.
2509,68,20,46,78,144,1.5972222222222223,0.06020510498555197,673,It's new but I think you'll find it effective. I tested it myself.
2934,71,23,42,83,148,1.5945945945945945,0.061271264446165465,673,Take these twice a day with garbage.
4153,72,23,40,82,145,1.5931034482758621,0.06228145831790376,673,"You can fill this at our in-house pharmacy: it’s down the hall, take a right, another right, then a left, two more rights, then three lefts, and another right."
681,73,18,46,75,139,1.589928057553957,0.06024742163103889,673,"Cheese, three times a day. Trust me."
2381,74,27,33,88,148,1.587837837837838,0.06426716023829077,673,"Take this to the lab. Out the door, three lefts, take the second corridor on the right, then two more rights, third door on the right, then turn left, and left again...."
677,75,20,41,77,138,1.5869565217391304,0.0623326159067006,673,"Johns Hopkins in Baltimore, why?"
3580,75,25,31,82,138,1.5869565217391304,0.06644010550681902,673,"If this curbs your hallucinations, call me and let me know if I’m real."
1062,77,16,46,71,133,1.586466165413534,0.060498253543417424,673,Yeah! I DO give a rat’s ass about your health!
4430,78,16,50,74,140,1.5857142857142856,0.05822460170010701,673,Call me if you notice anything weird.
3514,79,16,47,72,135,1.5851851851851853,0.05983687534630276,673,"Take this down the hall, make two rights, a left, and another right.  Trust me, it’s a real maze in here."
4067,80,18,47,77,142,1.5845070422535212,0.05933315522545535,673,Pay particular attention to the list of side effects.
3362,81,16,45,71,132,1.5833333333333333,0.06087653617227523,673,Clearly you are hallucinating. Why would I have a landline on my desk?
702,82,20,39,77,136,1.5808823529411764,0.06310342433870397,673,I take it myself and I haven't noticed any side effects.
3189,83,16,48,74,138,1.5797101449275361,0.05891540085708235,673,"Yes, the medication may have some side effects - why do you ask?"
1221,84,21,36,78,135,1.5777777777777777,0.06436032710016909,673,Now! Who's the expert on the Bubonic Plague here?
1204,84,18,42,75,135,1.5777777777777777,0.061729869155054344,673,We need to test this out on humans before we can get FDA approval.
2756,86,20,35,75,130,1.5769230769230769,0.0654012746674844,673,You wouldn’t believe the maze I ran through to get these degrees.
407,87,17,45,75,137,1.5766423357664234,0.06016528305976713,673,I started in the lab and worked my way up.
1653,88,15,46,71,132,1.5757575757575757,0.059995770651705776,673,"Welcome to the human trial phase of this study, Mr. Jones."
3076,88,18,40,74,132,1.5757575757575757,0.06282096591985734,673,I take it myself.  You get used to the side effects.
2818,90,14,45,68,127,1.5748031496062993,0.060741249925326264,673,I suggest you take this with cheese
1159,90,14,45,68,127,1.5748031496062993,0.060741249925326264,673,This will help you find your way to your cubicle.
3714,92,20,35,76,131,1.5725190839694656,0.06504935959660002,673,"Here's your prescription.  By the way, I know you poisoned my uncle."
1397,92,13,49,69,131,1.5725190839694656,0.05838955813545496,673,"Don't worry, it's been fully tested on humans."
3632,94,19,34,73,126,1.5714285714285714,0.06612020936270392,673,It's not poison. Trust me. I know poison.
581,95,17,43,75,135,1.5703703703703704,0.06089505670853536,673,Don't hesitate to call me if the hallucinations continue.
1104,96,16,41,71,128,1.5703125,0.062434605305988496,673,"Here, take this.  I tested it myself."
1429,97,18,38,74,130,1.5692307692307692,0.06362012854379206,673,Don't worry about the side effects. I'm taking it myself.
1685,98,15,42,70,127,1.5669291338582678,0.06183317054797768,673,"It's called the 'human condition', take two of these every four hours and you'll be rejoining the rat race in a week."
2117,98,16,40,71,127,1.5669291338582678,0.06283570129288106,673,Of course it's safe - it was tested on me.
2800,98,17,38,72,127,1.5669291338582678,0.06382248611516991,673,"Getting FDA approval was an absolute maze, but it worked on me."
706,101,17,34,69,120,1.5666666666666667,0.06666666666666665,673,"Wolves on Wall Street, sharks in law: health care was my only choice."
2292,101,15,38,67,120,1.5666666666666667,0.06453163874896185,673,Gnaw on two of these and call me in the morning.
2916,101,12,44,64,120,1.5666666666666667,0.061189576991507504,673,"I didn't picture myself the doctor-type either, till I couldn't get into law school."
2137,104,18,34,72,124,1.564516129032258,0.06602292344821777,673,You remember how the Republicans said they had a great alternative to Obamacare?
1736,105,17,37,72,126,1.5634920634920635,0.06423768537018062,673,"I’m not too worried about the hallucinations, but I’m going to prescribe something for your thyroid."
1461,106,15,37,67,119,1.5630252100840336,0.06497252765136018,673,Side effects? You're looking at them.
776,107,16,40,72,128,1.5625,0.0625,673,Take two of these every day right before you run on your wheel.
1560,108,16,36,69,121,1.56198347107438,0.06523169342370616,673,"Here's a prescription. Take one a day, come back in two days and I'll look more like a fluffy bunny and we can go from there."
1733,108,13,42,66,121,1.56198347107438,0.06198347107438016,673,Hallucinations are a rare side effect.  This prescription should help with them.
1613,110,13,43,67,123,1.5609756097560976,0.06124822438617386,673,"Don’t worry, I take it myself."
2336,110,19,31,73,123,1.5609756097560976,0.06746128607140485,673,"Yeah, I was on them. No side effects."
3970,112,14,38,66,118,1.5593220338983051,0.06430223985460819,673,Two a day and you'll be back in the race in no time.
402,113,16,35,69,120,1.5583333333333333,0.06567451502246544,673,Your coat's looking a little dull.
2119,113,12,43,65,120,1.5583333333333333,0.06126106295029645,673,"Sure, there are side effects. Do you want to feel better or don’t you?"
4298,115,11,41,61,113,1.5575221238938053,0.0627766356922268,673,The pharmacy's under the subway platform.
4508,115,11,41,61,113,1.5575221238938053,0.0627766356922268,673,I'd still like to run a few lab tests with you.
1622,115,16,31,66,113,1.5575221238938053,0.06878259266202395,673,"Well what did you expect? Johns Hopkins IS in Baltimore, after all."
34,118,16,32,67,115,1.5565217391304347,0.06786636524320115,673,From personal experience I know there are few side-effects.
151,119,14,41,69,124,1.5564516129032258,0.06198738837201607,673,You can get this filled at the dumpster behind Sal's.
4488,119,13,43,68,124,1.5564516129032258,0.06092048894765744,673,"It's all allergies, get rid of the cat."
1897,121,16,33,68,117,1.5555555555555556,0.06698030164309422,673,My mistake. I should have warned you about the hallucinogenic side-effects.
3780,121,13,39,65,117,1.5555555555555556,0.06359460794137102,673,"Don't worry, these pills only have one side effect."
4051,121,14,37,66,117,1.5555555555555556,0.06474284806482043,673,"Well, I did say there would be some hallucinogenic side effects."
4506,124,18,25,67,110,1.5545454545454545,0.07258639399516706,673,"It’s safe, I tested it on myself."
2373,125,14,39,68,121,1.5537190082644627,0.06314792335123198,673,Try a little gouda and swiss and call me in the morning.
292,126,19,24,69,112,1.5535714285714286,0.07268442317519681,673,I'm writing you a prescription for Gorgonzola.
2474,126,15,32,65,112,1.5535714285714286,0.06811405676371393,673,.... and you’re going to need a ratscan.
2328,128,11,42,63,116,1.5517241379310345,0.06164271429632317,673,"You can fill this at the nearest pharmacy: turn left, right, right, left, right, left, left, then right."
2815,128,14,36,66,116,1.5517241379310345,0.06518895104434419,673,This ought to get you back in the rat race Mr. Willard.
4021,128,13,38,65,116,1.5517241379310345,0.06402869904020105,673,"I understand your hesitation, but rats don't carry diseases. 
Trust me – I'm a doctor."
1691,131,13,33,61,107,1.5514018691588785,0.06801418429009491,673,You can get this filled behind the refrigerator.
3047,132,16,33,69,118,1.5508474576271187,0.06657692528650852,673,It's an experimental drug.  We want to see how it affects humans before trying it on rats.
2682,133,18,24,67,109,1.5504587155963303,0.07313920943792904,673,"Ha ha, no, I didn’t start out in the lab."
3724,134,9,43,59,111,1.5495495495495495,0.06102957586297429,673,I'm referring you to someone who specializes in hallucinations.
1766,135,11,42,64,117,1.547008547008547,0.06129524258289527,673,"Try taking these daily for a week, then come see me again if the hallucinations continue."
4093,136,11,43,65,119,1.546218487394958,0.06055798460998631,673,"This hasn’t been tested on humans yet, but we had great results with mice."
2408,137,14,38,69,121,1.5454545454545454,0.06320198065034609,673,"This works,it's been tested on me."
1743,137,12,36,62,110,1.5454545454545454,0.06539335477274659,673,"You have warts, not moles. I know moles."
3081,137,15,30,65,110,1.5454545454545454,0.06911373136079965,673,"Gnaw, don't swallow."
4224,137,17,32,72,121,1.5454545454545454,0.06639061303092922,673,This will have you back in the rat race in no time!
2889,141,14,29,62,105,1.542857142857143,0.07035828172596786,673,"Blood cravings, night runs, hunting in packs, howling, eating roadkill. Otherwise it's harmless."
965,142,13,33,63,109,1.5412844036697249,0.06713913883822674,673,"I’m the first of my 1,500 siblings to graduate from college."
1615,142,12,35,62,109,1.5412844036697249,0.06586174381711417,673,And here’s your prescription to treat your hallucinations.
4478,142,14,31,64,109,1.5412844036697249,0.06839267964662735,673,"Don't worry, I've tested this prescription."
4512,142,13,33,63,109,1.5412844036697249,0.06713913883822674,673,"The bad news is I'm a rat.
The good news is there's no co-pay."
2972,146,10,40,61,111,1.5405405405405406,0.06241624531779737,673,Here's your prescription. Should put an end to your irrational hallucinations.
3802,146,13,34,64,111,1.5405405405405406,0.06623585260998724,673,I'd also stay away from cheese. It's a trap.
1578,146,17,26,68,111,1.5405405405405406,0.0710097797924526,673,"If I'm still a rat next week, we'll change this prescription."
2650,149,14,27,61,102,1.5392156862745099,0.07195790393919664,673,Take one every six hours with cheese
824,149,11,33,58,102,1.5392156862745099,0.06779032937689529,673,Of course it's safe. It was tested on my parents.
4091,151,13,30,61,104,1.5384615384615385,0.06957015806923515,673,Actually there are some even more disturbing side effects we should probably talk about.
261,152,8,41,57,106,1.5377358490566038,0.06168424989391672,673,"Again, sorry for biting you. This should clear it up."
1844,152,13,31,62,106,1.5377358490566038,0.06858147914386922,673,Not to worry. Mild hallucinations are a common side-effect.
3439,154,15,28,65,108,1.537037037037037,0.0701404489314915,673,"Trust me, it was tested on me."
1526,155,13,33,64,110,1.5363636363636364,0.06670772360231078,673,We’ll run you through the maze again in a week. Better luck next time.
1152,155,12,35,63,110,1.5363636363636364,0.06544550952364467,673,Who knows better about how drugs work than lab rats?
1241,157,8,38,55,101,1.5346534653465347,0.06381339819533473,673,"I take this too, and look at me."
2863,158,12,23,53,88,1.5340909090909092,0.07742739147057878,673,"Relax, it's the same stuff you use to kill us."
3371,159,11,33,59,103,1.5339805825242718,0.0673327669133393,673,Let's make this quick. I have to get back to the lab.
665,159,8,39,56,103,1.5339805825242718,0.06294918008129567,673,Take 2 with whatever scraps you have in the garbage.
3274,161,6,20,34,60,1.5333333333333334,0.08722549084043064,673,Run two laps in the maze and call me in the morning.
1174,161,11,34,60,105,1.5333333333333334,0.06639137299238815,673,"If it's safe enough for a rat, it's safe enough for you."
3209,161,13,30,62,105,1.5333333333333334,0.06909496923882935,673,I also added the vaccine for bubonic plague because...well you know.
2497,161,17,22,66,105,1.5333333333333334,0.07420724699593366,673,Why yes..I am from Baltimore. Why do you ask?
475,165,13,31,63,107,1.5327102803738317,0.06812313295094134,673,This prescription will help with your hallucinations.
3025,165,15,27,65,107,1.5327102803738317,0.07066422524560746,673,Johns Hopkins. Why do ask?
2789,167,10,39,62,111,1.5315315315315314,0.0624635124546873,673,"Don't worry, it's perfectly safe for humans."
2848,167,12,35,64,111,1.5315315315315314,0.06503299713051217,673,Here's your refill. Let me know if you start having any hallucinations.
869,169,9,34,55,98,1.530612244897959,0.06679221201669486,673,I haven't experienced any side effects.  Why do you ask?
2945,169,15,22,61,98,1.530612244897959,0.07565421469047147,673,"So, you’re a member at Mar-a-Lago? My family's been there for generations."
2285,171,8,38,56,102,1.5294117647058822,0.06340172821417261,673,You should be careful who you're calling a rat.
2189,171,12,30,60,102,1.5294117647058822,0.06925552240510074,673,I'm sorry I bit you. You might want to get this filled immediately.
1108,171,18,18,66,102,1.5294117647058822,0.07720848235908288,673,What's the matter? Do you have a problem with my Trump University credentials?
1106,171,12,30,60,102,1.5294117647058822,0.06925552240510074,673,"If any mole looks suspicious, you should report it immediately to your dermatologist."
110,171,11,32,59,102,1.5294117647058822,0.06783944518374625,673,Don't worry about side effects. I've been taking it for years.
2323,171,13,28,61,102,1.5294117647058822,0.07064321937998234,673,"Oh, but you will give a rat’s ass."
2819,171,10,34,58,102,1.5294117647058822,0.06639317180308237,673,Take two of these and leave your garbage out tonight.
1227,178,14,27,63,104,1.5288461538461537,0.07094361692854002,673,You'll need to take these once a day with trash.
3098,178,16,23,65,104,1.5288461538461537,0.07352829236202653,673,Side effects include seeing people for who they really are
1899,180,11,29,57,97,1.5257731958762886,0.07042577846020343,673,You can get this filled at the dumpster out back.
2183,180,8,35,54,97,1.5257731958762886,0.06569216372459075,673,They've fast tracked this through the FDA - it was tested on me this morning.
164,180,8,35,54,97,1.5257731958762886,0.06569216372459075,673,We're quite optimistic. Tests with lab humans are promising.
4063,180,9,33,55,97,1.5257731958762886,0.06730703534639483,673,Walk two mazes and call me in the morning.
4138,180,8,35,54,97,1.5257731958762886,0.06569216372459075,673,"Of course, I can't guarantee you're not in the control group."
467,185,7,38,54,99,1.5252525252525253,0.06314677196837247,673,"Take two a day with food. Side effects include cravings for cheese, gnawing on wood, and snitching on others."
3784,185,10,32,57,99,1.5252525252525253,0.067867105433217,673,"Next time you think you smell a rat, take two of these. Works for me!"
1384,185,8,36,55,99,1.5252525252525253,0.06475845792876443,673,"Not only did it improve my libido, but I have a new appreciation for Limburger."
3815,185,11,30,58,99,1.5252525252525253,0.0693692083216272,673,Take it with cheese.
3246,189,10,43,67,120,1.525,0.059128237411441194,673,It's just cheddar cheese.  It won't help your symptoms but it's the only thing they let me prescribe now.
3571,190,12,29,60,101,1.5247524752475248,0.06978617895725187,673,I used this myself and it was a game changer.
1449,190,10,33,58,101,1.5247524752475248,0.06688849803585956,673,It’s an experimental drug. Personally tested by yours truly.
122,192,8,40,59,107,1.5233644859813085,0.061351662728710024,673,We do drug trials a little differently now.
3056,193,7,45,61,113,1.5221238938053097,0.05774051705016048,673,"It's still an experimental drug, but trials on humans have been positive."
3706,194,11,26,55,92,1.5217391304347827,0.07327937246229366,673,"Seriously, I've found this drug to be transformative!"
457,195,8,33,53,94,1.5212765957446808,0.06718295294138496,673,"You want species-specific diagnostics, you’re gonna have to up your plan"
2936,195,14,21,59,94,1.5212765957446808,0.07672178805499368,673,"Take one a day. They're safe, I tested them on myself."
3247,195,12,25,57,94,1.5212765957446808,0.07367951929501868,673,I wouldn’t worry about it too much — and this will help with your hallucinations.
3695,195,10,29,55,94,1.5212765957446808,0.07050610161351065,673,Take this to the pharmacists at the end of the maze.
823,199,10,30,56,96,1.5208333333333333,0.06942616718542426,673,"I know this medicine works, I was in the test group."
4005,199,8,34,54,96,1.5208333333333333,0.0661921158358789,673,"If I survived the clinical trial, I'm sure you'll be fine."
3398,201,9,33,56,98,1.5204081632653061,0.06683237812292703,673,This'll help you find your way through the maze.
4549,201,12,27,59,98,1.5204081632653061,0.07139850889717733,673,"This stuff works, my uncle was involved with the trials."
3257,201,10,31,57,98,1.5204081632653061,0.06838830456511333,673,You don’t trust me? Is it the moustache?
2868,201,13,25,60,98,1.5204081632653061,0.07285698668257641,673,Don't you worry. This prescription will get you back looking like your old self.
329,201,8,35,55,98,1.5204081632653061,0.0652393541494786,673,My father dragged slices of pizza down the subway stairs to put me through medical school.
1249,201,11,29,58,98,1.5204081632653061,0.06990961047678285,673,Trust me. I've personally tested all the medications I prescribe
1404,201,9,33,56,98,1.5204081632653061,0.06683237812292703,673,"Yes, it's a possible side effect, but I've learned to live with it."
243,208,9,29,53,91,1.5164835164835164,0.07051638828327114,673,"That's DOCTOR Vermin, please."
4196,209,9,30,54,93,1.5161290322580645,0.06941433893775216,673,Take it twice a day and avoid cats.
759,209,10,28,55,93,1.5161290322580645,0.07107815797318978,673,"Actually, I’m the only one in my family who’s not a lawyer."
2078,209,8,32,53,93,1.5161290322580645,0.06770964746229703,673,My father was a lab rat but he always wanted more for me.
255,209,7,34,52,93,1.5161290322580645,0.06596091470539171,673,"I wasn't always a doctor, but things evolved."
530,213,13,23,59,95,1.5157894736842106,0.07462209066620011,673,"Yes, i did try this prescription myself.  Why do you ask?"
1758,213,7,35,53,95,1.5157894736842106,0.06499747242003873,673,I'm referring you to Dr. Katz.
4052,213,10,29,56,95,1.5157894736842106,0.06997545225430231,673,There might be some side effects.
4125,213,9,31,55,95,1.5157894736842106,0.06835641705400203,673,My lab results weren’t that great either.
3959,217,10,30,57,97,1.5154639175257731,0.06891619565526255,673,"Down the hall on the left, left, right, left, right, left, right, right, left."
2939,217,12,26,59,97,1.5154639175257731,0.07196523666465109,673,We don't do CAT scans in our office
4049,217,9,32,56,97,1.5154639175257731,0.06733992420022482,673,"Good news, bad news, John. The test results were good, no sign of bubonic plague. Unfortunately, though, your credit card's been declined."""
3621,217,7,36,54,97,1.5154639175257731,0.06407114894152605,673,"I can vouch for the effectiveness of this drug, I participated in the clinical trial"
2840,217,14,22,61,97,1.5154639175257731,0.07489024337524917,673,"This lower dose should stop the diarrhea, but you still may experience hallucinations."
3975,217,10,30,57,97,1.5154639175257731,0.06891619565526255,673,I’ve worked my way up from lab rat to principal investigator.
1655,217,11,28,58,97,1.5154639175257731,0.07045721152512946,673,"It does have some unusual side effects, but it cured my cold immediately."
1399,217,11,28,58,97,1.5154639175257731,0.07045721152512946,673,Take this cheese and call me in the morning.
1985,217,12,26,59,97,1.5154639175257731,0.07196523666465109,673,"I'm a new hybrid -- part doctor, part health insurance company."
2195,226,6,30,46,82,1.5121951219512195,0.06993760379709454,673,Here's your prescription.  I have personal experience with it from my lab work.
4548,227,7,30,49,86,1.5116279069767442,0.06967618290464733,673,"Correct, that's one pill, twice a day, wrapped in a piece of cheese."
3540,228,9,28,53,90,1.511111111111111,0.07109706478002936,673,I learned early in my career that being in the lab is not for me.
392,228,12,22,56,90,1.511111111111111,0.07618304464083643,673,Take two of these daily and for God sake stay away from any tempting peanut butter or cheese resting on a little piece of wood.
599,228,9,28,53,90,1.511111111111111,0.07109706478002936,673,"In fact, I grew up in Baltimore. Why?"
1477,231,9,29,54,92,1.5108695652173914,0.06997126776615176,673,I personally tested this prescription while running a maze at Harvard med school.
903,232,9,30,55,94,1.5106382978723405,0.06889107721305673,673,"It is safe, I have been using it for years!"
1069,232,11,26,57,94,1.5106382978723405,0.07213557872773799,673,"Trust me, you want the placebo."
1842,232,10,28,56,94,1.5106382978723405,0.07053198649535199,673,Side effects? None that I'm aware of.
4494,232,13,22,59,94,1.5106382978723405,0.07524030115035443,673,"It's experimental, but it worked for me."
3751,236,8,33,55,96,1.5104166666666667,0.06621799403423612,673,I always recommend getting rid of your cat as a first-line treatment
3427,237,11,28,59,98,1.510204081632653,0.06993263862249995,673,Run three mazes a day and stay away from Gruyere.
3382,238,8,28,51,87,1.5057471264367817,0.07102857404993176,673,"You completed the maze, here is your prescription for cheese."
3122,239,6,33,50,89,1.5056179775280898,0.06612659166349136,673,These pills should cure your hallucinations.
4432,239,9,27,53,89,1.5056179775280898,0.07168552133987487,673,Take this. It will help with the hallucinations.
3966,241,13,20,58,91,1.5054945054945055,0.07714950105143309,673,It’s been approved for human testing.”
4271,241,6,34,51,91,1.5054945054945055,0.06513558016233036,673,I recommend a paleo diet.
958,241,13,20,58,91,1.5054945054945055,0.07714950105143309,673,"If you need Penicillin, I recommend the moldy cheese in the alley."
1385,241,6,34,51,91,1.5054945054945055,0.06513558016233036,673,"It’s an experimental drug, but we’re confident there are no side effects."
2359,241,11,24,56,91,1.5054945054945055,0.07391647329306632,673,"Oh fuck, I didn't turn into a big rat again, did I?"
4146,241,8,30,53,91,1.5054945054945055,0.06878258712409598,673,"You know, I got my start in a lab, but the clinical studies weren't my thing"
4135,241,6,34,51,91,1.5054945054945055,0.06513558016233036,673,They work well. I was on the testing committee.
1821,248,9,29,55,93,1.5053763440860215,0.06943244151699791,673,Take it twice a day with food scraps.
2838,249,9,30,56,95,1.5052631578947369,0.06837365918242709,673,These may cause you to hallucinate.
3562,249,8,32,55,95,1.5052631578947369,0.06671576353652271,673,You can get this filled in Canada for chicken feed.
194,251,10,29,58,97,1.5051546391752577,0.06893225816466499,673,I accept cheese or check.
3120,252,9,27,54,90,1.5,0.07110681947099658,673,There are a few side effects.
2927,252,9,27,54,90,1.5,0.07110681947099658,673,"Listen, I'm not supposed to do this, but when I needed them, these things got me through a lot of mazes."
2821,252,6,31,49,86,1.5,0.06769611021242873,673,Don’t worry. Just think of it as a dose of your own medicine.
2542,252,8,27,51,86,1.5,0.07162373182352562,673,"This will help with the hallucinations, but in the meantime, try to get some sleep."
2069,252,6,31,49,86,1.5,0.06769611021242873,673,"I tried it on myself first, the side effects are minimal."
1880,252,10,25,55,90,1.5,0.07284138703661694,673,I've tried it myself.
1310,252,10,24,54,88,1.5,0.07406681724583486,673,Or we put you in a cage and administer small electric shocks.”
1182,252,12,20,56,88,1.5,0.07751360820291699,673,"Yes, I'm from Baltimore."
1156,252,6,33,51,90,1.5,0.06562862260377643,673,I can guarantee it doesn't contain rat poison.
3186,252,11,24,57,92,1.5,0.07331479879864508,673,Look we didn't choose to spread the Plague. Why you're bringing back Measles I'll never know
1109,252,10,23,53,86,1.5,0.07534689497758576,673,"Sorry you don't like the care, sir, but here at Johns Hopkins we are all in Elijah Cummings' rat-infested district."
401,252,9,27,54,90,1.5,0.07110681947099658,673,"Hide two of these in a piece of cheese, and take before bed."
349,252,7,33,54,94,1.5,0.06549531463278076,673,"If you see anything unusual, just call me."
334,252,11,23,56,90,1.5,0.07453559924999299,673,I'm on it too. There's only one side effect.
99,252,10,23,53,86,1.5,0.07534689497758576,673,Now scurry over to the pharmacy.
3689,252,8,25,49,82,1.5,0.07413051147203215,673,"Sure, I'll get you the pills, but don't rat me out."
3693,252,9,28,55,92,1.5,0.0699805446992739,673,We hope this works in humans so we can try it in rats.
4152,252,7,30,51,88,1.5,0.06857254813237416,673,"It's tough on the stomach, but are you a mouse or a man?"
1145,252,7,31,52,90,1.5,0.06750410354197915,673,"Yes actually, I did take this medicine myself. Why do you ask?"
4,252,7,27,48,82,1.5,0.07207092762586559,673,It’s been successfully tested on lab people.
1812,272,8,30,55,93,1.4946236559139785,0.06772820567765507,673,"Take two pills a day -- and if you feel like garbage, go ahead and eat some."
415,272,8,30,55,93,1.4946236559139785,0.06772820567765507,673,"What do you mean, hallucinations ? No, actually, we have taken over. This is a prescription for the flu."
3984,274,8,29,54,91,1.4945054945054945,0.06878258712409598,673,"Don’t worry, the side effects are minimal. I take it myself."
4294,275,9,25,53,87,1.4942528735632183,0.07288598313755927,673,So you say your hallucinations are getting worse Mr Smith?
2713,275,10,23,54,87,1.4942528735632183,0.07469722045893348,673,Try this. It's worked wonders for me with no noticeable side effects.
1956,275,7,29,51,87,1.4942528735632183,0.06912127114864645,673,"Not to worry, it's been extensively tested on some of my relatives."
2190,275,10,23,54,87,1.4942528735632183,0.07469722045893348,673,"I swear, the only lasting side effect is a compulsion to move to Baltimore."
428,275,5,33,49,87,1.4942528735632183,0.06513934074336977,673,This one is very safe and effective. No side effects. I actually take it myself.
332,275,9,25,53,87,1.4942528735632183,0.07288598313755927,673,"I'm sorry, we don't accept Blue Cross and Blue Cheese."
1644,275,8,27,52,87,1.4942528735632183,0.07102857404993176,673,"It wasn't perfected when I took it, but I promise you -- this'll put that ol' eyeball right back in your head."
268,282,7,28,50,85,1.4941176470588236,0.07026067791046633,673,"Sure it's safe, in fact I use it myself."
1166,282,7,28,50,85,1.4941176470588236,0.07026067791046633,673,"Sure, that's one side effect.  But you'll be great at mazes."
1746,282,12,18,55,85,1.4941176470588236,0.0796060492960675,673,"Yes, I live in Elijah Cummings's district. Why do you ask?"
2704,282,7,28,50,85,1.4941176470588236,0.07026067791046633,673,I can vouch for this new medication. I was involved in some of the original trials.
2128,286,6,29,48,83,1.4939759036144578,0.06936489091504061,673,"There are some side-effects,"
4318,286,8,25,50,83,1.4939759036144578,0.07347928151660292,673,The pharamaceutical company assures me that it's completely safe.
4470,286,9,23,51,83,1.4939759036144578,0.07545239010439983,673,"Trust me, I know the plague when I see it."
2798,289,10,20,51,81,1.4938271604938271,0.07880953910372657,673,This should help your gnawing anxiety.
1774,289,14,12,55,81,1.4938271604938271,0.08628737656793359,673,I examined your stool sample. It was delicious.
1134,289,9,22,50,81,1.4938271604938271,0.07682643736652875,673,"Well, at least I'm not a quack."
3822,289,8,24,49,81,1.4938271604938271,0.07479077151042449,673,"Relax, everything will be fine. I was part of the original test study."""
2023,293,9,19,47,75,1.4933333333333334,0.08136965663575717,673,"Now, I insist that all my new patients get vaccinated for the plague."
2480,294,5,16,32,53,1.490566037735849,0.09183914089727939,673,You can get this at any drugstore here in Baltimore.
4302,295,10,23,55,88,1.4886363636363635,0.07405679670635239,673,"Sure,Baltimore General strives to be reflective of the community,but I earned my degree like anyone else."
497,296,10,22,54,86,1.4883720930232558,0.07533633849487509,673,Here's a little trick I found to combat nose hair.
2605,296,10,22,54,86,1.4883720930232558,0.07533633849487509,673,"Hey, we can't all work in the White House."
3326,296,6,30,50,86,1.4883720930232558,0.06768436047525571,673,"I take it myself.  Of course, there's a few side effects."
3558,296,11,20,55,86,1.4883720930232558,0.07713080907803256,673,Take this and you won't give a rat's ass about your problems.
3981,296,8,26,52,86,1.4883720930232558,0.07161262650803543,673,Don’t worry.  These tests at the laboratory where I was trained.
3722,301,9,23,52,84,1.4880952380952381,0.07478032011339286,673,This medicine has proven safe for rats. It could go either way for humans.
2021,301,8,25,51,84,1.4880952380952381,0.0728370410135986,673,"As you can see, Trump's healthcare plan is also a rat- and rodent-infested mess."
663,301,8,25,51,84,1.4880952380952381,0.0728370410135986,673,"This should help with the hallucinations, but I also recommend bumping up to three pounds of cheese a day."
1820,301,10,21,53,84,1.4880952380952381,0.0766743634398511,673,"In clinical trials, this drug pushed rodent IQs to 150.  It should straighten out your Republican brain."
3668,301,8,25,51,84,1.4880952380952381,0.0728370410135986,673,I assure you there are no side effects.
3184,306,9,22,51,82,1.4878048780487805,0.07612234094952922,673,That stuff you use to poison us? For you it’s a blood thinner.
1202,306,9,22,51,82,1.4878048780487805,0.07612234094952922,673,Swallow each pill whole - no nibbling.
1921,306,11,18,53,82,1.4878048780487805,0.07998024153590086,673,"I used to make house calls, but it's a trap"
3477,306,9,22,51,82,1.4878048780487805,0.07612234094952922,673,You’ll want to be sure to take this with a bite of garbage.
1115,306,11,18,53,82,1.4878048780487805,0.07998024153590086,673,"Trust me, I'm the White House doctor."
3118,311,10,19,51,80,1.4875,0.07954329686371674,673,"What's the matter, haven't you seen a doctor with a moustache before?"
250,311,7,25,48,80,1.4875,0.0733332733985179,673,"Turns out it does cure cancer, but also turns everyone into a rat. Now do you want it or not?"
2103,313,6,26,46,78,1.4871794871794872,0.07240594331431646,673,"As a former test subject myself, I can assure you the side effects are minimal."
3387,314,11,22,58,91,1.4835164835164836,0.07389831868802935,673,Side effects include seeing Big Pharma for what it truly is.
1848,315,5,31,49,85,1.4823529411764707,0.06612899012521703,673,"It’s a good drug, I take it myself, only one side effect."
2512,315,10,21,54,85,1.4823529411764707,0.0759842323055954,673,Its the new Republican health care plan.  I'm the manager here.
149,317,9,22,52,83,1.4819277108433735,0.07542892489154675,673,"Ironically, humans initially developed this medicine as a rat poison.  Who's laughing now?"
750,317,3,34,46,83,1.4819277108433735,0.06266077360416564,673,The side effects may include vivid hallucinations.
3992,317,7,26,50,83,1.4819277108433735,0.07142692762364836,673,Here is a comp ticket to see me in The Nutcracker tonight.
4177,320,6,27,48,81,1.4814814814814814,0.07051641764688804,673,"I'd also recommend a spinning wheel, for exercise."
4020,320,7,25,49,81,1.4814814814814814,0.07267191433462439,673,"This prescription is $400, but it's free if you get through the maze in three minutes."
3167,320,7,25,49,81,1.4814814814814814,0.07267191433462439,673,Would you like to participate in a very early stage clinical drug trial?  You’d be the first human.
2053,320,8,23,50,81,1.4814814814814814,0.07476529347476427,673,"Trust me!  I didn't figure out how to get through the maze, and work my way through medical school, without learning a thing or two."
2035,320,7,25,49,81,1.4814814814814814,0.07267191433462439,673,I can assure you this medicine is safe - I have taken it myself
3093,320,10,19,52,81,1.4814814814814814,0.07878536068956536,673,I’m accepting new patients. Post this somewhere in your basement.
1029,320,5,29,47,81,1.4814814814814814,0.06829292190587324,673,No humans were harmed during testing.
1706,320,9,21,51,81,1.4814814814814814,0.07680163464195452,673,I've tested the medication myself. Why do you ask ?
431,328,9,20,50,79,1.481012658227848,0.0782408823325932,673,Don't worry. They tested it on me first.
483,328,8,22,49,79,1.481012658227848,0.07613846415156787,673,Take it twice a day with cheese
1553,328,5,28,46,79,1.481012658227848,0.06945038436819669,673,"Don't worry, it's not a prescription. It's a fondue recipe. Cheese always seems to enhance mood levels."
2094,328,9,20,50,79,1.481012658227848,0.0782408823325932,673,"Take this to the pharmacy down the hall. Turn right, then left. Dead end. Double back, and it's around the corner to the left."
137,332,10,17,50,77,1.4805194805194806,0.08186644845666796,673,"Fair warning, there may be side effects."
3933,332,6,25,46,77,1.4805194805194806,0.07304150453184358,673,You will be fine. It's been exhaustively tested on laboratory humans
2925,332,9,19,49,77,1.4805194805194806,0.07975181429440985,673,Just be thankful that I am in network.
1093,332,6,25,46,77,1.4805194805194806,0.07304150453184358,673,We're not all lawyers.
1846,332,7,23,47,77,1.4805194805194806,0.07534470707311537,673,Just take this and avoid the subway. You'll be fine.
4366,337,8,24,52,84,1.4761904761904763,0.07280186819496158,673,"Side effects?  No, no side effects since I've been on it.  Why do you ask?"
1124,337,11,18,55,84,1.4761904761904763,0.07849010899859392,673,"These pills are still in trials, but I've tried them and they're 
a-mazing!"
2860,339,8,23,51,82,1.475609756097561,0.07408095898556447,673,"Well actually, I graduated from Ratcliffe. Why do you ask?"
2154,340,9,20,51,80,1.475,0.07749030155731126,673,"Doctorate...Doctor Rat.  Same diff, right?"
3252,340,8,22,50,80,1.475,0.07542076066469036,673,This should help with those hallucinations.
4436,340,6,26,48,80,1.475,0.0711011937089346,673,"Believe me, I know bubonic plague when I see it."
1948,340,9,20,51,80,1.475,0.07749030155731126,673,This will help you to become a Trump supporter too.
4465,340,6,26,48,80,1.475,0.0711011937089346,673,Tell ‘em The Lab Rat sent ya
3493,340,5,28,47,80,1.475,0.06883984348204832,673,I think we’re ready to move on to human trials.
2506,340,9,20,51,80,1.475,0.07749030155731126,673,The pharmacy is down the sewer to your left
2370,340,10,18,52,80,1.475,0.07950599053936482,673,"In phase one studies with this drug, most humans did survive."
3951,340,10,18,52,80,1.475,0.07950599053936482,673,This one worked for 95% of my relatives.
1222,340,6,26,48,80,1.475,0.0711011937089346,673,My last place was just a hole in the wall.
325,340,8,22,50,80,1.475,0.07542076066469036,673,Why are you so surprised? I won the rat race.
233,340,8,22,50,80,1.475,0.07542076066469036,673,"Here's your prescription, and please get over the ""Black Plague thing"""""
692,340,9,20,51,80,1.475,0.07749030155731126,673,"You'll find, trust me, that your maze solution times improve dramatically."
1357,340,9,20,51,80,1.475,0.07749030155731126,673,This should help with your hallucinations.
820,354,5,27,46,78,1.4743589743589745,0.07002297081442618,673,"it's for delusional thinking. Take two every day 
or until you stop seeing rodents everywhere."
848,354,10,17,51,78,1.4743589743589745,0.08104454396614029,673,"Relax, it’s a much lower dose than I take."
1484,354,8,21,49,78,1.4743589743589745,0.0768258904320606,673,I gotta guy ...he doesn't ask questions.
1775,354,9,19,50,78,1.4743589743589745,0.07896339515040696,673,Eat more cheese and get rid of that cat.
2568,354,6,25,47,78,1.4743589743589745,0.07236170793090994,673,"If you think I'm a giant talking mouse, then you really need this prescription"
4277,359,6,24,46,76,1.4736842105263157,0.07368421052631578,673,Are you still doing your mazes?
4272,359,6,24,46,76,1.4736842105263157,0.07368421052631578,673,"Yes, I’m sure you’re hallucinating 
 & not having a recurring dream."
3846,359,4,28,44,76,1.4736842105263157,0.0687576068149664,673,The experiment went so well  I became one of them.
2757,359,9,18,49,76,1.4736842105263157,0.08051083442514924,673,"I’m required to tell you it’s not yet approved for use in humans. But don’t worry, I’ve been taking it for years."
2478,359,4,28,44,76,1.4736842105263157,0.0687576068149664,673,I got my start in the lab.
1116,359,9,18,49,76,1.4736842105263157,0.08051083442514924,673,It'll work. I tested it on my family.
966,359,8,20,48,76,1.4736842105263157,0.07830145124358386,673,I know this prescription will work ; it was tested on me in the lab.
556,359,6,15,36,57,1.4736842105263157,0.09061632175333798,673,Take two of these a day with cheese.
3727,367,5,25,44,74,1.472972972972973,0.07256595251909087,673,"Your lucky,I've been taking this same medication for years with no side effects !"
2823,367,5,25,44,74,1.472972972972973,0.07256595251909087,673,This showed great promise in the lab .
347,367,8,19,47,74,1.472972972972973,0.07985309765963797,673,"Infested, infected...what's in a word?"
1479,370,9,19,51,79,1.4683544303797469,0.07818835404044687,673,I’m prescribing two weeks rest and relaxation in Baltimore.
1508,370,5,27,47,79,1.4683544303797469,0.06939120209552378,673,"Don't worry. I take it myself, and the side effects are barely noticeable."
1764,370,8,21,50,79,1.4683544303797469,0.07608448437579868,673,That's when I discovered it was better to be the one performing the research.
3053,370,8,21,50,79,1.4683544303797469,0.07608448437579868,673,"It's not FDA approved yet, but it works well for me."
3967,374,6,24,47,77,1.4675324675324675,0.07298071259078134,673,I assure you these are perfectly safe. I take them myself. But there is one unusual side effect I've noticed.....
3980,374,6,24,47,77,1.4675324675324675,0.07298071259078134,673,Of  course it’s safe. I tested it myself.
4275,374,7,22,48,77,1.4675324675324675,0.07528577495062708,673,My friends at the lab recommend this medicine.
4427,374,7,22,48,77,1.4675324675324675,0.07528577495062708,673,''If it hasn't cleared up in a few days come back and we'll start sniffing around for clues.'
2089,374,7,22,48,77,1.4675324675324675,0.07528577495062708,673,It reduces the gap between your paranoia and reality.
1886,374,9,18,50,77,1.4675324675324675,0.07969614111883297,673,Where did you say your Grandmother lived?
1788,374,11,14,52,77,1.4675324675324675,0.08387491823274353,673,I can personally assure you these will help with the rat race.
2862,374,7,22,48,77,1.4675324675324675,0.07528577495062708,673,I can personally vouch for this. It was tested on three of my brothers.
1640,374,8,20,49,77,1.4675324675324675,0.0775223284581591,673,"Well, look what it did for me."
773,374,10,16,51,77,1.4675324675324675,0.08181221430135709,673,Baltimore? Actually I’m from D.C.
1771,374,7,22,48,77,1.4675324675324675,0.07528577495062708,673,Don’t worry about side effects - I take it myself.
1524,374,6,24,47,77,1.4675324675324675,0.07298071259078134,673,This should help with your fear of rats.
1401,374,8,20,49,77,1.4675324675324675,0.0775223284581591,673,"You can fill this on practically any corner, Baltimore is infested with pharmacies."
4519,387,6,23,46,75,1.4666666666666666,0.07433387871977033,673,"I'm telling you, no side effects"
4166,387,7,21,47,75,1.4666666666666666,0.07671952740916672,673,"I didn't experience any issues during testing, but side effects vary by individual."
3913,387,5,25,45,75,1.4666666666666666,0.07186908351415902,673,Try these--I find them helpful when I'm feeling trapped or at a dead end.
3440,387,8,19,48,75,1.4666666666666666,0.07903319711517588,673,"It is experimental, but I'm on it myself."
3211,387,4,27,44,75,1.4666666666666666,0.06931669932133816,673,Works great and never tested on rats.
1724,387,8,19,48,75,1.4666666666666666,0.07903319711517588,673,Let’s worry about the diseases you’re carrying.
1608,387,3,29,43,75,1.4666666666666666,0.06666666666666665,673,"This won't stop the hallucinations, but at least they'll seem hilarious."
141,387,5,25,45,75,1.4666666666666666,0.07186908351415902,673,You’ll own the night and have thousands of offspring.
1107,387,9,17,49,75,1.4666666666666666,0.08128103472893664,673,It works.  I tested it myself.
1334,396,8,18,47,73,1.4657534246575343,0.08062303005940445,673,Give it a month or two and you'll love Baltimore.
2206,396,5,24,44,73,1.4657534246575343,0.0732019157163534,673,"This will put hair on your chest, and everywhere else!"
3401,396,6,22,45,73,1.4657534246575343,0.07575643846135642,673,"Don’t worry, it’s safe. It was tested on me."
4043,396,7,20,46,73,1.4657534246575343,0.07822758766672061,673,"Trust me, I've spent a lot of time in the lab."
3035,396,6,22,45,73,1.4657534246575343,0.07575643846135642,673,Have someone hold your mouth shut until you swallow.
1779,396,6,22,45,73,1.4657534246575343,0.07575643846135642,673,"It's perfectly safe; I use it myself."""
549,396,6,22,45,73,1.4657534246575343,0.07575643846135642,673,"This should help control your hallucinations. Come back in a week and we'll see if it worked."""
266,396,5,24,44,73,1.4657534246575343,0.0732019157163534,673,"After I was caught stealing the pizza, I decided I needed a career change."
1300,396,7,20,46,73,1.4657534246575343,0.07822758766672061,673,I don't make mouse calls.
271,405,8,17,46,71,1.4647887323943662,0.08229843596063405,673,Just in case you come across a difficult maze.
842,406,9,21,54,84,1.4642857142857142,0.07468892952609918,673,Take these twice a day with some cheese.
306,407,5,27,48,80,1.4625,0.0687679780866544,673,"yes, talking animals is a side effect"
3997,407,6,25,49,80,1.4625,0.07103161624466328,673,Any side effects?
4331,409,9,18,51,78,1.4615384615384615,0.07889578370282628,673,What did you think the Ratification of Obamacare meant?
3216,409,7,22,49,78,1.4615384615384615,0.07455564378423998,673,"Nibble two times a day, with or without cheese."
1885,409,7,22,49,78,1.4615384615384615,0.07455564378423998,673,You can get this prescription filled at any Chuck-E-Cheese.
1452,409,6,24,48,78,1.4615384615384615,0.07228792213836381,673,Here’s the prescription for those ridiculous hallucinations.
1803,413,5,25,46,76,1.4605263157894737,0.07118246746901173,673,This drug is perfectly safe. I take it myself.
3143,414,6,22,46,74,1.4594594594594594,0.07499028491734214,673,Take these medications for the diseases I just transmitted to you.
2309,414,4,26,44,74,1.4594594594594594,0.06987901214308198,673,Yes I did go to medical school at Johns Hopkins. Why do you ask?
4515,414,5,24,45,74,1.4594594594594594,0.07247971843928877,673,I think you'll enjoy this pill. It has just a hint of Roquefort.
2198,414,4,26,44,74,1.4594594594594594,0.06987901214308198,673,Rare side effects may occur
1904,414,8,18,48,74,1.4594594594594594,0.079774741152042,673,Take two of these and call me if your hallucinations continue.
3268,414,7,20,47,74,1.4594594594594594,0.07741948126233944,673,Take one of these whenever you think you see an animal head on a human body.
1739,414,8,18,48,74,1.4594594594594594,0.079774741152042,673,Don't give up.  I encountered a lot of dead ends getting to where I am today.
1215,414,6,22,46,74,1.4594594594594594,0.07499028491734214,673,This one should end the hallucinations. You'll no longer see yourself as a hairless ape.
1317,414,3,28,43,74,1.4594594594594594,0.0671776978702562,673,My father spent his life in the dump just to get me where I am today
890,414,9,16,49,74,1.4594594594594594,0.08206243094632817,673,I started in the lab and then went to medical school.
1572,414,5,24,45,74,1.4594594594594594,0.07247971843928877,673,"You know, lab tests on my relatives were very successful."
1212,414,5,24,45,74,1.4594594594594594,0.07247971843928877,673,You'll be in the same trial as my brother.
338,426,8,17,47,72,1.4583333333333333,0.08140371579496182,673,You'll be navigating mazes successfully again in no time.
491,426,7,19,46,72,1.4583333333333333,0.07896409714862605,673,And no driving. Take the subway like I do.
1945,426,7,19,46,72,1.4583333333333333,0.07896409714862605,673,Some of us made it out of the subway.
2037,429,4,24,42,70,1.457142857142857,0.0724767808487693,673,You can have the prescription filled at any corner in your basement.
4521,429,6,20,44,70,1.457142857142857,0.07798103046316464,673,That’s Doctor Rat to you!!
51,431,5,21,42,68,1.4558823529411764,0.07679323438282955,673,This will treat what plagues you.
1057,431,3,25,40,68,1.4558823529411764,0.07084657875598134,673,"Before I started taking these, I couldn’t even figure out the maze."
2829,431,6,19,43,68,1.4558823529411764,0.07960014076464034,673,This should help fuel positive feelings about living in Baltimore.
2452,434,12,12,55,79,1.4556962025316456,0.08411184875557629,673,"That's DOCTOR Rat Bastard, to you!"
4375,434,4,28,47,79,1.4556962025316456,0.06691967978476934,673,I'm sorry your insurance is out of our network. We take cash or cheese.
2304,434,8,20,51,79,1.4556962025316456,0.0760034428285226,673,"Trust me, I tested this medication myself!"
728,437,7,32,62,101,1.4554455445544554,0.06217947908161418,673,Here; take two of these and watch out for the cat.
3347,438,7,21,49,77,1.4545454545454546,0.07519729016986465,673,"Relax, I washed my hands."
3582,438,8,19,50,77,1.4545454545454546,0.07743639937748306,673,Not to worry. Rats tested it. A rat can prescribe it.
1513,440,12,20,65,97,1.4536082474226804,0.0718266493679673,673,"Through that door, along the maze to find your reward."
372,441,7,20,48,75,1.4533333333333334,0.07662552754449051,673,Side effects?  Don't worry--I've been taking these myself for years.
2148,441,7,20,48,75,1.4533333333333334,0.07662552754449051,673,Why would you think I’d breach doctor-patient confidentiality?
4127,441,9,16,50,75,1.4533333333333334,0.08119231609082349,673,Here's a prescription for something stronger. You can't get this kind of cheese over the counter.
4286,441,9,16,50,75,1.4533333333333334,0.08119231609082349,673,"Now to get back to reception it’s three rights, left, right, right, left."
4010,445,7,19,47,73,1.452054794520548,0.07812757366332727,673,"Where did you say you did yor rodency, I mean residency."
56,445,6,21,46,73,1.452054794520548,0.07565315765196753,673,It's an anti-hallucinatory.
150,445,5,23,45,73,1.452054794520548,0.07309502554147088,673,It helps if you wrap it in a bit of cheese before taking it.
545,445,7,19,47,73,1.452054794520548,0.07812757366332727,673,I tested it on myself.
2540,445,5,23,45,73,1.452054794520548,0.07309502554147088,673,"I know you’re worried about the side effects of this new medication, but I take this, and look at me?"
3125,445,6,21,46,73,1.452054794520548,0.07565315765196753,673,There are a few cosmetic side effects.
3312,445,4,25,44,73,1.452054794520548,0.07044405762804343,673,"If you’re interested in a lab testing gig, let me know."
3624,445,6,21,46,73,1.452054794520548,0.07565315765196753,673,"It happens to a lot of men. Take this, and you'll be breeding like me in no time."
3637,445,5,23,45,73,1.452054794520548,0.07309502554147088,673,"Yeah,  Johns Hopkins, class of 2010. Why do you ask?"
2245,454,5,22,44,71,1.4507042253521127,0.0744901716455073,673,The prescription is at the end of the maze.
219,454,4,24,43,71,1.4507042253521127,0.07173821286354722,673,"Gnaw on these as needed, and spend more time on the exercise wheel."
2769,454,7,18,46,71,1.4507042253521127,0.07970956432963486,673,I’ve been taking these for years with absolutely no side effects.
3688,454,7,18,46,71,1.4507042253521127,0.07970956432963486,673,Take these but only under a full moon.
2694,454,11,10,50,71,1.4507042253521127,0.08923717046896049,673,Here's your ticket to Baltimore.
1499,454,5,22,44,71,1.4507042253521127,0.0744901716455073,673,This is a new drug for your erectile dysfunction. There are some significant side effects but it is a personal choice.
21,454,6,20,45,71,1.4507042253521127,0.0771440221838262,673,Lurk in your attic while nibbling these for a few days.
1005,454,3,26,42,71,1.4507042253521127,0.0688763870853726,673,Should be safe... we even tested it on ourselves.
98,462,8,20,52,80,1.45,0.07526325107265376,673,Go ahead. It's been proven safe on laboratory humans.
3341,463,6,19,44,69,1.4492753623188406,0.07871580066087112,673,This will help you cope with the rat race – it did wonders for me.
3164,463,10,11,48,69,1.4492753623188406,0.0888887344476462,673,"No, hallucinations are not a side effect of the medication you're on. Why do you ask?"
337,463,7,17,45,69,1.4492753623188406,0.0813783431459964,673,Donald Trump’s physician..... Just another rat in the White House.
2901,463,6,19,44,69,1.4492753623188406,0.07871580066087112,673,"Don't worry, it's completely safe. I tested it on my family."
2518,463,6,19,44,69,1.4492753623188406,0.07871580066087112,673,Sorry I bit you. Get this filled and you should be okay.
251,468,5,20,42,67,1.4477611940298507,0.07751098050209018,673,My friends at the lab should be able to get you what you need.
1742,468,5,20,42,67,1.4477611940298507,0.07751098050209018,673,Take two slices of cheese and call me in the morning.
1522,468,4,22,41,67,1.4477611940298507,0.07453635397590774,673,"Trust me, it worked well on rats."
798,471,6,17,42,65,1.4461538461538461,0.08213137116947164,673,This is your bonus and I don't give a rats ass how you feel about it.
1457,471,6,17,42,65,1.4461538461538461,0.08213137116947164,673,For Pete’s sake. All we did was cut out the middle man!
1849,471,3,23,39,65,1.4461538461538461,0.07282344703369806,673,Here's an opthamologist I like. Good luck.
1546,474,5,23,46,74,1.445945945945946,0.07235881807415351,673,"Take it from me, other than occasional cravings for hard cheese there are no side effects to worry about."
2396,475,5,26,50,81,1.4444444444444444,0.06804138174397717,673,"We'll need some bloodwork. Take 2 lefts,a right,a left,and 2 more rights until you see the sign for the lab."
774,475,5,22,45,72,1.4444444444444444,0.07371456839364933,673,The only side effect is that sometimes you just don't feel like yourself.
1132,475,4,24,44,72,1.4444444444444444,0.07101127577175853,673,It's very safe - 9 out of 10 of my relatives had no adverse side effects.
3956,475,6,16,41,63,1.4444444444444444,0.08399210511316159,673,"The pharmacy is down two floors, off the elevator, left, right, right, left, right, left."
4045,479,7,17,46,70,1.4428571428571428,0.08046375490429117,673,It's just required testing before we can prescribe them to animals.
2737,479,7,17,46,70,1.4428571428571428,0.08046375490429117,673,These should cure your hallucinations.
1028,479,5,21,44,70,1.4428571428571428,0.07514158970504524,673,"Tested on rats? Of course not, that would be unethical."
2421,479,5,21,44,70,1.4428571428571428,0.07514158970504524,673,"If you run out, just pull the black lever."
115,483,6,15,40,61,1.4426229508196722,0.08596793837460259,673,"Thank you for volunteering for our animal testing program, it's very important that we know if these drugs are suitable for vermin consumption."
2790,484,6,11,35,52,1.4423076923076923,0.09675528342490991,673,I once misdiagnosed an old Gypsy woman.
2293,485,7,16,45,68,1.4411764705882353,0.08217401860238108,673,I wouldn’t prescribe for you anything they hadn’t first tested on me.
2225,485,7,16,45,68,1.4411764705882353,0.08217401860238108,673,"Make your first right, your second left, go to the end, go right, then right, then left, then the second right, make the next left, then a left, then a left,  the next left, make a right, a right, and a left, and the pharmacy's right there."
3109,485,6,18,44,68,1.4411764705882353,0.07945808813764718,673,Your eye condition qualifies. Here's your marijuana prescription.
1918,485,9,12,47,68,1.4411764705882353,0.08735291900568176,673,What do you mean I’m making a pest of myself.
4352,485,5,20,43,68,1.4411764705882353,0.07664597972311231,673,This might have some side effects but it will definitely suppress your social anxiety
4511,485,8,14,46,68,1.4411764705882353,0.08480301230521728,673,"There'll be cheese at the end, but you should bring your own wine."
1218,485,5,20,43,68,1.4411764705882353,0.07664597972311231,673,No it’s not addictive. In fact I own shares in the company.
941,485,8,14,46,68,1.4411764705882353,0.08480301230521728,673,"Turns out you were in the placebo group. But look on the bright side, you got 20 bucks!"
741,485,6,18,44,68,1.4411764705882353,0.07945808813764718,673,"Though, it's been shown to cause cancer in laboratory people."
592,485,4,22,42,68,1.4411764705882353,0.07372668882393525,673,What side effects?
1009,485,8,14,46,68,1.4411764705882353,0.08480301230521728,673,Stay away from Dr. Katz
968,496,7,19,49,75,1.44,0.07650001472060153,673,"Take this down to the maze lab, third floor."
4004,497,7,15,44,66,1.4393939393939394,0.083982426507805,673,Don’t worry Mr.Smith we’re experts at burrowing. Your colonoscopy is going to go just fine.
3012,497,8,13,45,66,1.4393939393939394,0.08671360001948561,673,I need you to sign this. I don't have thumbs.
3225,497,6,17,43,66,1.4393939393939394,0.08115939561097288,673,"If these don't stop the hallucinations, I'm going to recommend checking you into the maze."
3414,497,8,13,45,66,1.4393939393939394,0.08671360001948561,673,"They haven't run clinical trials on humans yet, but this worked wonders for my cousin"
3422,497,4,21,41,66,1.4393939393939394,0.07519605417531874,673,I know it works. I tested it myself.
3432,497,6,17,43,66,1.4393939393939394,0.08115939561097288,673,This prescription should ease your fears about nose hair.
3501,497,9,11,46,66,1.4393939393939394,0.08936133892539773,673,Call me if you have an erection lasting longer than 4 hours or start craving cheese.
3752,497,8,13,45,66,1.4393939393939394,0.08671360001948561,673,"This to the pharmacy. Just take the first left, the third right, the fourth left, two rights, and a left."
3745,497,9,11,46,66,1.4393939393939394,0.08936133892539773,673,Get this filled at the dumpster behind Wu's Palace.
2953,497,6,17,43,66,1.4393939393939394,0.08115939561097288,673,Johns Hopkins. Where did you get your degree?
4023,497,6,17,43,66,1.4393939393939394,0.08115939561097288,673,"This is necessary after a radioactive rat bite.  Trust me, I learned the hard way."
4243,497,6,17,43,66,1.4393939393939394,0.08115939561097288,673,"Well, it worked for me!"
4266,497,6,17,43,66,1.4393939393939394,0.08115939561097288,673,Focus on my degrees not my whiskers.
4461,497,9,11,46,66,1.4393939393939394,0.08936133892539773,673,What makes you think I’m working for the pharma companies?
3609,497,5,19,42,66,1.4393939393939394,0.07823456416276592,673,Don’t flush any extra pills down the toilet or you’ll poison my Aunt Nettie.
2907,497,3,23,40,66,1.4393939393939394,0.0720294807515437,673,"There are no side effects. And, Bob, all the ladies love a little hair on the snout."
3547,497,3,23,40,66,1.4393939393939394,0.0720294807515437,673,"For your headache, take this. It literally changed my life."
2642,497,5,19,42,66,1.4393939393939394,0.07823456416276592,673,And I'm going to refer you to someone who hasn't just eaten out of a dumpster.
101,497,6,17,43,66,1.4393939393939394,0.08115939561097288,673,I’d like to see a chicken write this legibly.
154,497,4,21,41,66,1.4393939393939394,0.07519605417531874,673,My brother was on an early trial for this one and saw results immediately.
738,497,4,21,41,66,1.4393939393939394,0.07519605417531874,673,"Side effects? Relax, I’ve been taking this stuff for years."
2806,497,8,13,45,66,1.4393939393939394,0.08671360001948561,673,"That's right, Peterson! I know all about that box of warfarin in your garage. My how the tables have turned, eh?"
901,497,6,17,43,66,1.4393939393939394,0.08115939561097288,673,Just a little something to help you cope with the rat race.
993,497,7,15,44,66,1.4393939393939394,0.083982426507805,673,"Of course, in the old days, they would just cut off your tail with a carving knife."
847,497,6,17,43,66,1.4393939393939394,0.08115939561097288,673,Perhaps the generic version of these wasn't fully effective...
1252,497,5,19,42,66,1.4393939393939394,0.07823456416276592,673,"Even though Dr. Campbell's tricks were flawless, Tom smelled a rat."
1928,497,7,15,44,66,1.4393939393939394,0.083982426507805,673,"Take two a day, and in no time you'll be feeling bright-eyed and bushy-tailed."
2262,497,7,15,44,66,1.4393939393939394,0.083982426507805,673,The side effects are mild. I’ve taken it myself.
2274,497,5,19,42,66,1.4393939393939394,0.07823456416276592,673,"I advise you take these with two or three pellets, and call me in the morning."
2389,497,7,15,44,66,1.4393939393939394,0.083982426507805,673,No need to worry.  I was on the team who did safety testing.
1016,497,3,23,40,66,1.4393939393939394,0.0720294807515437,673,"It's an off-label usage, but it worked for me"
1161,528,8,20,54,82,1.4390243902439024,0.0738202627201964,673,This helped me get through the maze 50% faster.
3208,529,6,13,38,57,1.4385964912280702,0.09031254509637719,673,Take two pills every two hours until fully addicted.
455,530,5,22,46,73,1.4383561643835616,0.07295226168342675,673,I’ll do the procedure on Friday. You’ll love your new face Mr. Daniels.
3828,531,7,14,43,64,1.4375,0.0858980338670346,673,I'm sorry if the subject of rat erections makes you uncomfortable. But how do you think these drugs were approved?
3313,531,1,26,37,64,1.4375,0.06634969288573796,673,"If this doesn’t work, I’m sending you for a Cat scan."
2871,531,5,18,41,64,1.4375,0.07991500941724733,673,"What, you've never seen a lab rat before?"
2645,531,6,16,42,64,1.4375,0.08296047538551402,673,Don’t worry. It was tested on me.
61,531,3,22,39,64,1.4375,0.07344620642412539,673,"Don't worry, I use this myself."
350,531,4,20,40,64,1.4375,0.07674879141802159,673,Here. And please stop calling me Dr. Ben.
2121,531,6,16,42,64,1.4375,0.08296047538551402,673,Just ask for the guy in the sheep’s clothing.
1703,531,6,16,42,64,1.4375,0.08296047538551402,673,Here is a prescription for plague vaccine.  Somehow all my patients take it.
232,539,3,21,38,62,1.435483870967742,0.07494389843197136,673,"My friends in the lab swear by it."""
3325,539,4,19,39,62,1.435483870967742,0.07839265681142747,673,"It isn't as potent, but you'll find the side effects a lot less disturbing."
3243,541,4,22,43,69,1.434782608695652,0.07293114408336317,673,"Trust me, I trained in some of the top mazes in the country."
889,541,6,18,45,69,1.434782608695652,0.07855868313763514,673,Safe?!?” Absolutely ... I took it and it’s done miracles for me
2164,541,4,22,43,69,1.434782608695652,0.07293114408336317,673,There is no reason to worry about this prescription. I take it myself.
622,541,4,22,43,69,1.434782608695652,0.07293114408336317,673,"Honest, it’s not species specific."
265,545,6,17,44,67,1.4328358208955223,0.08020744417363072,673,From Baltimore since you ask.
1635,545,4,21,42,67,1.4328358208955223,0.07435500004787114,673,Cigarette?
3517,545,6,17,44,67,1.4328358208955223,0.08020744417363072,673,Yes sir. I am a doctor. And a rat.
4234,545,7,15,45,67,1.4328358208955223,0.08297902226008497,673,"Yes, quite right, I might indeed be a six foot lab rat.  Or perhaps you really ought to take this prescription."
3561,549,6,16,43,65,1.4307692307692308,0.0819510605871635,673,"Trust me, I can help. I've been in the gutter too."
3175,549,4,20,41,65,1.4307692307692308,0.07585801124352314,673,"Take this, avoid mazes. and eat lots of cheese."
3298,549,4,20,41,65,1.4307692307692308,0.07585801124352314,673,"I know what I’m talking about, I literally grew up in a lab."
3572,549,6,16,43,65,1.4307692307692308,0.0819510605871635,673,Sure it will work.   They tried it on me first.
4172,549,5,18,42,65,1.4307692307692308,0.07896332756787616,673,Grind them up and mix into your food.
3923,549,6,16,43,65,1.4307692307692308,0.0819510605871635,673,"Sorry, only Velveeta is covered by your insurance."
3991,549,5,18,42,65,1.4307692307692308,0.07896332756787616,673,Relax... I clinically tested these myself.
4038,549,3,22,40,65,1.4307692307692308,0.07262002918653539,673,"Don't worry, I've tested all prescriptions myself."
3114,549,5,18,42,65,1.4307692307692308,0.07896332756787616,673,Take my word: the clinical trials went fabulously well.
4447,549,7,14,44,65,1.4307692307692308,0.08483363461581836,673,My father wanted me to follow his career path in the lab but I find clinical work so much more rewarding
3665,549,6,16,43,65,1.4307692307692308,0.0819510605871635,673,"I guarantee it will double in size.
I was in the original study."
2912,549,6,16,43,65,1.4307692307692308,0.0819510605871635,673,Of course any human doctor would be out of network.
3669,549,6,16,43,65,1.4307692307692308,0.0819510605871635,673,Don’t be alarmed if you develop a sudden craving for cheese.
2211,549,7,14,44,65,1.4307692307692308,0.08483363461581836,673,Here’s a referral to a cartoonist who can fix your eyeball.
86,549,4,20,41,65,1.4307692307692308,0.07585801124352314,673,Run two mazes and call me in the morning.
221,549,5,18,42,65,1.4307692307692308,0.07896332756787616,673,We've corrected the LASIK machine calibration issue. These drops should help.
2529,549,4,20,41,65,1.4307692307692308,0.07585801124352314,673,"It may be new on the market, but based on the animal trials, I assure you it does wonders."
693,549,4,20,41,65,1.4307692307692308,0.07585801124352314,673,I've taken this prescription myself.
1782,549,5,18,42,65,1.4307692307692308,0.07896332756787616,673,"Look, see you in TWO WEEKS: Gotta get back to the race."
812,549,7,14,44,65,1.4307692307692308,0.08483363461581836,673,Take my card and call me if you get enough cheese to get your eye fixed
872,549,4,20,41,65,1.4307692307692308,0.07585801124352314,673,“This should help with those hallucinations you’ve been having.”
1548,549,5,18,42,65,1.4307692307692308,0.07896332756787616,673,Ask my secretary to show you out. This place is a maze.
731,549,7,14,44,65,1.4307692307692308,0.08483363461581836,673,"I recommend 12 ounces of gouda, smoked."
318,572,6,19,47,72,1.4305555555555556,0.07616181215688536,673,"You're not eating enough garbage."""
4026,573,4,19,40,63,1.4285714285714286,0.07744738965256852,673,"Nibble on this tonight, and call me in the morning."
2273,573,5,17,41,63,1.4285714285714286,0.0806853824065677,673,I don't like taking pills either but this one worked for me too
3921,573,2,23,38,63,1.4285714285714286,0.0705268220168909,673,We are bound by doctor-patient confidentiality. What do I look like?
3879,573,5,17,41,63,1.4285714285714286,0.0806853824065677,673,I'm referring you out for a CAT scan.  Just kidding.  Here's a script for some oxycodone.
3663,573,4,19,40,63,1.4285714285714286,0.07744738965256852,673,Hey. Grab me a cheese danish when you go by the lab.
3573,573,4,19,40,63,1.4285714285714286,0.07744738965256852,673,"As prescribed, your exercise wheel pass."
3357,573,5,17,41,63,1.4285714285714286,0.0806853824065677,673,That's a common misconception. It's actually YOU who carries the plague
2902,573,6,15,42,63,1.4285714285714286,0.08379835144077329,673,Side effects may include strong cheese cravings.
2886,573,3,21,39,63,1.4285714285714286,0.07406797819503036,673,These pills should help you see people as they really are.
2329,573,6,15,42,63,1.4285714285714286,0.08379835144077329,673,You'll find this is particularly effective with managing hallucinations.
2025,573,5,17,41,63,1.4285714285714286,0.0806853824065677,673,"Don’t worry it’s completely safe, we tested it on mice."
4070,573,4,19,40,63,1.4285714285714286,0.07744738965256852,673,Take this to allow you to cope with the bill
1146,573,6,18,46,70,1.4285714285714286,0.07767700969373158,673,"I'm going to send you to the lab.  Head out this door, then take a right, then a left, another left, left, straight, right, left, right, right, left, then a right."
1748,573,3,21,39,63,1.4285714285714286,0.07406797819503036,673,"Yes, there may be unwanted side-effects."
256,573,3,21,39,63,1.4285714285714286,0.07406797819503036,673,Trust me. I've tested it myself.
406,573,5,17,41,63,1.4285714285714286,0.0806853824065677,673,"It hasn't been tested on humans yet, but I can vouch for it."
524,573,4,19,40,63,1.4285714285714286,0.07744738965256852,673,"If you don't like the tablet's taste, put it in a piece of cheese."
26,573,5,14,37,56,1.4285714285714286,0.08774647237199411,673,You look like you've never seen a prescription before.
1007,573,3,21,39,63,1.4285714285714286,0.07406797819503036,673,Try this prescription. Your hallucinations and the other side effects should clear up in about a week.
1099,573,9,9,45,63,1.4285714285714286,0.09251087511467616,673,"If you can't afford human healthcare, don't complain about getting the rat medication."
1131,573,1,25,37,63,1.4285714285714286,0.06679820247360642,673,Your Drug Plan only allows for generic Cheddar. I can’t specify Wisconsin or Vermont.
919,573,3,21,39,63,1.4285714285714286,0.07406797819503036,673,Here's my card. I think you'll do better to call me at the new moon.
2138,595,7,18,50,75,1.4266666666666667,0.07634283350929691,673,"Unfortunately, sir, blocks of cheddar are out-of-network."
3264,596,4,21,43,68,1.4264705882352942,0.07352941176470587,673,"I studied at Johns Hopkins in Baltimore, why do you ask?"
2831,597,5,16,40,61,1.4262295081967213,0.0825118517515929,673,"no worries, I used to be a veterinarian"
446,597,3,20,38,61,1.4262295081967213,0.07559966603506563,673,'Take two of these and enter the Caption Contest in the morning'.
3976,597,4,18,39,61,1.4262295081967213,0.07913126810588308,673,My real dream was to play the rat king in The Nutcracker
3768,597,5,16,40,61,1.4262295081967213,0.0825118517515929,673,"Take two a day until the nose grows in. The hair, whiskers, and ears will follow."
2808,597,7,12,42,61,1.4262295081967213,0.0888881423719735,673,"Don't worry,it's vegan."
4233,597,6,14,41,61,1.4262295081967213,0.08575927802231394,673,You’re telling me healthcare is more . . . human in Canada?
2127,597,5,16,40,61,1.4262295081967213,0.0825118517515929,673,"Bring this up to the receptionist. You'll go down the hall and take a right, then another right, then a left, then a right again..."
1571,597,6,14,41,61,1.4262295081967213,0.08575927802231394,673,Perhaps some meds with less intense side effects might help.
900,597,5,16,40,61,1.4262295081967213,0.0825118517515929,673,There are barely any side effects.
390,597,7,12,42,61,1.4262295081967213,0.0888881423719735,673,Warfarin is proven to work.
2608,597,5,16,40,61,1.4262295081967213,0.0825118517515929,673,"I'm a Republican from Baltimore, why?"
3889,608,4,23,46,73,1.4246575342465753,0.07011028553782689,673,Rest assured these pills have minimal side effects.
224,609,6,16,44,66,1.4242424242424243,0.08096333182691809,673,"Feel free to get a second opinion, but when I diagnose you with the black plague, I kinda know what I'm talking about."
1123,609,6,16,44,66,1.4242424242424243,0.08096333182691809,673,"After taking these, you may see some changes in your appearance.  But don't worry, it's temporary."
4002,609,6,16,44,66,1.4242424242424243,0.08096333182691809,673,It’s a prescription for a sleep aid and some Swiss cheese for me
4016,612,5,15,39,59,1.423728813559322,0.08445303035973557,673,"I can tell you're not sure about having a mouse as a doctor, but rest assured; I graduated top of my class at Harvarti University."
107,613,4,19,41,64,1.421875,0.07652123726119518,673,I'd lay off the hallucinogens.
1969,613,5,17,42,64,1.421875,0.07969649614641708,673,No-- never been to Baltimore. Why?
1468,613,6,15,43,64,1.421875,0.08275000449575588,673,What do you mean secondary effects?
125,613,7,13,44,64,1.421875,0.08569477807941021,673,"All right, here's a new prescription for you until the hallucinations stop."
438,613,4,19,41,64,1.421875,0.07652123726119518,673,"Don’t worry, I’ve been taking these for years with no side effects at all."
3907,618,4,16,37,57,1.4210526315789473,0.0828206097336256,673,"This will take care of your protruding eyes like I had.  
There are side effects though."
1679,618,6,12,39,57,1.4210526315789473,0.09006878609557097,673,I'm referring you to my colleague Dr. Doolittle.
3550,618,4,16,37,57,1.4210526315789473,0.0828206097336256,673,"Don't worry. If it was brain cancer, you would 
already have hallucinations."
3918,618,5,14,38,57,1.4210526315789473,0.0865206322947863,673,Why the doubtful look? I’ll have you know I’m considered a giant in my field.
4486,622,5,16,41,62,1.4193548387096775,0.08146070968255369,673,"I'd email this prescription to you, but my mouse is broken."
4211,622,3,20,39,62,1.4193548387096775,0.07468738690327893,673,"This prescription will do the trick, it was tested on three of my cousins."
1989,622,4,18,40,62,1.4193548387096775,0.07814746631985382,673,I'm not allowed in the drug store to pick up my own prescriptions... do you mind?
4161,622,6,14,42,62,1.4193548387096775,0.08464436160641713,673,You've just got to ask yourself: Are you a mouse or are you a man?
3942,622,6,14,42,62,1.4193548387096775,0.08464436160641713,673,"This will remove your inhibitions for the rate race. Side effects may include loss of meaning, loneliness, more envy, and feeling like a rat."
3864,622,6,14,42,62,1.4193548387096775,0.08464436160641713,673,This prescription should  exterminate the condition.
3811,622,5,16,41,62,1.4193548387096775,0.08146070968255369,673,"If the pills taste bitter, try hiding them in cheese."
3359,622,4,18,40,62,1.4193548387096775,0.07814746631985382,673,Now don't be giving me that physician assistant is not a doctor look.
1984,622,2,22,38,62,1.4193548387096775,0.07105902499097123,673,Try medical parmigiana - works for me.
2456,622,5,16,41,62,1.4193548387096775,0.08146070968255369,673,Take these and scurry through the park every day.
1730,622,7,12,43,62,1.4193548387096775,0.08771253434675405,673,"Why so leery?  Is it because I'm ""just"" a physician's assistant?"
1795,622,4,18,40,62,1.4193548387096775,0.07814746631985382,673,You look terrible.  Get this filled right away!!
1481,622,6,14,42,62,1.4193548387096775,0.08464436160641713,673,Don’t give me that look. I lost three cousins to be able to give this to you.
1346,622,5,16,41,62,1.4193548387096775,0.08146070968255369,673,And here's something special for your cat.
1301,622,7,12,43,62,1.4193548387096775,0.08771253434675405,673,This should help pop your eye back in.
1070,622,4,18,40,62,1.4193548387096775,0.07814746631985382,673,Yes. It’s been clinically tested. I took it myself.
614,622,5,16,41,62,1.4193548387096775,0.08146070968255369,673,The side effects are not as bad as they look.
327,622,5,16,41,62,1.4193548387096775,0.08146070968255369,673,Cheer up. You may only have one year. That’s my entire lifespan.
212,622,4,18,40,62,1.4193548387096775,0.07814746631985382,673,You should probably get a rabies shot.
1262,641,3,17,35,55,1.4181818181818182,0.08078282433588768,673,Side effects?
2016,642,4,17,39,60,1.4166666666666667,0.07987160129252457,673,Will this cure your hallucinations? Yes. Will this remove the sight of all those rat-bastards in government? No.
2022,642,3,14,31,48,1.4166666666666667,0.08849276392530342,673,You've got 2 hours. Valet is at the center of the hedge maze.
2464,642,3,19,38,60,1.4166666666666667,0.07625287497281387,673,"Trust me, I was a hardcore lab rat in medical school."
2606,642,4,17,39,60,1.4166666666666667,0.07987160129252457,673,"Oh, it's very safe.  I personally know many of those involved in the early trials."
2963,642,3,19,38,60,1.4166666666666667,0.07625287497281387,673,I don't know why so many of my patients are on anxiety meds.
4276,642,5,15,40,60,1.4166666666666667,0.08333333333333333,673,"I'm not an ANIMAL doctor, I'm an animal DOCTOR."
3187,642,3,19,38,60,1.4166666666666667,0.07625287497281387,673,"OK, we better lower your dosage."
3356,642,4,17,39,60,1.4166666666666667,0.07987160129252457,673,I'm referring you to a veterinarian
3853,642,5,15,40,60,1.4166666666666667,0.08333333333333333,673,For best results use it during the full moon.
1658,642,8,9,43,60,1.4166666666666667,0.09294815597246527,673,I graduated top of my animal trials.
4450,642,5,15,40,60,1.4166666666666667,0.08333333333333333,673,Not sure whether this will be covered — health insurance is such a maze.
3132,642,7,11,42,60,1.4166666666666667,0.0898575981610309,673,"Look Harry, get over it.  The whole grandma thing was long ago.  I've changed and moved on."
1543,642,1,23,36,60,1.4166666666666667,0.06844382688595609,673,"""All my lab buddies said it works."""
4476,642,6,13,41,60,1.4166666666666667,0.0866568877577361,673,Take one of these twice a day. The hallucinations should stop in about a week.
1396,642,6,13,41,60,1.4166666666666667,0.0866568877577361,673,"I'm a lab rat … Trust me ,this stuff works."
30,642,5,15,40,60,1.4166666666666667,0.08333333333333333,673,You can always get a human opinion.
32,642,5,15,40,60,1.4166666666666667,0.08333333333333333,673,"Yes, but now I run the Lab instead."
551,642,2,21,37,60,1.4166666666666667,0.07245363476187482,673,I can tell you from personal experience: this drug works.
571,642,2,21,37,60,1.4166666666666667,0.07245363476187482,673,You need to eat more cheese.
443,642,3,19,38,60,1.4166666666666667,0.07625287497281387,673,"If they can't read my handwriting, tell them your doctor is a rat. They'll know what that means."
849,642,2,21,37,60,1.4166666666666667,0.07245363476187482,673,"I know this looks like chicken scratch. Thankfully, our pharmacist is an actual chicken."
997,642,4,17,39,60,1.4166666666666667,0.07987160129252457,673,"There's nothing wrong with you sir, you just licked the wrong stamps."
1246,642,7,11,42,60,1.4166666666666667,0.0898575981610309,673,"You smell a rat, eh? Well, I smell a man who needs a prescription for man up!"
604,642,2,21,37,60,1.4166666666666667,0.07245363476187482,673,This should do the trick. Don't listen to what Dr. Katz says.
2693,666,6,15,44,65,1.4153846153846155,0.08172511292644531,673,You're gonna want to take this with a block of cheese.
4007,666,4,19,42,65,1.4153846153846155,0.0756138586589904,673,"Believe me, it works. I tested it on myself."
4094,666,4,19,42,65,1.4153846153846155,0.0756138586589904,673,I'm the only doctor available in your plan. Let me check you for fleas
2830,669,4,16,38,58,1.4137931034482758,0.08170329348401274,673,Don't worry. I tested this drug personally.
2418,669,4,16,38,58,1.4137931034482758,0.08170329348401274,673,You'll need to squeak to the pharmacist about treatment for your head mice.
2435,669,5,14,39,58,1.4137931034482758,0.08532519465955339,673,Just stick to cheese
2487,669,5,14,39,58,1.4137931034482758,0.08532519465955339,673,"Here’s a Alergy  prescription, but I strongly recommend you get rid of your cat."
2974,669,4,16,38,58,1.4137931034482758,0.08170329348401274,673,"Take two of these daily.
And, from now on, stay our of Baltimore."
3307,669,1,22,35,58,1.4137931034482758,0.06971761709544326,673,This should help with your underdeveloped nostril hair.
3281,669,6,12,40,58,1.4137931034482758,0.0887994905460985,673,"No, generic cheese is fine."
2330,669,4,16,38,58,1.4137931034482758,0.08170329348401274,673,"As you can see sir, I was born in this infested place!"
3518,669,7,10,41,58,1.4137931034482758,0.09214287926260278,673,I know this prescription will cure your craving.  I used to have a thing about cheese.
4181,669,5,14,39,58,1.4137931034482758,0.08532519465955339,673,"Yes, many other rodents are involved in the medical field, but they tend to work in the labs."
3137,669,4,16,38,58,1.4137931034482758,0.08170329348401274,673,Take it.  It's a free sample.
2302,669,4,16,38,58,1.4137931034482758,0.08170329348401274,673,This medication was found effective in hundreds of my siblings.
2184,669,6,12,40,58,1.4137931034482758,0.0887994905460985,673,I guarantee it's safe and effective. It was tested on my own family.
10,669,6,12,40,58,1.4137931034482758,0.0887994905460985,673,The rabies vaccine is on me.
2066,669,6,12,40,58,1.4137931034482758,0.0887994905460985,673,"Look, they tested this on my whole family."
2011,669,4,16,38,58,1.4137931034482758,0.08170329348401274,673,Take two of these every morning with a slice of cheese.
1963,669,3,18,37,58,1.4137931034482758,0.07791320484089177,673,I'm referring you to a wolf in sheep's clothing. She may be able to help you.
1607,669,8,8,42,58,1.4137931034482758,0.09536912957744006,673,This medicine was successfully tested on my 60 children.
1519,669,5,14,39,58,1.4137931034482758,0.08532519465955339,673,"It's no cheese, but it does help with the withdrawal symptoms."
436,669,6,12,40,58,1.4137931034482758,0.0887994905460985,673,"Alright, I'm writing a prescription for 80mg Oxycontins. Those are the good ones. If you find that they're too strong for your shoulder pain, just, I don't know, cut 'em in half with a credit card. Or sell them to your kid or his friends or whatever."
425,669,3,18,37,58,1.4137931034482758,0.07791320484089177,673,You're lucky to still be covered.
2228,669,4,16,38,58,1.4137931034482758,0.08170329348401274,673,At least you don't have to wear a cone.
4498,691,4,18,41,63,1.4126984126984128,0.07718458811550716,673,"I am not going to lie to you, there are some side effects"
4406,691,2,22,39,63,1.4126984126984128,0.07023813139859228,673,If this doesn't kill you it will make you stronger.
3543,691,2,22,39,63,1.4126984126984128,0.07023813139859228,673,"Two ounces of cheddar administered orally twice a day with meals 
for two weeks."
2295,691,6,14,43,63,1.4126984126984128,0.08355552754159991,673,I'm giving you this prescription for nose hair.  I'm an expert.
1472,695,5,13,38,56,1.4107142857142858,0.08744863321307475,673,I'm worried about the weight gain. Do you have a maze membership?
3888,695,6,11,39,56,1.4107142857142858,0.09108575135654055,673,I am sorry. Animal scientists don’t study these things.
2519,695,3,17,36,56,1.4107142857142858,0.0796778648818703,673,I was in the clinical trial.  It's done wonders for me.
2221,698,5,15,41,61,1.4098360655737705,0.08223998329667984,673,You look surprised!
2531,698,7,11,43,61,1.4098360655737705,0.08863583376660687,673,"We're still great at testing, but we're also moving up into the higher paying pharmaceutical jobs."
4413,698,5,15,41,61,1.4098360655737705,0.08223998329667984,673,Sure it worked I tested it myself.
4258,698,4,17,40,61,1.4098360655737705,0.07884774419859128,673,"Try this. It did wonders for me."""
1974,698,4,17,40,61,1.4098360655737705,0.07884774419859128,673,We have high hopes the results will be duplicated in humans.
2589,698,4,17,40,61,1.4098360655737705,0.07884774419859128,673,No humans were harmed in testing this new drug.
1711,698,3,19,39,61,1.4098360655737705,0.07530284641216951,673,They're harmless! Look at me!
236,698,4,17,40,61,1.4098360655737705,0.07884774419859128,673,"Don't worry, 'rodenticide' is just the generic name."
984,698,5,15,41,61,1.4098360655737705,0.08223998329667984,673,Big Pharma? Who dat?
1097,698,4,17,40,61,1.4098360655737705,0.07884774419859128,673,"Mr. Jones, just take these twice a day for three weeks, and I promise you that you will no longer be seeing animals dressed-up in suits."
384,708,4,19,43,66,1.4090909090909092,0.07472489631484729,673,Here's the key to the bathroom. It's just at the end of the maze.
1719,708,4,19,43,66,1.4090909090909092,0.07472489631484729,673,Gnaw on it twice a day. Trust me.
1101,710,5,12,37,54,1.4074074074074074,0.08971777520838767,673,Not addictive at all. I swear.
1528,711,5,14,40,59,1.4067796610169492,0.08415927979889802,673,"It's experimental, but it should do the trick. Worked on me."
3820,711,3,18,38,59,1.4067796610169492,0.07690173798023957,673,Call if you begin to hallucinate
2618,711,2,20,37,59,1.4067796610169492,0.07300290246584397,673,"Disregard Rodent Xpress, we’re Rodentia Medical Associates now."
565,711,4,16,39,59,1.4067796610169492,0.08061222512947594,673,I lab tested it myself.
952,711,3,18,38,59,1.4067796610169492,0.07690173798023957,673,"Hey, you've never seen anyone in a white coat before?"
1269,711,4,16,39,59,1.4067796610169492,0.08061222512947594,673,"I'm afraid you don't qualify for this study, but there's another lab rat down the street who might be able to use you."""
3474,717,2,22,40,64,1.40625,0.06943204254338217,673,Take this.  It should help with your hallucinations.
513,717,8,10,46,64,1.40625,0.08830061725682617,673,Why do you ask if I’m from Baltimore?
4252,719,4,20,45,69,1.4057971014492754,0.07246376811594202,673,Please take these two referrals.  One is for an opthamologist .  The other is for a  shrink.  Good luck!
118,719,4,20,45,69,1.4057971014492754,0.07246376811594202,673,"Look, I'm a real doctor. My credentials are on the wall. The one with two medals is for getting through Harvard's toughest maze, eh, course...I mean course."
88,721,5,11,36,52,1.4038461538461537,0.09214887040656643,673,I tested this one on myself.
752,721,4,13,35,52,1.4038461538461537,0.0879617331811671,673,Side effects? Not with Ratalin.
2255,721,3,15,34,52,1.4038461538461537,0.0835650566401022,673,"This should help. So you know, I'm a recovering cheese addict myself."
2569,721,2,17,33,52,1.4038461538461537,0.07892382959722714,673,Is there something you want to ask?
3437,725,4,15,38,57,1.4035087719298245,0.08248812902672853,673,"Take one of these twice a day with cheese, I mean meals."
2073,725,2,19,36,57,1.4035087719298245,0.07450609772528698,673,My cousin was in the drug trial and he says the side effects are minimal.
2150,725,6,11,40,57,1.4035087719298245,0.08976315648644723,673,You need a specialist. I'm referring you to a platypus.
2204,725,4,15,38,57,1.4035087719298245,0.08248812902672853,673,Take these and you too can be an anthropomorphic animal doctor.
2466,725,3,17,37,57,1.4035087719298245,0.078598505165748,673,It's a big pill.  You'll have to gnaw on it.
2628,725,3,17,37,57,1.4035087719298245,0.078598505165748,673,And on the back is one dollar off your next pizza
2649,725,5,13,39,57,1.4035087719298245,0.08620242366877114,673,This should help you. It worked for me.
2687,725,1,21,35,57,1.4035087719298245,0.07017543859649124,673,*I want you to try this new drug for boosting your brain power. I personally tested it.
2826,725,5,13,39,57,1.4035087719298245,0.08620242366877114,673,I'm going to have to refer you to a different unidentifiable animal.
2937,725,5,13,39,57,1.4035087719298245,0.08620242366877114,673,Don't worry!  It was tested on humans.
2891,725,3,17,37,57,1.4035087719298245,0.078598505165748,673,What? Never seen a doctor before?
3282,725,4,15,38,57,1.4035087719298245,0.08248812902672853,673,"You may crave cheese and burrowing, but otherwise there are no side effects."
3135,725,5,13,39,57,1.4035087719298245,0.08620242366877114,673,"The Rat Race is a marathon, not a sprint."
4314,725,2,19,36,57,1.4035087719298245,0.07450609772528698,673,"Well, it was safe enough to test it on me."
2070,725,2,19,36,57,1.4035087719298245,0.07450609772528698,673,"Here, this should help with some of your psychotic symptoms. But I really am a giant rat."
4164,725,5,13,39,57,1.4035087719298245,0.08620242366877114,673,"Yeah, I tried being wolf in sheep's clothing for awhile, but a wolf in pharmaceutical clothing is just so much more lucrative."
3805,725,4,15,38,57,1.4035087719298245,0.08248812902672853,673,"Yes, it will change your appearance but you'll be able to earn a whole lot of medical degrees in no time at all."
3248,725,3,17,37,57,1.4035087719298245,0.078598505165748,673,Don't leave these pills where the dog can get them
2836,725,3,17,37,57,1.4035087719298245,0.078598505165748,673,This prescription is sure to work. It's been tested on me personally.
2034,725,2,19,36,57,1.4035087719298245,0.07450609772528698,673,"Yes, in rare instances the prescription can have hallucinogenic side effects. Why do you ask?"
1240,725,3,17,37,57,1.4035087719298245,0.078598505165748,673,This will help with your mange... uh... rash.
1371,725,4,15,38,57,1.4035087719298245,0.08248812902672853,673,"It's perfectly safe, I've taken it myself for years."
1879,725,4,15,38,57,1.4035087719298245,0.08248812902672853,673,I don't see patients named Katz so here's a referral to Dr.  Jack Russell.
89,725,7,9,41,57,1.4035087719298245,0.09318793204299854,673,Here is your ID badge. welcome to the White House
163,725,5,13,39,57,1.4035087719298245,0.08620242366877114,673,Don't worry ... I've tried it myself and I highly recommend it.
432,725,2,19,36,57,1.4035087719298245,0.07450609772528698,673,"Trust me, med school was a maze."
508,725,4,15,38,57,1.4035087719298245,0.08248812902672853,673,Here's the number of a plastic surgeon.  He did wonders with my chin.
617,725,3,17,37,57,1.4035087719298245,0.078598505165748,673,Absolutely! Guaranteed not to have the side effects of the last one!
381,725,5,13,39,57,1.4035087719298245,0.08620242366877114,673,You'll need to take this 3 times a day until your hallucinations stop completely.
761,725,2,19,36,57,1.4035087719298245,0.07450609772528698,673,"There are side effects, but I find them quite tolerable."
934,725,5,13,39,57,1.4035087719298245,0.08620242366877114,673,"Here, this will fix you up, it's lab tested!"
989,725,4,15,38,57,1.4035087719298245,0.08248812902672853,673,Take two little red riding hoods and call me in the morning.
1034,725,4,15,38,57,1.4035087719298245,0.08248812902672853,673,It's either the experimental medication or back to the maze!
1158,725,5,13,39,57,1.4035087719298245,0.08620242366877114,673,Take one of these every morning.  They'll help with the hallucinations.
735,725,4,15,38,57,1.4035087719298245,0.08248812902672853,673,"I was in the test group for this new drug and, as you can see, there are no noticeable side effects at all."
518,760,4,19,44,67,1.4029850746268657,0.07385398055884286,673,"At one time yes, I was a lab rat, it was the beginning of my interest in the study of medicine."
2575,761,3,16,36,55,1.4,0.08040302522073697,673,"Facial reconstruction is my specialty"""
1950,761,3,16,36,55,1.4,0.08040302522073697,673,Not all of us are veterinarians.
2098,761,4,14,37,55,1.4,0.08448696430838984,673,You'll be fine. I took it and there were no side effects.
2364,761,5,14,41,60,1.4,0.08302201736426092,673,"Believe me, you don't want to take warfarin."
1920,761,4,14,37,55,1.4,0.08448696430838984,673,Now... what makes you think I would betray your trust.
4422,761,5,12,38,55,1.4,0.0883823953706156,673,They're perfectly safe--I take them myself.
2442,761,2,18,35,55,1.4,0.07610023515893885,673,"I don't like this medical coverage you have, they treat doctors like vermin."
2501,761,4,14,37,55,1.4,0.08448696430838984,673,"I do make house calls, provided you live in the subway."
2911,761,5,12,38,55,1.4,0.0883823953706156,673,You may experience a strong desire to frighten the hell out of people.
3771,761,5,14,41,60,1.4,0.08302201736426092,673,"I assure you, it passed all trials."
3479,761,2,18,35,55,1.4,0.07610023515893885,673,Trust me... I tried it myself!
3531,761,2,18,35,55,1.4,0.07610023515893885,673,It worked in the lab...
4282,761,4,14,37,55,1.4,0.08448696430838984,673,And remember to get that eyeball fixed.  You look weird.
4209,761,4,14,37,55,1.4,0.08448696430838984,673,"Listen, you look at me like that, but if I trim them I look a little too much like Hitler."
4134,761,3,16,36,55,1.4,0.08040302522073697,673,Here's your membership card.  Welcome to the Rat Race.
3679,761,1,20,34,55,1.4,0.07153911599848797,673,You’ll need to see a Snake for that.
3642,761,5,12,38,55,1.4,0.0883823953706156,673,Your medication does have side effects but I'm still a giant rat.
3532,761,4,14,37,55,1.4,0.08448696430838984,673,It’s call “TheBlack Plague.” It’s spread by humans
1857,761,4,14,37,55,1.4,0.08448696430838984,673,"I don't accept your insurance, but if you have any peanut butter..."
2969,761,3,16,36,55,1.4,0.08040302522073697,673,"Twice a day, with food, or anything else you find rummaging through the trash."
1747,761,4,14,37,55,1.4,0.08448696430838984,673,I've tested it personally.
1090,761,2,18,35,55,1.4,0.07610023515893885,673,The colonoscopy is for your protection. The CAT scan is for mine.
1579,761,3,16,36,55,1.4,0.08040302522073697,673,My diagnosis is severe bias. We rats were here first. Here's a bus pass back to wherever you came from.
1664,761,3,16,36,55,1.4,0.08040302522073697,673,You say rat infestation like it's a bad thing.
172,761,3,20,42,65,1.4,0.07205766921228919,673,Let's deal with the depression first.
201,761,3,18,39,60,1.4,0.07591252771714813,673,Don't worry. I tested it myself.
675,761,6,10,39,55,1.4,0.09211323729436767,673,These should take care of the hallucinations but I can't do anything about the lack of whiskers.
838,761,4,14,37,55,1.4,0.08448696430838984,673,"You might get cravings 
for discarded pizza .
This is quite normal."
930,761,3,16,36,55,1.4,0.08040302522073697,673,You seem anxious?
188,761,5,14,41,60,1.4,0.08302201736426092,673,This is for that gnawing feeling.
1091,761,3,16,36,55,1.4,0.08040302522073697,673,...and go easy on the cheese.
1398,761,6,14,45,65,1.4,0.08145314840210525,673,"That's DOCTOR Dirty Rat, sir."
1414,761,3,16,36,55,1.4,0.08040302522073697,673,You have the plague. Please find a different doctor the next time around.
1448,761,6,10,39,55,1.4,0.09211323729436767,673,"Look, there's a fifty-fifty chance I myself have taken these before, and I'm just fine."
1532,761,3,16,36,55,1.4,0.08040302522073697,673,"Not to worry, I take it too and the side effects are minimal."
1012,761,4,14,37,55,1.4,0.08448696430838984,673,"We provide exceptional care at Johns Hopkins. 
Here in Baltimore, a rat and rodent-infested place, we want to place that characterization in a positive light."
1861,797,4,17,42,63,1.3968253968253967,0.07686804028227165,673,"Here's my card.  If you have any more hallucinations, call me."
2878,797,4,17,42,63,1.3968253968253967,0.07686804028227165,673,"This should help with the pain, inflammation and giant rat hallucinations."
4089,799,4,15,39,58,1.396551724137931,0.08135146713693613,673,There are no side effects. I tested it myself.
4083,799,5,13,40,58,1.396551724137931,0.08498836322043128,673,Take one a day with garbage.
2978,799,7,9,42,58,1.396551724137931,0.09183105813394439,673,Take one 2X daily and avoid Baltimore or  any other infested places.
2067,799,5,13,40,58,1.396551724137931,0.08498836322043128,673,Take twice daily with garbage.
1966,799,6,11,41,58,1.396551724137931,0.08847588688701524,673,Give two of these to your cat and call me in the morning.
1495,799,4,15,39,58,1.396551724137931,0.08135146713693613,673,"I’m filling in while the cat’s away. This is fun! Anyway, take whatever this says."
1437,799,4,15,39,58,1.396551724137931,0.08135146713693613,673,I hear you have a rat problem. I can take care of that for you. Here's my card.
1208,799,3,17,38,58,1.396551724137931,0.07754418435818407,673,"I don't want to give you the runaround, but we're looking for subjects for a new study."
2401,799,5,13,40,58,1.396551724137931,0.08498836322043128,673,Nothing to be afraid of...just a few tests.
1175,799,3,17,38,58,1.396551724137931,0.07754418435818407,673,"This is experimental, but I haven’t dropped dead yet."
13,799,3,17,38,58,1.396551724137931,0.07754418435818407,673,I'm on this too. The side effects are temporary.
4132,799,4,15,39,58,1.396551724137931,0.08135146713693613,673,"Animals go to human doctors, so..."
3769,811,5,11,37,53,1.3962264150943395,0.0907140783280131,673,It's experimental.  But I tested it on myself.
4567,811,4,13,36,53,1.3962264150943395,0.08662190601670117,673,"Good luck finding the pharmacy, this office is a maze."
4075,811,2,17,34,53,1.3962264150943395,0.07779444576637096,673,"Take one of these a day with cheese, and a little time on the exercise wheel wouldn't hurt either."
3952,811,3,15,35,53,1.3962264150943395,0.08232657649284052,673,"Becoming a doctor was a good career move, since working in the lab was really a dead-end job."
3104,811,4,13,36,53,1.3962264150943395,0.08662190601670117,673,Welcome aboard! This card is good for cheese in any of our excellent mazes.
3061,811,2,17,34,53,1.3962264150943395,0.07779444576637096,673,It'll go down easier if you stick in a piece of cheese.
2457,811,4,13,36,53,1.3962264150943395,0.08662190601670117,673,You can fill it at any pharmacy in Baltimore
1991,811,2,17,34,53,1.3962264150943395,0.07779444576637096,673,"Trust me, 200 of my siblings and I tested this drug ourselves."
1839,811,4,13,36,53,1.3962264150943395,0.08662190601670117,673,I can both spread AND cure disease at the same time.
2338,811,6,9,38,53,1.3962264150943395,0.09462945319421213,673,I was a lab rat.  Then I met Tony Robbins.
535,811,3,15,35,53,1.3962264150943395,0.08232657649284052,673,"If your delusions don't disappear in a week, we'll try something else - at no extra cheese."
124,811,5,11,37,53,1.3962264150943395,0.0907140783280131,673,For the gnawing.
1229,811,3,15,35,53,1.3962264150943395,0.08232657649284052,673,It seems the rat-race is causing your stress.
4281,811,4,13,36,53,1.3962264150943395,0.08662190601670117,673,"It's not uncommon to see rats everywhere, especially in the city. But this should help."
1078,811,6,9,38,53,1.3962264150943395,0.09462945319421213,673,"No, Sir, I am not from Baltimore. Now take your prescription and leave!"
760,826,4,11,33,48,1.3958333333333333,0.09292137745269846,673,"We don't accept your insurance, but we will accept some cheese."
850,827,3,9,26,38,1.394736842105263,0.1035601932853589,673,"It hasn't been tested on humans yet, but what the heck?"
813,828,7,12,47,66,1.393939393939394,0.08328564009232776,673,I specialize in infested infections
3028,828,5,16,45,66,1.393939393939394,0.07748610787223617,673,Take one of these three times a day and stay OUT of sewers.
3788,830,5,14,42,61,1.3934426229508197,0.08191255007892127,673,Watch out for the traps on your way out.
3908,830,5,14,42,61,1.3934426229508197,0.08191255007892127,673,These have no side effects but don't wolf them down.
3452,832,4,14,38,56,1.3928571428571428,0.08327146745002247,673,"His office is in the sewer, but he's a good man."
3000,832,4,14,38,56,1.3928571428571428,0.08327146745002247,673,"I know, you thought 'ratified' meant something else."
2877,832,5,12,39,56,1.3928571428571428,0.08708322422045936,673,It’s highly recommended by the pharmaceutical rep.
3196,832,4,14,38,56,1.3928571428571428,0.08327146745002247,673,Three howls at the moon weekly. That'll fix you right up.
3770,832,3,16,37,56,1.3928571428571428,0.07927664625808474,673,I'm a fox. You can trust me.
2855,832,3,16,37,56,1.3928571428571428,0.07927664625808474,673,I don't give a rat's ass about google...just start taking this!
4119,832,3,16,37,56,1.3928571428571428,0.07927664625808474,673,If the hallucinations don't subside within two days call me.  Sara at the billing desk will take your cheese.
4342,832,2,18,36,56,1.3928571428571428,0.07506954104414687,673,"Don’t worry, I tested it on myself."
4368,832,5,12,39,56,1.3928571428571428,0.08708322422045936,673,You have nothing to worry about. My friends and I have been taking this drug for months.
4572,832,3,16,37,56,1.3928571428571428,0.07927664625808474,673,Side effects? I never noticed any.
4403,832,3,16,37,56,1.3928571428571428,0.07927664625808474,673,Trust me -- I'm cheeseboard-certified.
3979,832,1,20,35,56,1.3928571428571428,0.07061221808744009,673,What did you expect when you opted for an HMO?
2844,832,4,14,38,56,1.3928571428571428,0.08327146745002247,673,"I’ll be honest, you have some serious trust issues."
2977,832,4,14,38,56,1.3928571428571428,0.08327146745002247,673,"If you need me call me, no matter where you are, no matter how far underground."
1781,832,4,14,38,56,1.3928571428571428,0.08327146745002247,673,My brother was a test subject for this. He swears by it.
2652,832,2,18,36,56,1.3928571428571428,0.07506954104414687,673,I spent so much time in the lab that they gave me an honorary degree.
128,832,5,12,39,56,1.3928571428571428,0.08708322422045936,673,"I'm prescribing one ""Rat's Ass"" for you to give, at your own leisure."
354,832,5,12,39,56,1.3928571428571428,0.08708322422045936,673,I graduated from Ratcliffe.  Why do you ask?
673,832,5,12,39,56,1.3928571428571428,0.08708322422045936,673,You're going to need this rabies vaccine.
49,832,7,8,41,56,1.3928571428571428,0.09424536720355063,673,Frankly I don’t give a rat’s ass.
929,832,3,16,37,56,1.3928571428571428,0.07927664625808474,673,"I tested this medicine myself, back when I worked in the lab."
1059,832,4,14,38,56,1.3928571428571428,0.08327146745002247,673,"Don’t worry, it’s been proven to work in doctors."
1408,832,6,10,40,56,1.3928571428571428,0.09073499099014365,673,I go to med school. My brother picks up a slice of pizza. And he's the famous one.
1647,832,2,18,36,56,1.3928571428571428,0.07506954104414687,673,"Yes I starred in ""Ratatouille."" Then, I went to med school. Too competitive to be a chef in Paris."
923,832,2,18,36,56,1.3928571428571428,0.07506954104414687,673,"Don’t act so surprised, us rats know all about diseases."
805,857,7,13,49,69,1.391304347826087,0.08053897539510309,673,Here's your stipend for volunteering. We like to test new procedures on patients before we try them on mice.
1718,858,6,11,42,59,1.3898305084745763,0.08722271469866806,673,"Take this. Go through that door, turn right and then right again, then left and go to the end of that hall there's a round door and a square door. Don't go through the round door, go through the square one, SQUARE, got it? Ring the bell there and..."
2578,859,2,17,35,54,1.3888888888888888,0.07669203238507481,673,"Not to worry, its been extensively tested on cats."
2601,859,4,13,37,54,1.3888888888888888,0.08531876622693765,673,You should be able to get this filled at your local land-fill.
2792,859,2,17,35,54,1.3888888888888888,0.07669203238507481,673,This should really help with the hallucinations.
2898,859,5,11,38,54,1.3888888888888888,0.08932023225481209,673,We can have a co-worker show you around. It's a maze in here.
2981,859,2,17,35,54,1.3888888888888888,0.07669203238507481,673,"'I understand your confusion, but I wasn't using 'cheese' as a euphemism for money."
3333,859,3,15,36,54,1.3888888888888888,0.08112015687189036,673,This will put hair on your nose
4340,859,3,15,36,54,1.3888888888888888,0.08112015687189036,673,"I'm not really a rat, but I play one on television."
3800,859,3,15,36,54,1.3888888888888888,0.08112015687189036,673,I’m ethically obligated to tell you that this drug can cause excessive nose whiskers.
3871,859,3,15,36,54,1.3888888888888888,0.08112015687189036,673,I find cheddar works best for this but if it doesn’t  we could always try provolone.
4267,859,2,17,35,54,1.3888888888888888,0.07669203238507481,673,"You know, running is good for you.  Another patient was just scratched from the fifth race, so tell them I sent you."
4308,859,4,13,37,54,1.3888888888888888,0.08531876622693765,673,I absolutely agree that you need major work on your chinny-chin-chin.
2091,859,4,13,37,54,1.3888888888888888,0.08531876622693765,673,"I'm a MD and, prior to medical school, I was a Rhode-ents Scholar."
4398,859,1,19,34,54,1.3888888888888888,0.07199205381003258,673,"It’s for the sake of science, so it’s totally worth it."
4552,859,4,13,37,54,1.3888888888888888,0.08531876622693765,673,My late family took this.
3466,859,5,11,38,54,1.3888888888888888,0.08932023225481209,673,"No, Greg! I won't tell your wife you caught an STD. What would make you think I'd rat you out?"
2059,859,5,11,38,54,1.3888888888888888,0.08932023225481209,673,"The head researcher at the lab saw my potential and, long story short, here I am!"
3343,859,3,15,36,54,1.3888888888888888,0.08112015687189036,673,...and no maze running while you're taking these.
1827,859,4,13,37,54,1.3888888888888888,0.08531876622693765,673,Sorry human doctors aren't within your insurance network
1902,859,5,11,38,54,1.3888888888888888,0.08932023225481209,673,"Take two pills, twice a day with cheese."
65,859,3,15,36,54,1.3888888888888888,0.08112015687189036,673,I take this myself.  There is one side effect I should mention.
181,859,3,15,36,54,1.3888888888888888,0.08112015687189036,673,Yes it has been tested and no side effects noted. Why do you ask?
290,859,4,13,37,54,1.3888888888888888,0.08531876622693765,673,"I'm recommending against a chin implant, and suggesting a complete facial lift."
727,859,3,15,36,54,1.3888888888888888,0.08112015687189036,673,"Well, just exactly what kind of side effects have your been experiencing?"
1120,859,3,15,36,54,1.3888888888888888,0.08112015687189036,673,Take two of these and see if you can find your way throught the parking garage to your car.
967,859,1,19,34,54,1.3888888888888888,0.07199205381003258,673,Did I mention your medications hallucinogenic side effects?
1130,859,4,13,37,54,1.3888888888888888,0.08531876622693765,673,"I can assure you, those certificates are from the most prestigious laboratories."
1281,859,6,9,39,54,1.3888888888888888,0.09314996462490101,673,What side effects are you referring to?
1336,859,3,15,36,54,1.3888888888888888,0.08112015687189036,673,Take one pill with one piece of garbage every morning and again at night
1523,859,4,13,37,54,1.3888888888888888,0.08531876622693765,673,"We accept all forms of payment—Gorgonzola, cheddar, Muenster..."
1584,859,4,13,37,54,1.3888888888888888,0.08531876622693765,673,"We don't do plague cures anymore, 
here's a script for an expensive, crippling opioid addiction."
1717,859,5,11,38,54,1.3888888888888888,0.08932023225481209,673,This should cure what plagues you.
2290,890,2,15,32,49,1.3877551020408163,0.08152629125310805,673,"Take these, trust me!  I'm trained in the best Ivy League mazes."
3107,890,4,11,34,49,1.3877551020408163,0.09136310216709723,673,"You'll be fine.  After all, it's not rat poison."
3249,890,1,17,31,49,1.3877551020408163,0.07613275267210677,673,A word of advice-to get a job here you need a certain kind of moustache.  Take these and come back in two weeks.
2443,893,3,16,38,57,1.3859649122807018,0.07817781433825675,673,I'm confident in this prescription. I tested it on myself.
4575,893,3,16,38,57,1.3859649122807018,0.07817781433825675,673,"Don't tell anyone, but I'm recommending a CAT scan."
2433,893,4,14,39,57,1.3859649122807018,0.08208737461234245,673,"It'll work, but you don't want to know who they tested it on."
2690,893,6,10,41,57,1.3859649122807018,0.08939502168928225,673,"Trust me, I take the same medication myself.  Sure there are side effects but it'll do wonders for your sex life."
1865,893,2,18,37,57,1.3859649122807018,0.0740621646906627,673,"Take this to the big cheese."""
1048,893,3,16,38,57,1.3859649122807018,0.07817781433825675,673,"It was my brother's practice, but he had a run in with a girl in a red hood."
2210,893,3,16,38,57,1.3859649122807018,0.07817781433825675,673,I have to take this call; would you like some cheese?
2028,900,2,16,34,52,1.3846153846153846,0.07841686836534514,673,The worst side effect is that you're likely to feel more predatory.
2257,900,6,8,38,52,1.3846153846153846,0.09573816635027661,673,"I take this myself. There are some slight side effects , but nothing worth mentioning."
2324,900,3,14,35,52,1.3846153846153846,0.08308641921035718,673,"Don't worry,  I was personally involved in the medical trials."
2489,900,3,14,35,52,1.3846153846153846,0.08308641921035718,673,Chew this prescription three times a day
2550,900,3,14,35,52,1.3846153846153846,0.08308641921035718,673,"Just so you know, this medicine may have some transformative side effects. I know this from experience."
2593,900,4,12,36,52,1.3846153846153846,0.08750714753761862,673,"Here, this should clear up the infestation... er... the infection."
2602,900,3,14,35,52,1.3846153846153846,0.08308641921035718,673,Funny story about that.  My father was playing around with CRISPR when there was an escape from the rodent lab...
2654,900,3,14,35,52,1.3846153846153846,0.08308641921035718,673,Take this to a pharmacy in Baltimore. Tell them I sent you.
2908,900,4,12,36,52,1.3846153846153846,0.08750714753761862,673,"One day you're crawling up a sewer pipe, the next you're in medical school. New York, right? Here's your prescription for bubonic plague."
2949,900,3,14,35,52,1.3846153846153846,0.08308641921035718,673,"My great, great, great grandfather gave his life for this."
3017,900,4,12,36,52,1.3846153846153846,0.08750714753761862,673,"Well George, if you want a professional for your next lab experiment, here's my card."
3557,900,3,14,35,52,1.3846153846153846,0.08308641921035718,673,"My cousin Larry was involved in the preclinical trials, so I can personally assure you that it is safe for rats"
3595,900,2,16,34,52,1.3846153846153846,0.07841686836534514,673,Complications may include running in mazes.
3628,900,6,8,38,52,1.3846153846153846,0.09573816635027661,673,I smell anxiety and pesimism. This will make you hibernate until  election season is over.
3649,900,3,14,35,52,1.3846153846153846,0.08308641921035718,673,We would never experiment on humans to ensure it's safe for rats.
3860,900,2,16,34,52,1.3846153846153846,0.07841686836534514,673,"Trust me, the side effects are minimal--I take the stuff like every day."
3896,900,5,10,37,52,1.3846153846153846,0.09171504065932641,673,"Trust me, my whole family is in the business"
4131,900,3,14,35,52,1.3846153846153846,0.08308641921035718,673,"Take these twice a day with cheese,"
4226,900,3,14,35,52,1.3846153846153846,0.08308641921035718,673,Nibble one a night as you creep along the baseboard. I guarantee you’ll be transformed.
2009,900,4,12,36,52,1.3846153846153846,0.08750714753761862,673,This will ease your pain. But your intense cravings for cheese may skyrocket.
3134,900,4,12,36,52,1.3846153846153846,0.08750714753761862,673,"Three slices daily -- American, not Swiss"
1960,900,4,12,36,52,1.3846153846153846,0.08750714753761862,673,"No worries, I’ve researched and tested this medication myself."
1944,900,4,12,36,52,1.3846153846153846,0.08750714753761862,673,This one's for what you'll get because of my exam.
1728,900,4,12,36,52,1.3846153846153846,0.08750714753761862,673,"To get your bloodwork done, go down the hall, and through the maze."
87,900,3,14,35,52,1.3846153846153846,0.08308641921035718,673,Here. It's a cheese scented Medicare card. All of my patients love it.
259,900,4,12,36,52,1.3846153846153846,0.08750714753761862,673,Take two nibbles and call me in the morning.
447,900,4,12,36,52,1.3846153846153846,0.08750714753761862,673,"True, most of us are now immune to Warfarin, but it's still an effective blood thinner for my non-rodent patients."
667,900,2,16,34,52,1.3846153846153846,0.07841686836534514,673,"Oh, we may have to cut your brain in little slices to see if this really worked, but that's just standard practice."
672,900,5,10,37,52,1.3846153846153846,0.09171504065932641,673,I’ll see you back here for a follow up next Halloween.
724,900,4,12,36,52,1.3846153846153846,0.08750714753761862,673,I can assure you it was thoroughly tested. I was personally involved in the clinical trials.
725,900,6,8,38,52,1.3846153846153846,0.09573816635027661,673,Who's afraid of big bad pharma?
831,900,3,14,35,52,1.3846153846153846,0.08308641921035718,673,"I take this myself, and, so far, no apparent side effects."
1114,900,2,16,34,52,1.3846153846153846,0.07841686836534514,673,"So you're ratting me out, then?"
308,900,4,12,36,52,1.3846153846153846,0.08750714753761862,673,"Perhaps try taking your LSD micro-dose every other day, Mr. Kaplan."
1247,900,5,10,37,52,1.3846153846153846,0.09171504065932641,673,"We accept cash, credit or a nice gouda."
1363,900,2,16,34,52,1.3846153846153846,0.07841686836534514,673,"This may surprise you, but the cure is cheese."
1432,900,4,12,36,52,1.3846153846153846,0.08750714753761862,673,I'm obliged to tell you that this medication has only been tried out with humans.
1434,900,4,12,36,52,1.3846153846153846,0.08750714753761862,673,But it hasn't been tested yet on humans.
1441,900,4,12,36,52,1.3846153846153846,0.08750714753761862,673,"Try going to a vet, it’s what I always do"
1453,900,3,14,35,52,1.3846153846153846,0.08308641921035718,673,"This should start working in a few days... in the meantime, try not to be self-conscious about your appearance."
1540,900,1,18,33,52,1.3846153846153846,0.07345105466401777,673,"It's easy, run through a maze, ring a few bells, and earn some extra money."
1169,900,5,10,37,52,1.3846153846153846,0.09171504065932641,673,I normally don’t give a rats ass
1603,900,2,16,34,52,1.3846153846153846,0.07841686836534514,673,I think it's time for me to cut back on your CBD prescription.
1656,900,4,12,36,52,1.3846153846153846,0.08750714753761862,673,Don’t worry. I’m a board certified lab rat.
3491,944,4,13,38,55,1.3818181818181818,0.08405108712207968,673,"This will help with the hallucinations, but it might give you the plague."
3881,944,4,13,38,55,1.3818181818181818,0.08405108712207968,673,"Trust me, Bob."
501,944,4,13,38,55,1.3818181818181818,0.08405108712207968,673,Take this 3 times a day; I've tried it myself in multiple studies
2303,944,3,15,37,55,1.3818181818181818,0.07994488459559346,673,"The generic is cheaper, but genuine Gruyère is more effective."
1474,948,1,14,27,42,1.380952380952381,0.08314646378209262,673,This should help with your musophobia.
2296,948,3,18,42,63,1.380952380952381,0.07307373205693578,673,"I know this prescription will work, I tested it myself."
2424,948,6,12,45,63,1.380952380952381,0.08292085761146409,673,"I know you poisoned everyone I loved last year, but you can trust me."
4563,948,3,18,42,63,1.380952380952381,0.07307373205693578,673,"They tried all of them on me, believe me, this one is the best."
159,952,4,11,35,50,1.38,0.08985248682009364,673,It's for a mild Jarlsberg. We found the stronger Camembert  too habit forming.
340,952,3,13,34,50,1.38,0.08518886580500329,673,Don't worry. They tested it on my uncle.
4068,952,4,11,35,50,1.38,0.08985248682009364,673,"This will help, but nose hair is a side effect."
920,952,3,13,34,50,1.38,0.08518886580500329,673,I tested these myself.
1308,952,6,7,37,50,1.38,0.09851965514038095,673,Guess who's getting the placebo?
4564,952,3,13,34,50,1.38,0.08518886580500329,673,"And, worst of all - no more cheese."
3279,958,2,18,38,58,1.3793103448275863,0.07307764728634726,673,"While taking this, you should probably avoid driving, operating heavy machinery, and hunting."
3482,958,6,10,42,58,1.3793103448275863,0.08809191360806969,673,This medicine was tested on my entire family
2167,958,6,10,42,58,1.3793103448275863,0.08809191360806969,673,Take two of these and you're not even going to care if you ever get out of the maze.
1931,958,4,14,40,58,1.3793103448275863,0.08093370057040328,673,"Gary, you've gotta quit going for those cheese platters."
1056,958,2,18,38,58,1.3793103448275863,0.07307764728634726,673,Some of us made it from the street to Johns Hopkins.
393,958,5,12,41,58,1.3793103448275863,0.08458856048884893,673,Qualifications? Do you have any idea the number of mazes I've had to run through to get here?
2617,964,2,16,35,53,1.3773584905660377,0.07726462498813448,673,I went to a more “underground” medical school.
3276,964,3,14,36,53,1.3773584905660377,0.08182610634444085,673,I was a lowly lab rat before I took the red pill.
3747,964,3,14,36,53,1.3773584905660377,0.08182610634444085,673,"It's the tail, isn't it?"
3660,967,4,10,34,48,1.375,0.09237316395165707,673,It's great to be an American!  Here even the  lowly rat can reach the highest professional levels.
3409,967,4,13,39,56,1.375,0.08281766860861414,673,This treatment did not test on lab animals.
4133,967,4,10,34,48,1.375,0.09237316395165707,673,I know the ad said mole doctor but you need a dermatologist”
3932,967,3,12,33,48,1.375,0.08744299054666807,673,Take one of these a day for 2 weeks and stay out of the subway.
3415,967,4,10,34,48,1.375,0.09237316395165707,673,"This is the last prescription I'm going to write for you, Peter. We saw Patricia's ""faux-fur"" coat when she dropped you off."
3369,967,3,12,33,48,1.375,0.08744299054666807,673,Call me if you feel any more symptoms of frail humanity
3253,967,1,16,31,48,1.375,0.07663698161041188,673,"It’s only a mild sedative which will help with the hallucinations. In the meantime, do you happen to have any cheese?"
2929,967,4,10,34,48,1.375,0.09237316395165707,673,Here is a prescription to help with the hallucinations
2673,967,4,10,34,48,1.375,0.09237316395165707,673,Just nibble each pill three times a day.
2334,967,4,13,39,56,1.375,0.08281766860861414,673,They tested this on me. After FDA approval the only way I could afford it was to become a doctor.
2065,967,2,14,32,48,1.375,0.08221770960717432,673,Here. this will thin out your blood.
2208,967,2,14,32,48,1.375,0.08221770960717432,673,Trust me—it’s perfectly safe. It’s been tested in rats.
1883,967,6,9,41,56,1.375,0.0903186997939382,673,Take two of these every morning for a week and call me if you remain human.
1464,967,1,16,31,48,1.375,0.07663698161041188,673,You may be in the placebo group.
1311,967,3,12,33,48,1.375,0.08744299054666807,673,The results are in: it works on humans so it's safe for the rats.
1138,967,3,12,33,48,1.375,0.08744299054666807,673,This should cure what’s plaguing you.
867,967,2,14,32,48,1.375,0.08221770960717432,673,"Seriously, this guy’s my go-to guy."
828,967,3,12,33,48,1.375,0.08744299054666807,673,Try this prescription. It worked for me.
648,967,4,10,34,48,1.375,0.09237316395165707,673,"I know the rat race can be brutal, but I want you to keep trying to find the end of the maze. If I can do it, so can you."
585,967,4,10,34,48,1.375,0.09237316395165707,673,It's called exophthalmos but almost everyone in this cartoonist's world has it.
1959,967,3,12,33,48,1.375,0.08744299054666807,673,You have nothing to worry about Mr. Paker. I personally tested this medication on some of my closest friends.
435,967,3,12,33,48,1.375,0.08744299054666807,673,"Yes, our experiments with gene splicing rats and humans is going very well, thank you.  Why do you ask?"
396,967,2,14,32,48,1.375,0.08221770960717432,673,The pills you're taking have no known side effects. Why do you ask?
3836,990,4,17,46,67,1.373134328358209,0.07316524328361153,673,I wouldn’t worry.  Medicare-for-all covers prescriptions for every mammal.
3113,991,1,17,33,51,1.3725490196078431,0.07388801443692852,673,The pharmacist can explain the side-effects.
3315,991,2,15,34,51,1.3725490196078431,0.07901741835141131,673,"Actually, trained rats require less malpractice insurance."
2884,991,3,13,35,51,1.3725490196078431,0.08383356206443902,673,"Here’s your prescription, Mr. Sackler."
4073,991,2,15,34,51,1.3725490196078431,0.07901741835141131,673,"Side effects include headache, rash, insomnia, diarrhea, impotence, development of rodent-like features, and full-body alopecia; but most are reversible."
4493,991,3,13,35,51,1.3725490196078431,0.08383356206443902,673,"Of course I write prescriptions. I'm a DOCTOR rat, not a lab rat."
3620,991,4,11,36,51,1.3725490196078431,0.08838766799674232,673,This should help you relax and stop thinking of life as a futile maze.
2546,991,4,11,36,51,1.3725490196078431,0.08838766799674232,673,"I've written it down for you:  left,right,left,left,right,left,Meds."
852,991,4,11,36,51,1.3725490196078431,0.08838766799674232,673,"No, you can’t weasel out of the colonoscopy."
2313,991,3,13,35,51,1.3725490196078431,0.08383356206443902,673,I participated in the clinical trial myself; there are no side-effects.
287,991,4,11,36,51,1.3725490196078431,0.08838766799674232,673,Your'll get the Vicoden when I get the cheese.
1092,991,3,13,35,51,1.3725490196078431,0.08383356206443902,673,"No, there's no side effects"
1157,991,5,9,37,51,1.3725490196078431,0.0927183562159756,673,"I survived the trials, and you might too."
2335,991,4,11,36,51,1.3725490196078431,0.08838766799674232,673,"Relax, Ron. They tested it on me first."
1420,991,2,15,34,51,1.3725490196078431,0.07901741835141131,673,"Sorry, your application was rejected.  We never use humans in our clinical trials."
2077,991,3,13,35,51,1.3725490196078431,0.08383356206443902,673,Tic Tac?
2082,991,5,9,37,51,1.3725490196078431,0.0927183562159756,673,Chew through these wires and call me in the morning.
1377,991,3,13,35,51,1.3725490196078431,0.08383356206443902,673,Here. My card says I'm qualified to be in charge of the trial study.
161,1008,5,10,39,54,1.3703703703703705,0.08884811550302607,673,Try this. I tested it myself.
405,1008,6,8,40,54,1.3703703703703705,0.09269735512950625,673,"Call me,we’re looking for lab people."
902,1008,3,14,37,54,1.3703703703703705,0.08060002226616063,673,Of course I don’t take kickbacks.  What do I look like?
2194,1008,3,14,37,54,1.3703703703703705,0.08060002226616063,673,"You say Warfarin,
I say Rat Poison, 
You say it saves you,
I say it slays you..."
3181,1008,4,12,38,54,1.3703703703703705,0.08482438098136835,673,"Take two now, you won’t see me in the morning."
940,1013,3,11,32,46,1.3695652173913044,0.08986675940827533,673,what'd you call me?
4099,1014,4,13,40,57,1.368421052631579,0.08161734079164801,673,It's a clear case of Rodentia.
3712,1015,2,14,33,49,1.3673469387755102,0.08088518333737492,673,You can get this prescription filled in the alley out back.
3239,1015,3,12,34,49,1.3673469387755102,0.08598112013445264,673,Someone with your condition shouldn't be looking at me like I'm the weirdo
3273,1015,3,12,34,49,1.3673469387755102,0.08598112013445264,673,To eradicate the problem take the whole bottle and have a relative call me in the morning.
3410,1015,2,14,33,49,1.3673469387755102,0.08088518333737492,673,"It’s a loyalty card, for not ratting me out."
3670,1015,6,6,37,49,1.3673469387755102,0.09971847084536767,673,"Yeah, I started out as a vector for plague and tick-borne disease. Turns out, there wasn't any money in it."
3775,1015,5,8,36,49,1.3673469387755102,0.0953594950263686,673,Who told you all moles can be cancerous?
4556,1015,4,10,35,49,1.3673469387755102,0.09079148173496013,673,"Actually, I used to be a rat lab myself."
3937,1015,2,14,33,49,1.3673469387755102,0.08088518333737492,673,"Speaking from experience, there’s only one known side effect."
4100,1015,4,10,35,49,1.3673469387755102,0.09079148173496013,673,This will treat your hallucinations.
4241,1015,3,12,34,49,1.3673469387755102,0.08598112013445264,673,"Now, I would like to send you for some testing."
3146,1015,3,12,34,49,1.3673469387755102,0.08598112013445264,673,It's for cheese. It always makes me feel better.
4574,1015,4,10,35,49,1.3673469387755102,0.09079148173496013,673,"The trial pays 20 pellets a day, but the real reward is you'll be contributing to the health of rats all over the world!"
1015,1015,3,12,34,49,1.3673469387755102,0.08598112013445264,673,"Take two each morning and if you get an upset stomach, nibble on some garbage"
781,1015,5,8,36,49,1.3673469387755102,0.0953594950263686,673,"I'm Transferring You To Our ""LAB"" Division Where YOU Will Be Tested."
3854,1015,1,16,32,49,1.3673469387755102,0.07544582657421371,673,Trust me.  It is not rat poison.
3089,1015,2,14,33,49,1.3673469387755102,0.08088518333737492,673,I'd like you to take massive amounts of this new drug for the next six months.  Let me know if it's safe and effective.
3171,1015,2,14,33,49,1.3673469387755102,0.08088518333737492,673,Trust me. I  know about lab testing.
2922,1015,5,8,36,49,1.3673469387755102,0.0953594950263686,673,"I'm a stable genius, OK?"
441,1015,3,12,34,49,1.3673469387755102,0.08598112013445264,673,Here’s the prescription for your new medication— I’m not especially concerned about side effects.”
582,1015,3,12,34,49,1.3673469387755102,0.08598112013445264,673,I suggest you take this prescription after dark and sleep all-day.
669,1015,3,12,34,49,1.3673469387755102,0.08598112013445264,673,You think it’s easy being me!
826,1015,2,14,33,49,1.3673469387755102,0.08088518333737492,673,"If you want a human doctor, you'll need private health insurance."
982,1015,3,12,34,49,1.3673469387755102,0.08598112013445264,673,"Sorry, but you're in our control group."
1137,1015,4,10,35,49,1.3673469387755102,0.09079148173496013,673,Trust me. She's the best cosmetic surgeon I know.
1181,1015,2,14,33,49,1.3673469387755102,0.08088518333737492,673,"Here, I validated your parking for you.”
“Thanks. Why are you a rat?”
“I’m a psychiatrist, Mark. You have schizophrenia. I’ll see you next week.”"
2867,1015,2,14,33,49,1.3673469387755102,0.08088518333737492,673,It's been working fine for me other than constant cravings for cheese.
1196,1015,2,14,33,49,1.3673469387755102,0.08088518333737492,673,"Don't worry, it's been thoroughly tested on humans."
126,1015,1,16,32,49,1.3673469387755102,0.07544582657421371,673,Call me if you start hallucinating.
1494,1015,4,10,35,49,1.3673469387755102,0.09079148173496013,673,"It's just a mask, actually, I'm a tortoise."
1621,1015,3,12,34,49,1.3673469387755102,0.08598112013445264,673,Remember to take this with cheese.
1698,1015,2,14,33,49,1.3673469387755102,0.08088518333737492,673,"Some of my cousins experienced minor fur loss with this medication, but you should be fine."
2133,1015,5,8,36,49,1.3673469387755102,0.0953594950263686,673,"Grandmother, what a big prescription pad you have. 

Yes dear, the better to addict you."
2685,1015,3,12,34,49,1.3673469387755102,0.08598112013445264,673,"You come to a doctor who looks like a rat, and you're surprised I prescribe cheese?"
2780,1015,3,12,34,49,1.3673469387755102,0.08598112013445264,673,One mammal's Coumadin is another mammal's poison.
1455,1015,3,12,34,49,1.3673469387755102,0.08598112013445264,673,I  had the procedure myself.  It's completely safe.
144,1015,3,12,34,49,1.3673469387755102,0.08598112013445264,673,Third door on the left. Get in the wheel and start running.
1148,1051,5,12,43,60,1.3666666666666667,0.08222425813125592,673,You did right coming to me for a second opinion. Dr Katz is an idiot.
1581,1052,2,11,28,41,1.3658536585365855,0.09076972715087023,673,"It's a business card, not the plague."
1402,1053,2,15,35,52,1.3653846153846154,0.0778134742034209,673,Don't worry. I take it myself and I haven't experienced a single negative side effect.
1738,1053,3,13,36,52,1.3653846153846154,0.08251717748794969,673,This drug works best when taken with moldy food scraps.
2076,1053,1,17,34,52,1.3653846153846154,0.07280651725384965,673,"This hospital's bureaucracy is a maze, but I don't mind it."
2552,1053,1,17,34,52,1.3653846153846154,0.07280651725384965,673,It's true this one doesn't work so well but there are very few side effects.
2633,1053,3,13,36,52,1.3653846153846154,0.08251717748794969,673,Giving you this script makes me feel like a rat.
2955,1053,3,13,36,52,1.3653846153846154,0.08251717748794969,673,"That’s fantastic DR. Fox to you, sir."
3829,1053,5,9,38,52,1.3653846153846154,0.09119967218428188,673,We'll start you out with six weeks of some mild cheddar and possibly work up to a more pungent Roquefort.
3037,1053,2,15,35,52,1.3653846153846154,0.0778134742034209,673,Are you a man or a mouse? This prescription will help you decide.
560,1053,2,15,35,52,1.3653846153846154,0.0778134742034209,673,"Whaddya mean, ""It's a trap""? Go on...take it!"
780,1062,2,12,30,44,1.3636363636363635,0.08657756968052124,673,"Trust me,I'm a rat."
3355,1062,2,12,30,44,1.3636363636363635,0.08657756968052124,673,I think it's time we adjusted your medication.
1593,1062,4,8,32,44,1.3636363636363635,0.09802979382130766,673,"So, I recommend this for your symptoms but heck, it's just rat poison."
3855,1065,2,13,32,47,1.3617021276595744,0.0828802280775823,673,There's new research on irrelevance coming out all the time.
3566,1065,2,13,32,47,1.3617021276595744,0.0828802280775823,673,"Try 'em.  You won't look like a show dog, but you should feel better."
3198,1065,2,13,32,47,1.3617021276595744,0.0828802280775823,673,It hasn't been tested on humans yet but it worked great for me.
2560,1065,0,17,30,47,1.3617021276595744,0.07084485475872634,673,This prescription is for a great new wonder drug … tested it myself.
2348,1065,3,11,33,47,1.3617021276595744,0.08828477550742017,673,"Oh my, and I thought the Presidents hands were small."
918,1065,1,15,31,47,1.3617021276595744,0.07709774851439273,673,I recommend this medication - it's been tested on me.
1364,1065,5,7,35,47,1.3617021276595744,0.09820560242064913,673,It’s big and it’s bad but in a week you should be out of the woods.
2971,1065,2,13,32,47,1.3617021276595744,0.0828802280775823,673,"Open this, I don't have a thumb."
1206,1065,3,11,33,47,1.3617021276595744,0.08828477550742017,673,"Take two of these and . . . well, you'll see."
3036,1074,2,14,34,50,1.36,0.0795907901553378,673,I can personally verify that the prescription has been thoroughly vetted.
3123,1074,2,14,34,50,1.36,0.0795907901553378,673,"Look, if it can happen to me, it can happen to you."
3291,1074,1,16,33,50,1.36,0.07428571428571427,673,"For the last time, Mr. Johnson- Take two by mouth each morning, and the urges to eat your neighbor's chickens will stop. Take it from me."
3506,1074,3,12,35,50,1.36,0.08456370621113565,673,"I've mastered going to the pharmacy. Out of my office take a left, left, right, right, right, left, left, and a right."
3631,1074,3,12,35,50,1.36,0.08456370621113565,673,"For the last time, I promise I wasn't the one who gave you rabies."
3763,1074,3,12,35,50,1.36,0.08456370621113565,673,We avoid using the term “lab rat.” We’d prefer to think of you as a “guinea pig.”
3861,1074,3,12,35,50,1.36,0.08456370621113565,673,Trust me.  Pharmaceutical reps have stopped offering me wilderness trips.
3904,1074,2,14,34,50,1.36,0.0795907901553378,673,"As a drug test participant I can honestly say, there are no side effects with this drug."
3968,1074,5,8,37,50,1.36,0.09372125409632413,673,I'm almost certain it won't have the same effect on you.
4040,1074,2,14,34,50,1.36,0.0795907901553378,673,"You can’t get out of the race, but these supplements should help."
4066,1074,2,14,34,50,1.36,0.0795907901553378,673,Here's a script for some cheddar served on a wet sidewalk in Brooklyn.
4103,1074,4,10,36,50,1.36,0.08925999629607605,673,Why the long face?
4174,1074,2,14,34,50,1.36,0.0795907901553378,673,"You qualify for our Summer Special.  When I remove your gallbladder at the regular price, you can have another organ removed free."
4178,1074,5,8,37,50,1.36,0.09372125409632413,673,This prescription will change your life
4197,1074,2,14,34,50,1.36,0.0795907901553378,673,"When I tell you you don't have the plague,I know what I am talking about!"
4370,1074,2,14,34,50,1.36,0.0795907901553378,673,"Don’t worry, it’s not a harmful drug. I can personally vouch for its safety."
4391,1074,3,12,35,50,1.36,0.08456370621113565,673,"I used to suffer a lot of anxiety, but this got me out of the maze."
3011,1074,4,10,36,50,1.36,0.08925999629607605,673,It's perfectly safe- I've tried it myself.
2973,1074,4,10,36,50,1.36,0.08925999629607605,673,Your clinical trial is through the maze to your left.
3723,1074,1,16,33,50,1.36,0.07428571428571427,673,"Maze run, twice a day, see me in a week."
2588,1074,3,12,35,50,1.36,0.08456370621113565,673,I have to warn you they’ve only tested this on rats.
175,1074,2,14,34,50,1.36,0.0795907901553378,673,"You need penicillin. Go down the hall, take a left, a right, then a left, then a ... aw, just follow the smell of roquefort."
208,1074,4,10,36,50,1.36,0.08925999629607605,673,"What large bills you have, Doctor!"
404,1074,4,10,36,50,1.36,0.08925999629607605,673,"Yes, I always wear a tie?"
602,1074,4,10,36,50,1.36,0.08925999629607605,673,"I know what this looks like, but trust me: it's the pharmacies that are the real rats."
627,1074,3,12,35,50,1.36,0.08456370621113565,673,"I gather that you didn't know ""Flowers for Algernon"" had an alternate ending."
785,1074,2,14,34,50,1.36,0.0795907901553378,673,Trust me. I wouldn't prescribe anything that wasn't already tested on me.
884,1074,2,14,34,50,1.36,0.0795907901553378,673,Don't be alarmed. I have to wear this just until my med school loans are paid off.  Trust me.
891,1074,1,16,33,50,1.36,0.07428571428571427,673,I'm certain that this will help you. Lot's of my friends were in the clinical trial.
1001,1074,3,12,35,50,1.36,0.08456370621113565,673,It's safe.... the FDA tested it ....
1030,1074,3,12,35,50,1.36,0.08456370621113565,673,"Trump just tweeted that we're a rat-infested city!  The nerve."""
1067,1074,2,14,34,50,1.36,0.0795907901553378,673,"If you find your way out of the maze, send directions to me at this email address."
1186,1074,4,10,36,50,1.36,0.08925999629607605,673,"Side effects may include headaches, nausea, and hallucinations."
1505,1074,1,16,33,50,1.36,0.07428571428571427,673,"Of course you can’t read my writing.
I’m a rat!"
1666,1074,2,14,34,50,1.36,0.0795907901553378,673,Take two tablets daily till I start looking human.
2012,1074,3,12,35,50,1.36,0.08456370621113565,673,Side effects may include seeing souls' true nature.
2033,1074,3,12,35,50,1.36,0.08456370621113565,673,"Don't worry. It's been fully tested by the FDA. Trust me, I supervised the human trials myself."
2129,1074,3,12,35,50,1.36,0.08456370621113565,673,Side effects? None at all; I even take these myself!
2234,1074,1,16,33,50,1.36,0.07428571428571427,673,"In animal testing, it only killed 25% of those that tried it."
2317,1074,2,14,34,50,1.36,0.0795907901553378,673,You'll be able to squeak by with this.
2787,1074,3,12,35,50,1.36,0.08456370621113565,673,And I can’t stress this enough. This is a MoviePass card. It literally does nothing.
0,1074,3,12,35,50,1.36,0.08456370621113565,673,No one likes the pellets.
1036,1116,4,15,45,64,1.359375,0.07508985193150429,673,You should take it on a full moon...I mean stomach.
3182,1117,1,17,35,53,1.3584905660377358,0.07175156513386516,673,"Take this prescription. Come back in a week. If I still look like this to you, we'll investigate further."
1641,1118,4,12,40,56,1.3571428571428572,0.08229094499969293,673,No wonder you're bug-eyed.
2505,1118,2,16,38,56,1.3571428571428572,0.07398039152533047,673,"As you can see, the early clinical trials have produced some extraordinary results."
2086,1118,2,11,29,42,1.3571428571428572,0.08900944482260857,673,"You'll get a discount in Baltimore, or so I hear."
870,1118,2,16,38,56,1.3571428571428572,0.07398039152533047,673,"It’s for Warfarin, don’t take too much"
3144,1122,3,10,32,45,1.3555555555555556,0.09076307015852635,673,Good luck navigating the insurance industry maze for this prescription.
3395,1122,3,10,32,45,1.3555555555555556,0.09076307015852635,673,Fill this at any trash can.
3397,1122,4,8,33,45,1.3555555555555556,0.09616670897302551,673,"No, I specialize in bubonic plague, the tick's down the hall."
3713,1122,2,12,31,45,1.3555555555555556,0.08501666833333664,673,"Cheese 3 times a day, that should solve your problem."
3872,1122,3,10,32,45,1.3555555555555556,0.09076307015852635,673,"It will do more than mitigate, it will exterminate."
3905,1122,1,14,30,45,1.3555555555555556,0.07885260226777271,673,Don’t be ridiculous. I’m a squirrel.
4367,1122,2,12,31,45,1.3555555555555556,0.08501666833333664,673,Here is a thought and a prayer for you that I have used with all my patients since my time in  the Health and Human Services Department while in the Trump administration.
4383,1122,3,10,32,45,1.3555555555555556,0.09076307015852635,673,"They’re safe, I was part of the test when I was a resident."
4490,1122,3,10,32,45,1.3555555555555556,0.09076307015852635,673,"Here is a link to our survey, don't worry its anonymouse."
4522,1122,3,10,32,45,1.3555555555555556,0.09076307015852635,673,Of course there’s a difference between ‘animal doctor’ and ‘doctor who is an animal’.
1172,1122,3,10,32,45,1.3555555555555556,0.09076307015852635,673,"Hey, we're all test rats."
3030,1122,2,12,31,45,1.3555555555555556,0.08501666833333664,673,"Don't worry, I have a doctor rat degree."
4058,1122,2,12,31,45,1.3555555555555556,0.08501666833333664,673,One small side effect is the need to burrow.
2998,1122,3,10,32,45,1.3555555555555556,0.09076307015852635,673,It' s not cheap but the price will come down under Bernie's plan.
4018,1122,1,14,30,45,1.3555555555555556,0.07885260226777271,673,Take two daily; they're good for bubonic.
2744,1122,2,12,31,45,1.3555555555555556,0.08501666833333664,673,No need to make a followup appointment Mr. Smith. This should take care of the issue.
22,1122,1,14,30,45,1.3555555555555556,0.07885260226777271,673,This card is blocked. I smell a rat.
108,1122,3,10,32,45,1.3555555555555556,0.09076307015852635,673,"No need to worry, I tested it on my own family."
254,1122,3,10,32,45,1.3555555555555556,0.09076307015852635,673,Here's your parking pass. You now have 5 minutes to find your car....
302,1122,2,12,31,45,1.3555555555555556,0.08501666833333664,673,"No, all drugs are not, 'basically the same stuff'"
924,1122,3,10,32,45,1.3555555555555556,0.09076307015852635,673,Don't be intimidated by my framed college degrees.
1071,1122,3,10,32,45,1.3555555555555556,0.09076307015852635,673,I can get you into an experimental trial. Those are my specialty.
1201,1122,2,12,31,45,1.3555555555555556,0.08501666833333664,673,Vermin schermin. Take the pills.
31,1122,3,10,32,45,1.3555555555555556,0.09076307015852635,673,Call me if the erection lasts longer than four generations.”
2919,1122,2,12,31,45,1.3555555555555556,0.08501666833333664,673,You may experience a strong fear of cats.
1809,1122,3,10,32,45,1.3555555555555556,0.09076307015852635,673,"Baltimore? No,the White House."
2365,1122,5,6,34,45,1.3555555555555556,0.10128246109175859,673,Why are you always so focused on side effects?
2438,1122,2,12,31,45,1.3555555555555556,0.08501666833333664,673,How's it feel to be the Lab Rat now?   Wanna try the eye chart again?
2724,1122,3,10,32,45,1.3555555555555556,0.09076307015852635,673,Lots of my friends have experienced positive results.
2611,1122,4,8,33,45,1.3555555555555556,0.09616670897302551,673,What? Lab rats got dreams too.
2525,1122,1,14,30,45,1.3555555555555556,0.07885260226777271,673,"Believe me, in a week you'll think I look like an angel."
1650,1122,2,12,31,45,1.3555555555555556,0.08501666833333664,673,Take two pills and call me Dr. Vermin.
1019,1154,3,5,23,31,1.3548387096774193,0.1186699325705066,673,"Okay, no more of that 'you dirty rat' every time I give you your bill"
4467,1155,0,17,31,48,1.3541666666666667,0.06976139255528775,673,"Yes there were a few anomalies in the preclinical animal studies, but we don’t think they were statistically significant"
4248,1155,3,11,34,48,1.3541666666666667,0.08675382619422652,673,It’s okay. It was tested on me and look where I wound up.
4348,1155,3,11,34,48,1.3541666666666667,0.08675382619422652,673,"Take this twice a day, and let me know right away if you develop a compulsion to solve mazes or your sense of smell picks out cheese more often than usual."
3322,1155,5,7,36,48,1.3541666666666667,0.09643275379624983,673,This should help with the voices.
2491,1155,2,13,33,48,1.3541666666666667,0.08148436375552691,673,I recommend a high cheese diet.
1592,1155,1,15,32,48,1.3541666666666667,0.07584969817967631,673,Don't know if it will help but it's NOT gonna kill you.
1570,1155,4,9,35,48,1.3541666666666667,0.09172105092089328,673,How do you feel about experimental treatments?
1086,1155,6,5,37,48,1.3541666666666667,0.10092472852291043,673,"Trust me it's just a cold. Here is a prescription for the cough. But look, I resent your plague diagnosis. That was a long time ago."
814,1155,3,11,34,48,1.3541666666666667,0.08675382619422652,673,I must caution you. The side effects are quite pointed.
3803,1155,3,11,34,48,1.3541666666666667,0.08675382619422652,673,"It's totally safe.  In fact, my 413 cousins were personally involved in the clinical trials...."
2045,1165,3,12,36,51,1.3529411764705883,0.08318903308077029,673,Oh so rats can carry disease but not cure them?
2566,1165,3,12,36,51,1.3529411764705883,0.08318903308077029,673,It's definitely the cat
2991,1165,3,12,36,51,1.3529411764705883,0.08318903308077029,673,"Oh yeah, Johns Hopkins is infested with us."""
3029,1165,4,10,37,51,1.3529411764705883,0.08777658543372309,673,I'm going to start you on Garbage.
3342,1165,4,10,37,51,1.3529411764705883,0.08777658543372309,673,Take these; they were clinically rested on rats.
1551,1170,1,17,36,54,1.3518518518518519,0.07072257295398894,673,"Most of my patients are fine with under-the-counter."""
3487,1171,0,20,37,57,1.3508771929824561,0.06377448947368156,673,"Before I became a doctor, I was a lab assistant."
2967,1171,4,12,41,57,1.3508771929824561,0.08107682265474593,673,You can get this filled at the manhole cover outside the Port Authority Bus Terminal.
851,1171,5,10,42,57,1.3508771929824561,0.08485291737959999,673,We're under a lot of pressure to stop prescribing the stuff that'll blow your house down.
1822,1171,1,18,38,57,1.3508771929824561,0.06851096206935661,673,here's your prescription for your new glasses.
613,1171,5,10,42,57,1.3508771929824561,0.08485291737959999,673,Take two cubes of cheese and call me in the morning.
678,1171,4,12,41,57,1.3508771929824561,0.08107682265474593,673,You should have taken the blue pill.
2960,1171,4,12,41,57,1.3508771929824561,0.08107682265474593,673,This medicine worked for me.
1595,1171,1,18,38,57,1.3508771929824561,0.06851096206935661,673,"I swear,  D-Con is just shorthand for decongestion medication."
3658,1179,3,9,31,43,1.3488372093023255,0.09343761535166267,673,"Side effects, no, and I say that from personal experience."
4551,1179,1,13,29,43,1.3488372093023255,0.08072018668501404,673,"Take three of these daily. You really only need one, but this way I get paid three times more"
1937,1179,3,9,31,43,1.3488372093023255,0.09343761535166267,673,Dr. B. F. Skinner has worked wonders for me.
1697,1179,0,15,28,43,1.3488372093023255,0.07354134093414834,673,You get to choose; the blue one or the red one.
2864,1179,2,11,30,43,1.3488372093023255,0.08731075678594472,673,Its very effective - I just tested this new drug on myself this morning.
863,1179,1,13,29,43,1.3488372093023255,0.08072018668501404,673,This should stop the hallucinations plaguing you.
299,1179,0,15,28,43,1.3488372093023255,0.07354134093414834,673,Your participation may contribute knowledge that alleviates suffering in rats worldwide.
3451,1179,3,9,31,43,1.3488372093023255,0.09343761535166267,673,Thank you for supporting the arts.
3075,1187,3,10,33,46,1.3478260869565217,0.08910391970399652,673,I can assure you that our Cheese Only Dieting Formula has no side effects.
4365,1187,4,8,34,46,1.3478260869565217,0.09436997447014324,673,Make sure to take it with trash.
4311,1187,3,10,33,46,1.3478260869565217,0.08910391970399652,673,This will prevent the hallucinations from recurring.
4105,1187,2,12,32,46,1.3478260869565217,0.08350643646891556,673,It had amazing results in the rat trials.
3915,1187,1,14,31,46,1.3478260869565217,0.07750575047606342,673,"The side effects include growing whiskers and fur, but it'll cure your visions."
2931,1187,3,10,33,46,1.3478260869565217,0.08910391970399652,673,"I know it's not traditional medicine, but think you could benefit from a visit to the catnip dispensary."
3308,1187,4,8,34,46,1.3478260869565217,0.09436997447014324,673,You said everyone looks like a rodent? This should help– side effects include seeing the world as it is.
2436,1187,3,10,33,46,1.3478260869565217,0.08910391970399652,673,Trust me.  I have spent my whole life in the lab.
1,1187,2,12,32,46,1.3478260869565217,0.08350643646891556,673,"Look, all medicine is rat poison if given at large enough doses."
121,1187,2,12,32,46,1.3478260869565217,0.08350643646891556,673,This drug is great according to my friends in the lab.
2896,1187,4,8,34,46,1.3478260869565217,0.09436997447014324,673,Careful with this blood thinner. My mother died from it.
821,1187,2,12,32,46,1.3478260869565217,0.08350643646891556,673,...I don’t give a rat’s ass...
971,1187,4,8,34,46,1.3478260869565217,0.09436997447014324,673,"Trust me, this prescription works. I've tested it myself."
2427,1187,5,6,35,46,1.3478260869565217,0.0993573130492905,673,The better to cure you with.
1128,1187,2,12,32,46,1.3478260869565217,0.08350643646891556,673,I take this myself. There might be a few side effects
1907,1187,2,12,32,46,1.3478260869565217,0.08350643646891556,673,Here's your new prescription. It's been safely tested in mice.
1313,1187,3,10,33,46,1.3478260869565217,0.08910391970399652,673,Trust me. My brother survived trials of this drug.
1955,1187,3,10,33,46,1.3478260869565217,0.08910391970399652,673,Take 2 voles and call me in the morning.
1282,1187,3,10,33,46,1.3478260869565217,0.08910391970399652,673,It’s new but I’ve taken it myself.
4213,1206,5,7,37,49,1.346938775510204,0.0947204103105056,673,"Actually, I left my law practice years ago."
3038,1206,4,9,36,49,1.346938775510204,0.09012000884008008,673,"As for side effects, with any luck, you'll be a cat."
532,1206,3,11,35,49,1.346938775510204,0.08527177644028351,673,"Take this at home, in a secluded place, were carnivores will not find your rotting carcass."
1859,1206,4,9,36,49,1.346938775510204,0.09012000884008008,673,Needed? Do I look like someone who'd overprescribe for a kickback?
1353,1206,1,15,33,49,1.346938775510204,0.07463642264452958,673,"This will help a little, bit it’s still a rat race."
950,1206,4,9,36,49,1.346938775510204,0.09012000884008008,673,"Your pro Trump, Right!"
765,1206,2,13,34,49,1.346938775510204,0.08013074142442006,673,"Mr. Cosgrove, All our plans require a referral for hallucinations."
619,1206,1,15,33,49,1.346938775510204,0.07463642264452958,673,These cheese packets should do the trick.
1939,1206,4,9,36,49,1.346938775510204,0.09012000884008008,673,Try this—if you start hallucinating rats call me immediately.
3824,1215,2,14,36,52,1.3461538461538463,0.07711138339070239,673,"When you're up in Canada, don't mix this with BC bud... there are side effects..."
2627,1216,3,13,39,55,1.3454545454545455,0.0787878787878788,673,"It's an emergency - I'm going to have to scurry."""
2384,1217,2,8,25,35,1.3428571428571427,0.09993995796516643,673,Rat face is contagious.  Get yourself some pills.
1234,1218,2,10,29,41,1.3414634146341464,0.08978127960637054,673,"I've been taking this same medicine for years, and it's had no negative effects at all."
2171,1218,3,8,30,41,1.3414634146341464,0.09633374467381219,673,Trust me. It works! I don’t even recognize myself anymore.
3320,1220,2,11,31,44,1.3409090909090908,0.0856709732875726,673,Here’s my card. There are only two plastic surgeons in this town. He is gorgeous. Call me when that sinks in.
3237,1220,3,9,32,44,1.3409090909090908,0.09163295322356073,673,Wolfbane has worked for many of my patients
2996,1220,2,11,31,44,1.3409090909090908,0.0856709732875726,673,"I am prescribing 500 mL of cheese to help alleviate the depression. Cheese makes everyone happy. And no, I am not just saying that because I'm a rat."
2968,1220,4,7,33,44,1.3409090909090908,0.09723003943690735,673,Please take your medication; your schizophrenia is getting much worse.
2233,1220,3,9,32,44,1.3409090909090908,0.09163295322356073,673,This will definitely cure you of the delusion that your dentist is Bigfoot.
2533,1220,4,7,33,44,1.3409090909090908,0.09723003943690735,673,"Here's twenty bucks, if you can get this stupid mask off my head."
2232,1220,2,11,31,44,1.3409090909090908,0.0856709732875726,673,"Hide two of these in your food each night."""
2377,1220,1,13,30,44,1.3409090909090908,0.0792618017181586,673,I'm referring you to a specialist in Baltimore.
2322,1220,2,11,31,44,1.3409090909090908,0.0856709732875726,673,This is what you get for testing this on me
3331,1220,3,9,32,44,1.3409090909090908,0.09163295322356073,673,Here's the prescription for the drug study I volunteered you for.
2735,1220,3,9,32,44,1.3409090909090908,0.09163295322356073,673,"After your gene edit, you can redeem this half off any item coupon at Animal Chow."
3361,1220,2,11,31,44,1.3409090909090908,0.0856709732875726,673,"Don’t worry, it tested well on rats."
4214,1220,2,11,31,44,1.3409090909090908,0.0856709732875726,673,"Bob,take my card.  Yes there is a doctor shortage,but I can tell more from your garbage than your blood test."
3686,1220,3,9,32,44,1.3409090909090908,0.09163295322356073,673,Anxiety? Take this. You are not allergic to cheese right?
3692,1220,1,13,30,44,1.3409090909090908,0.0792618017181586,673,My nurses will help you navigate the insurance maze.
3790,1220,2,11,31,44,1.3409090909090908,0.0856709732875726,673,Wrap the tablet in some chicken or peanut butter and you’ll find it easier to swallow.
3934,1220,2,11,31,44,1.3409090909090908,0.0856709732875726,673,Side effects?  Unlikely.  I've been taking it for years.
3945,1220,2,11,31,44,1.3409090909090908,0.0856709732875726,673,"Side effects include destructive gnawing, burrowing and random stooling, nothing unusual."
4139,1220,3,9,32,44,1.3409090909090908,0.09163295322356073,673,"Yes, these should make the turtles disappear too."
4168,1220,4,7,33,44,1.3409090909090908,0.09723003943690735,673,"My relatives have tested this for months, trust me it's safe."
4215,1220,1,13,30,44,1.3409090909090908,0.0792618017181586,673,Take a slice of cheddar and call me in the morning.
4218,1220,2,11,31,44,1.3409090909090908,0.0856709732875726,673,‘Avoid all red meat - eat only lamb; it works for me.’
4377,1220,2,11,31,44,1.3409090909090908,0.0856709732875726,673,Take one every eight hours with a piece of cheese.
4387,1220,1,13,30,44,1.3409090909090908,0.0792618017181586,673,Take two of these daily and bring me a sample of your droppings.
1976,1220,0,15,29,44,1.3409090909090908,0.07228658768525044,673,What? Are you afraid it's poison?
3568,1220,1,13,30,44,1.3409090909090908,0.0792618017181586,673,This prescription is completely safe.  I tested it on myself and as you can see it works wonders.
4257,1220,1,13,30,44,1.3409090909090908,0.0792618017181586,673,This will really help your maze-solving times
4570,1220,2,11,31,44,1.3409090909090908,0.0856709732875726,673,I think you’ll find an emotional support animal very beneficial
2015,1220,2,11,31,44,1.3409090909090908,0.0856709732875726,673,Don't worry.  I've been taking them for over a year.
167,1220,2,11,31,44,1.3409090909090908,0.0856709732875726,673,Here's your prescription for humanitis.
213,1220,1,13,30,44,1.3409090909090908,0.0792618017181586,673,"Well, not all doctors can prescribe, but all prescribing doctors are rats."
272,1220,2,11,31,44,1.3409090909090908,0.0856709732875726,673,Less than 200 lab humans died in the trials.
422,1220,2,11,31,44,1.3409090909090908,0.0856709732875726,673,I highly recommend this drug. I was even an early test subject for it.
569,1220,3,9,32,44,1.3409090909090908,0.09163295322356073,673,Twice a day until your eyes pop back into your head
651,1220,3,9,32,44,1.3409090909090908,0.09163295322356073,673,"Relax, it worked on my cousins in the lab."
682,1220,1,13,30,44,1.3409090909090908,0.0792618017181586,673,Take two of these and an electric shock every morning.
737,1220,2,11,31,44,1.3409090909090908,0.0856709732875726,673,"Quite frankly sir, I don’t give a rat’s “a**” about  what you think about my diagnosis. However, if anyone should know the plague it would be me."
762,1220,2,11,31,44,1.3409090909090908,0.0856709732875726,673,This prescription should help with those hallucinations.
771,1220,3,9,32,44,1.3409090909090908,0.09163295322356073,673,Trust ME!  This is not the time to jump ship!
28,1220,4,7,33,44,1.3409090909090908,0.09723003943690735,673,"Yes, I went to a foreign medical school, but take it any way."
1094,1220,2,11,31,44,1.3409090909090908,0.0856709732875726,673,"If the hallucinations continue, feel free to call this number after hours."
909,1220,2,11,31,44,1.3409090909090908,0.0856709732875726,673,You should've gotten a letter from your HMO - we've just added a pharmaceutical weasel tax to your copay.
1727,1220,3,9,32,44,1.3409090909090908,0.09163295322356073,673,This ticket is good for one free tour of the maze.
1214,1220,4,7,33,44,1.3409090909090908,0.09723003943690735,673,"I assure you, Frank, this drug has been thoroughly lab-tested and approved. I take it myself."
1550,1220,2,11,31,44,1.3409090909090908,0.0856709732875726,673,They're looking for human test subjects and you qualify! Congratulations!
1565,1220,3,9,32,44,1.3409090909090908,0.09163295322356073,673,It's been quite effective with rats.
1642,1220,2,11,31,44,1.3409090909090908,0.0856709732875726,673,I'm just going to run you through some tests.
1654,1220,3,9,32,44,1.3409090909090908,0.09163295322356073,673,"3 mozzarella wheels 3 times a day. This coupon is expired, but they’re adorably susceptible to gaslighting."
1671,1220,2,11,31,44,1.3409090909090908,0.0856709732875726,673,Take two Babybel's and call me in the morning.
1213,1220,2,11,31,44,1.3409090909090908,0.0856709732875726,673,It's perfectly safe. I've been taking it for years.
2029,1220,3,9,32,44,1.3409090909090908,0.09163295322356073,673,You're my fifth patient with the plague this week!
1912,1220,2,11,31,44,1.3409090909090908,0.0856709732875726,673,"Sorry, it's a bit of a maze to get out of here."
1983,1220,2,11,31,44,1.3409090909090908,0.0856709732875726,673,"Take this referral to physical therapy, it's just at the other end of the maze."
2008,1220,3,9,32,44,1.3409090909090908,0.09163295322356073,673,"No, we don't take your insurance, but I am willing to barter for livestock."
3417,1274,2,12,33,47,1.3404255319148937,0.08204484088304062,673,"Believe me,I've used this drug for years and the side effects are minimal."
3408,1274,3,10,34,47,1.3404255319148937,0.08750100168413485,673,Just follow the instructions on the prescription and you'll be able to cope with the rat race much easier.
2689,1274,1,14,32,47,1.3404255319148937,0.07619899300725659,673,"Look, if there's one thing we rats know about, it's reproduction. Take 2 of these daily and your wife will be pregnant in no time."
2796,1274,2,12,33,47,1.3404255319148937,0.08204484088304062,673,Some guy with a flute drove my family out of Ireland so we settled in Baltimore.
2954,1274,4,8,35,47,1.3404255319148937,0.09263635720347863,673,Its okay.  I got my start in the lab.
3672,1274,3,10,34,47,1.3404255319148937,0.08750100168413485,673,You seem to have a little white-coat syndrome. This will help.
4198,1274,2,12,33,47,1.3404255319148937,0.08204484088304062,673,I'll have to refer you to a colleague. I don't handle rat phobias.
3862,1274,3,10,34,47,1.3404255319148937,0.08750100168413485,673,"Of course, I’m using a mouse. Why do you ask?"
3946,1274,3,10,34,47,1.3404255319148937,0.08750100168413485,673,"A few minimal side effects, took it myself."
3973,1274,5,6,36,47,1.3404255319148937,0.09750161053097534,673,"I'm prescribing a taste of your own medicine, otherwise kown as rat poison."
3986,1274,0,16,31,47,1.3404255319148937,0.0698657080055475,673,Take two and scratch the wall in the morning.
4169,1274,1,14,32,47,1.3404255319148937,0.07619899300725659,673,These opioids are recommended by Little Red Riding Hood.
4183,1274,2,12,33,47,1.3404255319148937,0.08204484088304062,673,I feel your pain - I’m also lactose intolerant.
2681,1274,2,12,33,47,1.3404255319148937,0.08204484088304062,673,"Your check-up was fine, it's in case you come down with the plague."
4484,1274,1,14,32,47,1.3404255319148937,0.07619899300725659,673,Here take these pills and come back when you're vision is cleared up..
3813,1274,4,8,35,47,1.3404255319148937,0.09263635720347863,673,Take two a day. You'll back up on your hind legs in no time.
2636,1274,2,12,33,47,1.3404255319148937,0.08204484088304062,673,‘This should stop your hallucinations.’
3599,1274,2,12,33,47,1.3404255319148937,0.08204484088304062,673,Trust me.  I spent a lot of time in the lab before I got this job.
2376,1274,2,12,33,47,1.3404255319148937,0.08204484088304062,673,"So, ""Mr. Orkin Man,"" the tables have finally turned. No pain pills for you!"
2599,1274,4,8,35,47,1.3404255319148937,0.09263635720347863,673,"Trust me, it will allow you to believe you can do anything."
333,1274,2,12,33,47,1.3404255319148937,0.08204484088304062,673,"Sure you could go to the pharmacy on 8th, but it’s a bit of a maze."
822,1274,2,12,33,47,1.3404255319148937,0.08204484088304062,673,Whatever made you think  one of the side effects is hallucinations!
1024,1274,2,12,33,47,1.3404255319148937,0.08204484088304062,673,"Me, I grew up in Baltimore....Why?"
1277,1274,1,14,32,47,1.3404255319148937,0.07619899300725659,673,"I know I might look like a Rat, but it's actually Dr. Rat."""
1389,1274,4,8,35,47,1.3404255319148937,0.09263635720347863,673,Try it. I've tested it myself.
1217,1274,3,10,34,47,1.3404255319148937,0.08750100168413485,673,"Normally, I would prescribe the generic, but in this case, you're going to want to go with the name brand stuff."
1471,1274,1,14,32,47,1.3404255319148937,0.07619899300725659,673,Take my word for it. The side effects are limited to an insatiable appetite for cheese and aversion to cats.
1536,1274,3,10,34,47,1.3404255319148937,0.08750100168413485,673,Get on the wheel more and lay off the pizza.
1878,1274,2,12,33,47,1.3404255319148937,0.08204484088304062,673,Here’s the address of the lab. Don’t let the maze scare you !
2224,1274,1,14,32,47,1.3404255319148937,0.07619899300725659,673,I'm certain it is effective because I was the lab rat they tested in on.
2254,1274,3,10,34,47,1.3404255319148937,0.08750100168413485,673,Trust me. It worked for me.
1406,1274,1,14,32,47,1.3404255319148937,0.07619899300725659,673,"I can vouch there are no side effects. In fact, I've used this medication myself."
2027,1306,3,11,36,50,1.34,0.08383657572069263,673,"I don't come to your office and stare at you, sir, Thank you very much."
4414,1306,2,13,35,50,1.34,0.0788177955664784,673,... and you'll be back in the rat race in ten days.
2044,1306,1,15,34,50,1.34,0.07345691504104251,673,Don't worry - they were tested on humans.
893,1306,2,13,35,50,1.34,0.0788177955664784,673,I voted for Trump...now I see rat infestations everywhere...!
2837,1310,4,10,39,53,1.3396226415094339,0.08494596688823428,673,in queso emergency call 911
4044,1310,2,14,37,53,1.3396226415094339,0.07592389927228196,673,"Given how you're looking at me, my guess is you've already tried some of these."
3587,1310,3,12,38,53,1.3396226415094339,0.08056132996445817,673,"Not to worry--there are no significant side effects. I take it myself, in fact. Perfectly safe!"
3990,1310,6,6,41,53,1.3396226415094339,0.09309777709723455,673,"Of all the drugs they tested on me, I found this one gave me the least tumors."
2297,1310,2,14,37,53,1.3396226415094339,0.07592389927228196,673,"If you feel like it's working, keep pressing the button."
3050,1310,4,10,39,53,1.3396226415094339,0.08494596688823428,673,Trust me!  The benefits outweigh the risks.
2160,1310,4,10,39,53,1.3396226415094339,0.08494596688823428,673,Take two poison pellets and call me in the morning.
3272,1310,2,14,37,53,1.3396226415094339,0.07592389927228196,673,"Johns Hopkins, why do you ask?"
1957,1310,2,14,37,53,1.3396226415094339,0.07592389927228196,673,The benefits outweigh the poison. I'm still alive.
2026,1310,1,16,36,53,1.3396226415094339,0.07098414665101588,673,I take this myself and never noticed any side effects.
1509,1310,2,14,37,53,1.3396226415094339,0.07592389927228196,673,"This will help with stress, but you need to get out of the human race."
2049,1321,3,9,33,45,1.3333333333333333,0.08989331499509895,673,This should help those giant rat nightmares.
2124,1321,1,13,31,45,1.3333333333333333,0.0778498944161523,673,"I know, but I'm the best doctor you're gonna find here in Baltimore."
2193,1321,1,13,31,45,1.3333333333333333,0.0778498944161523,673,"This prescription will help. And of all the things you think you are seeing, I would never wear a green tie"
2244,1321,3,9,33,45,1.3333333333333333,0.08989331499509895,673,"Call this guy, he's human."
2315,1321,3,9,33,45,1.3333333333333333,0.08989331499509895,673,I went to Johns Hopkins. So?
2449,1321,3,9,33,45,1.3333333333333333,0.08989331499509895,673,It's your conscience; it is a very personal decision. I found these are the only thing that keeps mine quiet.
3210,1321,3,11,37,51,1.3333333333333333,0.08244625898677896,673,I took it and I’ve never felt better.
2669,1321,3,9,33,45,1.3333333333333333,0.08989331499509895,673,Now next time call me if you keep seeing cheese.
2705,1321,2,11,32,45,1.3333333333333333,0.08408749651825217,673,Take these after surgery. I'll probably bite you.
2801,1321,3,11,37,51,1.3333333333333333,0.08244625898677896,673,"Don't rat me out, but this prescription is cheaper than therapy sessions."
3002,1321,2,11,32,45,1.3333333333333333,0.08408749651825217,673,"Funnily enough, they tested this on me before I went to medical school."
3026,1321,2,10,30,42,1.3333333333333333,0.08799394622474242,673,This will help your nose and whiskers grow back.
3185,1321,2,11,32,45,1.3333333333333333,0.08408749651825217,673,"It's a business card, Mr. Emerson, not the plague."
2504,1321,2,10,30,42,1.3333333333333333,0.08799394622474242,673,My vet says this stuff works great.
3286,1321,1,13,31,45,1.3333333333333333,0.0778498944161523,673,"The experiments will begin soon.  This is your cage number, you must report immediately..."
3345,1321,2,11,32,45,1.3333333333333333,0.08408749651825217,673,Of Course you do not need a prescription for an exercise wheel but with one insurance may cover it.
3349,1321,4,7,34,45,1.3333333333333333,0.09534625892455922,673,Take two of these and run for the Senate
3472,1321,2,11,32,45,1.3333333333333333,0.08408749651825217,673,The main thing to avoid while taking these is hunting season.
4538,1321,1,13,31,45,1.3333333333333333,0.0778498944161523,673,It's for the hallucinations.
3617,1321,3,9,33,45,1.3333333333333333,0.08989331499509895,673,One man's poison is another man's blood thinner
3823,1321,0,14,28,42,1.3333333333333333,0.07362101738323101,673,Here's your identity card for your participation in the electric shock experiment.
4062,1321,1,12,29,42,1.3333333333333333,0.08112640991916524,673,... and it's non-habit forming.
4227,1321,3,6,27,36,1.3333333333333333,0.10540925533894598,673,"Oh, please. Its not the friggin plague."
4239,1321,3,5,25,33,1.3333333333333333,0.11236664374387369,673,It’s just a blood-thinner. You’ll be fine.
4401,1321,1,12,29,42,1.3333333333333333,0.08112640991916524,673,Next we’ll be sending you to space.
4454,1321,3,13,41,57,1.3333333333333333,0.07647191129018727,673,Here's a little something to help with that infested feeling.
4468,1321,2,11,32,45,1.3333333333333333,0.08408749651825217,673,Good luck with the bureaucratic maze.
4509,1321,3,10,35,48,1.3333333333333333,0.08595177052156613,673,Just try them.   Opioids haven’t changed me.
3328,1321,2,11,32,45,1.3333333333333333,0.08408749651825217,673,Karma's a bitch. Pick your poison.
2047,1321,2,11,32,45,1.3333333333333333,0.08408749651825217,673,Just a little something to help you fight the hallucinations.
531,1321,3,7,29,39,1.3333333333333333,0.09948133599990347,673,"Don't worry, we tested it — I was part of the team!"
1910,1321,2,12,34,48,1.3333333333333333,0.08062990780781613,673,Take two of these a day and avoid me like the plague.
2017,1321,3,10,35,48,1.3333333333333333,0.08595177052156613,673,"It's off label, but then, so am I."
7,1321,4,8,36,48,1.3333333333333333,0.09096280381830256,673,I’m sending you to the lab. It’s going to be a dog.
123,1321,4,6,32,42,1.3333333333333333,0.10032853504294638,673,Do you have any idea where you might have contracted the plague?
399,1321,3,8,31,42,1.3333333333333333,0.0943629946432037,673,Trying to weasel you're way out of a co-pay won't work. I should know
450,1321,1,15,35,51,1.3333333333333333,0.0723101526062187,673,"Take one three times a day, with meals.  And cheese.  Lots and lots of rat trap cheese."
638,1321,3,9,33,45,1.3333333333333333,0.08989331499509895,673,This is my driver's license! What more do you need?
647,1321,0,18,36,54,1.3333333333333333,0.06475239082381762,673,This will put you back in the rat race.
882,1321,2,12,34,48,1.3333333333333333,0.08062990780781613,673,"Yeah, I'm that 10th doctor, and I recommend  a pack a day."
949,1321,3,11,37,51,1.3333333333333333,0.08244625898677896,673,This is a prescription  for the blue pill. Your last prescription for the red pill had some side effects.
1068,1321,2,10,30,42,1.3333333333333333,0.08799394622474242,673,Im gonna Rat-chit up a notch!
1082,1321,2,12,34,48,1.3333333333333333,0.08062990780781613,673,"So, you go to this forest and ask for granny's house."
1112,1321,3,9,33,45,1.3333333333333333,0.08989331499509895,673,"It's safe, I even tested it on myself."
1154,1321,2,10,30,42,1.3333333333333333,0.08799394622474242,673,Well the good news is this confirms that rats are able to smell cancerous cells
1207,1321,2,11,32,45,1.3333333333333333,0.08408749651825217,673,"My colleague grew an ear on this one, but it might help your eczema."
1268,1321,3,12,39,54,1.3333333333333333,0.07930515857181442,673,Don't be afraid. I am really a sheep in wolf's clothing.
1360,1321,1,16,37,54,1.3333333333333333,0.06994057575518775,673,Take these with cheese.
1469,1321,4,7,34,45,1.3333333333333333,0.09534625892455922,673,"I went to med school in Baltimore, what’s your excuse?"
1518,1321,3,7,29,39,1.3333333333333333,0.09948133599990347,673,"Hey, trust me, I was just a test rat once, but look at me now."
1729,1321,3,9,33,45,1.3333333333333333,0.08989331499509895,673,Two injections a day for one month.  Your maze skills should increase dramatically.
1732,1321,2,11,32,45,1.3333333333333333,0.08408749651825217,673,"Come on, have a cigarette."
1829,1321,3,9,33,45,1.3333333333333333,0.08989331499509895,673,I take these myself and there are no side effects!
1838,1321,2,11,32,45,1.3333333333333333,0.08408749651825217,673,"This is a prescription to play dead and the problem resolves itself"""
1892,1321,2,11,32,45,1.3333333333333333,0.08408749651825217,673,"They're perfectly safe, I tried them myself."
2731,1321,3,8,31,42,1.3333333333333333,0.0943629946432037,673,"No, I really don't think the meds are working"
4148,1377,4,10,41,55,1.3272727272727274,0.08228449234107596,673,"Just take this Rx over to Nurse Squirrel, and she'll run it over to check out."
4254,1377,1,16,38,55,1.3272727272727274,0.06892412973427063,673,"Chinese Astrology gets us right... The Rat is  hardworking, curious, trustworthy, honest , and insightful. I'm sure you will agree!"
3364,1379,1,15,36,52,1.3269230769230769,0.07119510849574463,673,Take 1 every hour and avoid dairy. Especially cheese.
247,1380,2,12,35,49,1.3265306122448979,0.07925972923626559,673,"Despite all you rage, I am doubling your Zoloft prescription."
1938,1380,2,12,35,49,1.3265306122448979,0.07925972923626559,673,Trust me. Less than 5% of the people who take this experience side effects.
3016,1380,3,10,36,49,1.3265306122448979,0.08445380284309616,673,"This statin should help your cholesterol, but diet is still important. For me it was hardest to give up the cheese."
4460,1380,2,12,35,49,1.3265306122448979,0.07925972923626559,673,Your next appointment is with the Big Cheese.
3407,1384,3,9,34,46,1.326086956521739,0.08821552344077216,673,Take two pills in the morning with one bowl of water.
445,1384,1,13,32,46,1.326086956521739,0.07648275247512323,673,Watch out for side effects.  I should know.
2403,1384,4,7,35,46,1.326086956521739,0.09353161043630463,673,"I write prescriptions in perfectly legible script to compensate for the negative stereotypes associated with rats in medicine. Asking me about the bubonic plague is insensitive, so take your Viagra and get out of here!"
3555,1384,1,13,32,46,1.326086956521739,0.07648275247512323,673,"You don't have to be a rat to charge these prices, but it helps."
3556,1384,2,11,33,46,1.326086956521739,0.08255782822391948,673,"Trust me, I used to be like you"
3559,1384,2,11,33,46,1.326086956521739,0.08255782822391948,673,I'm going to have you try an experimental drug.
4013,1384,4,7,35,46,1.326086956521739,0.09353161043630463,673,Warfarin - all my friends use it.
3105,1391,2,10,31,43,1.3255813953488371,0.08627218916306675,673,Don't worry; pharmacists can read anything.
3071,1391,1,12,30,43,1.3255813953488371,0.07959567143329527,673,"No,  I didn't personally test it on lab rats."
2966,1391,2,10,31,43,1.3255813953488371,0.08627218916306675,673,"I’ll give you a prescription, but I’m required to warn you: it’s only been approved for use on humans; the definitive testing for rats hasn’t been completed."
2660,1391,1,12,30,43,1.3255813953488371,0.07959567143329527,673,"Naturally, we doctors test it before we offer it to our patients."
4459,1391,1,12,30,43,1.3255813953488371,0.07959567143329527,673,Take one of these when you feel trapped.
3174,1391,1,12,30,43,1.3255813953488371,0.07959567143329527,673,"This should help you focus, but there’s a few side effects."
2368,1391,3,8,32,43,1.3255813953488371,0.09246788812911673,673,What doesn’t kill you makes me stronger.
2243,1391,4,6,33,43,1.3255813953488371,0.09827375054982751,673,"Yes, I’m prescribing cheese!
Wash it down with bacon and peanut butter."
2473,1391,3,8,32,43,1.3255813953488371,0.09246788812911673,673,"' Three of us did a blind study,  and it's been proven safe and effective!'"
3207,1391,2,10,31,43,1.3255813953488371,0.08627218916306675,673,"The nutcracker gig is seasonal...anyway, take 1 tab twice a day and call me in a week if the rash doesn’t clear up."
3961,1391,1,12,30,43,1.3255813953488371,0.07959567143329527,673,"No pressure, but a lot of my best friends died so you could take this drug."
3339,1391,3,8,32,43,1.3255813953488371,0.09246788812911673,673,"Here’s your prescription, and apologies in advance, our pharmacy is a bit of a hole in the wall"
3742,1391,3,8,32,43,1.3255813953488371,0.09246788812911673,673,There’s an extra charge because your health insurance doesn’t cover fetish therapy.
3834,1391,3,8,32,43,1.3255813953488371,0.09246788812911673,673,"If I still look like a talking rat after taking these, it's you not me."
3939,1391,3,8,32,43,1.3255813953488371,0.09246788812911673,673,This prescription is one that I would give to myself if I had your symptoms.
2229,1391,2,10,31,43,1.3255813953488371,0.08627218916306675,673,"I know. New York City, right?"
4140,1391,0,14,29,43,1.3255813953488371,0.07230526397743267,673,"No, it was not tested on me first."
4317,1391,2,10,31,43,1.3255813953488371,0.08627218916306675,673,"The painkillers are for your back, but the antibiotics are for your plague."
4433,1391,1,12,30,43,1.3255813953488371,0.07959567143329527,673,I appear to have a problem with the mouse!
3217,1391,2,10,31,43,1.3255813953488371,0.08627218916306675,673,Take this and you'll feel fine testifying against him.
2222,1391,1,12,30,43,1.3255813953488371,0.07959567143329527,673,"No, tempting as it is, I will not comment on the role of my species in the current political dialogue."
2795,1391,2,10,31,43,1.3255813953488371,0.08627218916306675,673,"Nah, you definitely won’t be a guinea pig-"
1922,1391,3,8,32,43,1.3255813953488371,0.09246788812911673,673,Maybe you’ll have better luck than I did
207,1391,2,10,31,43,1.3255813953488371,0.08627218916306675,673,This prescription drug has been proven very effective in cats.
304,1391,2,10,31,43,1.3255813953488371,0.08627218916306675,673,"Look, they're safe. My cousin at Hopkins was in on the trial."
1977,1391,1,12,30,43,1.3255813953488371,0.07959567143329527,673,Cheese! You’re not eating enough cheese.”
538,1391,4,6,33,43,1.3255813953488371,0.09827375054982751,673,"Yes - Donald J. Trump, why?"
578,1391,2,10,31,43,1.3255813953488371,0.08627218916306675,673,At least you had the option to volunteer for our lab experiments.
801,1391,1,12,30,43,1.3255813953488371,0.07959567143329527,673,"I caused the plague, I never said I could cure it."
907,1391,3,8,32,43,1.3255813953488371,0.09246788812911673,673,Take this.  Speak up!  The New Yorker is expecting SOMETHING in return for me wearing this ridiculous mask
1178,1391,1,12,30,43,1.3255813953488371,0.07959567143329527,673,"Here, Larry. Let me know if  your rat-induced fear continues.'Till next week."
218,1391,3,8,32,43,1.3255813953488371,0.09246788812911673,673,I needed a high-paying career to put my four turtles through college.
1284,1391,1,12,30,43,1.3255813953488371,0.07959567143329527,673,I've personally tested all the medications I prescribe.
1382,1391,3,8,32,43,1.3255813953488371,0.09246788812911673,673,This should work it has only been tested on humans.
1395,1391,2,10,31,43,1.3255813953488371,0.08627218916306675,673,"Quick, here’s the key to the maze, many mice were lost to produce this!"""
1700,1391,5,4,34,43,1.3255813953488371,0.1037552396710672,673,Hey! ...  Hey! My eyes are up here.
1723,1391,4,6,33,43,1.3255813953488371,0.09827375054982751,673,Take this order to our staff and they will schedule your maze test.
1875,1391,3,8,32,43,1.3255813953488371,0.09246788812911673,673,"I didn't call you ""Little Red,"" I said, you are a little red."
1265,1391,3,8,32,43,1.3255813953488371,0.09246788812911673,673,Try this. We have no clue as to whether it works or not
3316,1430,1,11,28,40,1.325,0.08310867152139592,673,"I used the Canadian spelling, it will be more convenient."
3147,1430,2,9,29,40,1.325,0.0904936603531019,673,"Don't worry, I got my degree in Baltimore."
3111,1430,3,7,30,40,1.325,0.0973198532990769,673,"It may taste like rat poison, but it's very effective"
2987,1430,2,9,29,40,1.325,0.0904936603531019,673,This is no mickey mouse operation.
2976,1430,2,9,29,40,1.325,0.0904936603531019,673,I can vouch for this drug -- it got me through the maze in no time.
2944,1430,2,9,29,40,1.325,0.0904936603531019,673,"At the next full moon, take two and call me in the morning."
2903,1430,2,9,29,40,1.325,0.0904936603531019,673,"What do you mean, you can smell a rat?"
2662,1430,3,7,30,40,1.325,0.0973198532990769,673,"I usually don't make personal recommendations, but this prescription really does improve cognitive ability."
2749,1430,2,9,29,40,1.325,0.0904936603531019,673,Two of these a day should cure your hallucinations.
2718,1430,2,9,29,40,1.325,0.0904936603531019,673,And it's a much lower dose than I received in the lab.
2604,1430,2,9,29,40,1.325,0.0904936603531019,673,"""Your CATastrophic insurance should cover this"""
2510,1430,2,9,29,40,1.325,0.0904936603531019,673,"I assure you, the Rx is lactose free."
2441,1430,3,7,30,40,1.325,0.0973198532990769,673,Take two and squeak me in the morning.
3323,1430,1,11,28,40,1.325,0.08310867152139592,673,"This is my bill.  I accept Visa, Mastercard, and Cheddar!"
2414,1430,1,11,28,40,1.325,0.08310867152139592,673,"Trust me, I'm a doctor."
2794,1430,3,7,30,40,1.325,0.0973198532990769,673,Take this blood thinner and see me again in 2 weeks.
3392,1430,1,11,28,40,1.325,0.08310867152139592,673,“Scientists had great results testing this drug on my extended  family”
3894,1430,2,9,29,40,1.325,0.0904936603531019,673,"""Once more. If you want to see a doctor that's a dog, see me. 
But if your dog needs a doctor, see a vet! Got it?"""
3462,1430,2,9,29,40,1.325,0.0904936603531019,673,One of these cards holds your diagnoses. Is it this one?
222,1430,2,9,29,40,1.325,0.0904936603531019,673,One pellet three times a day.
4513,1430,1,11,28,40,1.325,0.08310867152139592,673,"It's poison to me, but it will cure your blood clot."
4456,1430,2,9,29,40,1.325,0.0904936603531019,673,"Trust me, it's cheaper than surgery, and makes picnics far more enjoyable."
4323,1430,1,11,28,40,1.325,0.08310867152139592,673,"A classic cheese deficiency.  Take one cheddar, one brie and one gouda and call me in the morning."
4259,1430,2,9,29,40,1.325,0.0904936603531019,673,"Pay this to the cashier, and come back and I will tell you what is wrong with you."
4246,1430,2,9,29,40,1.325,0.0904936603531019,673,"Limburger cheese, with meals, three times a day.  Don't eat it. Sit it on your window sill."
4238,1430,3,7,30,40,1.325,0.0973198532990769,673,"take one with meals and then cry ""WOLF""  !"
4098,1430,2,9,29,40,1.325,0.0904936603531019,673,I’m afraid it’s not looking good. Here is the number to my vet.
4048,1430,2,9,29,40,1.325,0.0904936603531019,673,Do I look like a holistic doctor?
2410,1430,2,9,29,40,1.325,0.0904936603531019,673,"This drug is still experimental, but it has been proven safe and effective with rats."
3825,1430,1,11,28,40,1.325,0.08310867152139592,673,"Here's  my card, call me if you need any more help in this rat race"
3659,1430,2,9,29,40,1.325,0.0904936603531019,673,How should I know?  It's not tested on animals.
3657,1430,2,9,29,40,1.325,0.0904936603531019,673,"In my experience, these experimental drugs are completely safe."
3578,1430,2,9,29,40,1.325,0.0904936603531019,673,"I'm ordering you a stronger cheese, this is for Limburger."
3575,1430,2,9,29,40,1.325,0.0904936603531019,673,"I simply ferret things out, here is your bill."
3444,1430,2,9,29,40,1.325,0.0904936603531019,673,Just try it. Look how much it helped me.
2320,1430,0,13,27,40,1.325,0.07500000000000002,673,"Yeah, Uncle Pizza Rat put me through med school.  Here’s his card; call him."
3126,1430,3,7,30,40,1.325,0.0973198532990769,673,"This prescription has been thoroughly tested on rats, and is now being used off-label quite extensively on many varieties of humans..."
2147,1430,1,11,28,40,1.325,0.08310867152139592,673,I'll give you the rest when you find all the piggies.
41,1430,2,9,29,40,1.325,0.0904936603531019,673,I'm prescribing you a new drug. It's experimental.
209,1430,1,11,28,40,1.325,0.08310867152139592,673,"Take cheese and call me tomorrow."""
210,1430,2,9,29,40,1.325,0.0904936603531019,673,Trust me.
258,1430,2,9,29,40,1.325,0.0904936603531019,673,"Some call it ""opioid crisis"". I call it ""Dr. Rat drives a Bentley"". Ka-ching!"
260,1430,4,5,31,40,1.325,0.10369766211542636,673,Thank you for coming to Baltimore Memorial Hospital
303,1430,3,7,30,40,1.325,0.0973198532990769,673,"This may make you very, very, very thirsty."
517,1430,3,7,30,40,1.325,0.0973198532990769,673,"Fred, get this filled. This will quickly stop your delusion of being a human."
567,1430,3,7,30,40,1.325,0.0973198532990769,673,"What did you expect; after all, I am a physician in Baltimore."
784,1430,2,9,29,40,1.325,0.0904936603531019,673,These should help you with the hallucinations.
948,1430,1,11,28,40,1.325,0.08310867152139592,673,"And not forgetting that I’m a rat, here’s an additional prescription for rabies medicine..."
1027,1430,2,9,29,40,1.325,0.0904936603531019,673,This prescription will help suppress your delusion of being a human.
1031,1430,3,7,30,40,1.325,0.0973198532990769,673,"No other doctor would give you this prescription for what you have, but I believe in experimentation."
1102,1430,1,11,28,40,1.325,0.08310867152139592,673,"Go on...try it. Trust me, it works quickly."
1388,1430,2,9,29,40,1.325,0.0904936603531019,673,Take this note to your boss. It requests that you be transferred out of Baltimore to  a less infested location.
1259,1430,1,11,28,40,1.325,0.08310867152139592,673,Here’s a prescription that will help with your hallucinations.
1843,1430,1,11,28,40,1.325,0.08310867152139592,673,"Side effects may include the urge to burrow, cravings for cheese and garbage."
1460,1430,3,7,30,40,1.325,0.0973198532990769,673,"Yes, I've read ""Stuart Little.""  Why do you ask?"
1609,1430,3,7,30,40,1.325,0.0973198532990769,673,Don't be weird with me. You're the one who bought health insurance from a Latvian robocall.
1634,1430,1,11,28,40,1.325,0.08310867152139592,673,Here's your prescription; you need more cheese.
1682,1430,1,11,28,40,1.325,0.08310867152139592,673,Take it with food - preferably rabbits.
1704,1430,2,9,29,40,1.325,0.0904936603531019,673,Trust me. This is prescription strength—not industrial strength like they give my kind.
1790,1430,3,7,30,40,1.325,0.0973198532990769,673,Take one pill in the morning.  Call me in the middle of the night if you have any problems...i’ll be up.
1835,1430,1,11,28,40,1.325,0.08310867152139592,673,Here's your prescription for stress.  Blow a house down!
1444,1430,2,9,29,40,1.325,0.0904936603531019,673,"This is a Prescription which should help take care of 
the illusions you seem to be suffering from."
1851,1430,2,9,29,40,1.325,0.0904936603531019,673,I can personally vouch for its effectiveness.
1872,1430,2,9,29,40,1.325,0.0904936603531019,673,I've got a cousin uptown if you want a second opinion.
1992,1430,1,11,28,40,1.325,0.08310867152139592,673,This should help-- I know the rat race is stressful.
2062,1430,2,9,29,40,1.325,0.0904936603531019,673,"Believe me, I had the same thing. This prescription should fix you right up."
2079,1430,1,11,28,40,1.325,0.08310867152139592,673,"When you hear this click, you will bring me cheese."
2299,1497,4,8,38,50,1.32,0.08778452283278408,673,personally the only side effect  is your true self comes out
3033,1497,3,10,37,50,1.32,0.08300479455047971,673,Take two pellets - I mean pills - and call me in the morning.
3856,1497,3,10,37,50,1.32,0.08300479455047971,673,It's not bubonic plague.  I would know.
1060,1497,3,10,37,50,1.32,0.08300479455047971,673,Take two capsules tonight and tweet the President in the morning.
3699,1497,4,8,38,50,1.32,0.08778452283278408,673,"And, just because I’ve had some complaints, here’s a prescription for plague."
316,1497,2,12,36,50,1.32,0.07793246683991917,673,This should insure that you won’t keep seeing giant rats everywhere.
3303,1497,4,8,38,50,1.32,0.08778452283278408,673,Yes!  You should take these!  You think you’re talking to a giant rat!
2132,1504,1,13,33,47,1.3191489361702127,0.07515868491008178,673,Take two a day and your man-or-mouse dilemma should resolve
403,1504,3,9,35,47,1.3191489361702127,0.0865965742845523,673,"This is a prescription for fear, I can smell it on you."
716,1504,3,9,35,47,1.3191489361702127,0.0865965742845523,673,"Why, yes . . . Johns Hopkins is in Baltimore . . . why do you ask??"
2056,1504,3,9,35,47,1.3191489361702127,0.0865965742845523,673,"Thanks for coming to our Baltimore Clinic 
The President is woefully misinformed."
3799,1504,2,11,34,47,1.3191489361702127,0.08107957386183322,673,Here is my card.  We may have a desk for you when you are ready to transition.
2420,1504,1,13,33,47,1.3191489361702127,0.07515868491008178,673,Whaddya mean ‘I smell a rat.’?
1529,1510,1,12,31,44,1.3181818181818181,0.07811689127628887,673,Try this. I rat-tested it myself.
1555,1510,4,6,34,44,1.3181818181818181,0.096298993037131,673,Give me a call if those droppings become more frequent.
2346,1510,2,10,32,44,1.3181818181818181,0.08461283091294622,673,"You guessed it, not everything that happens in Las Vegas stays in Las Vegas."
2358,1510,4,6,34,44,1.3181818181818181,0.096298993037131,673,"That's right -- Coumadin. If there was anything to worry about, I wouldn't be prescribing this to you."
2366,1510,1,12,31,44,1.3181818181818181,0.07811689127628887,673,"This is cheaper if you order it from Canada but don't worry about any side effects, I take it myself."
2615,1510,1,12,31,44,1.3181818181818181,0.07811689127628887,673,"In clinical trials, they worked for me every time."
1309,1510,3,8,33,44,1.3181818181818181,0.09064443506103459,673,Here's a prescription for anthropomorphism pills.
2994,1510,3,8,33,44,1.3181818181818181,0.09064443506103459,673,What kind of disease expert did you expect to find in Baltimore ?
3405,1510,3,8,33,44,1.3181818181818181,0.09064443506103459,673,"Side effects include nausea, fatigue, dry mouth, visual hallucinations and squeak, squeak, squeak squeak squeak."
3589,1510,3,8,33,44,1.3181818181818181,0.09064443506103459,673,"Don't worry, this medication was tested on lab humans.


Susan Elwood..Monterey CA"
3603,1510,1,12,31,44,1.3181818181818181,0.07811689127628887,673,"It’s a sketchy med, but don’t rat me out."
3605,1510,1,12,31,44,1.3181818181818181,0.07811689127628887,673,Here's the card of a good exterminator
3654,1510,3,8,33,44,1.3181818181818181,0.09064443506103459,673,It'll make you feel better. It's from the Rat Pack.
4076,1510,0,14,30,44,1.3181818181818181,0.07102933373079214,673,It’s the first new drug since the FDA adopted their accelerated testing protocol. Why do you ask?
1295,1510,2,10,32,44,1.3181818181818181,0.08461283091294622,673,"Why do you look so shocked, Steve. I'm sure I'm not the only rat in your life."
594,1510,3,8,33,44,1.3181818181818181,0.09064443506103459,673,"Take these pills.  Shit them out, and bring it back to me."
899,1510,3,8,33,44,1.3181818181818181,0.09064443506103459,673,No it’s safe now. I took them when it was still experimental.
629,1510,1,12,31,44,1.3181818181818181,0.07811689127628887,673,Stay out of Baltimore.
3804,1510,3,8,33,44,1.3181818181818181,0.09064443506103459,673,"Here!  Next time you cry Wolf, don't call me!"
502,1510,2,10,32,44,1.3181818181818181,0.08461283091294622,673,"Make sure you eat something after you take it. I recommend old pizza crusts, banana peels or old cat food."
359,1510,4,6,34,44,1.3181818181818181,0.096298993037131,673,Here... this should take the edge off the rat race existence you’ve been experiencing
301,1510,2,10,32,44,1.3181818181818181,0.08461283091294622,673,You want to win don't you?
44,1510,2,10,32,44,1.3181818181818181,0.08461283091294622,673,"Trust me, a quarter pound of Gouda should take care of that"
16,1510,3,8,33,44,1.3181818181818181,0.09064443506103459,673,"I’m a rat in doc’s clothing.  
Take two and you won’t call me in the morning."
4274,1510,3,8,33,44,1.3181818181818181,0.09064443506103459,673,Ratcliffe! Were'd you get your degree?
4316,1510,2,10,32,44,1.3181818181818181,0.08461283091294622,673,Don’t worry. It’s been tested extensively.
4439,1510,0,14,30,44,1.3181818181818181,0.07102933373079214,673,Take this to my brother in the lab. He'll test it for you.
1237,1510,1,12,31,44,1.3181818181818181,0.07811689127628887,673,It's cheddar.
3924,1510,2,10,32,44,1.3181818181818181,0.08461283091294622,673,"Side effects? Not really, although you may find yourself craving pizza on the subway."
2804,1539,3,7,31,41,1.3170731707317074,0.09524694726715431,673,"I'm going to give you this prescription, it did wonders for my sinuses."
2050,1539,2,9,30,41,1.3170731707317074,0.08861415670529244,673,I need a cat scan before I can make a diagnosis.
1549,1539,1,11,29,41,1.3170731707317074,0.08144296515640975,673,"Take this once a day, and if you keep having weird visions come back and see me."
4416,1539,2,9,30,41,1.3170731707317074,0.08861415670529244,673,Of course it’s effective. I’ve tested a vat of it.
915,1539,1,11,29,41,1.3170731707317074,0.08144296515640975,673,"I can only give you the tools, you have to do the work”"
3698,1539,3,7,31,41,1.3170731707317074,0.09524694726715431,673,It developed from 'press lever get a snack' to 'pass medical degree get a snack'
3545,1539,2,9,30,41,1.3170731707317074,0.08861415670529244,673,Do one maze in the morning and one before bed.
3762,1539,3,7,31,41,1.3170731707317074,0.09524694726715431,673,Take two in the morning and let me know if you can still see me.
3931,1539,2,9,30,41,1.3170731707317074,0.08861415670529244,673,Don’t forget to take this with trash.”
4356,1539,2,9,30,41,1.3170731707317074,0.08861415670529244,673,Some of my friends tested this. It caused some blurred vision but it did wonders for their fear of the NYC subway system.
3094,1539,2,9,30,41,1.3170731707317074,0.08861415670529244,673,Take it with more hay and less alfalfa.
878,1539,2,9,30,41,1.3170731707317074,0.08861415670529244,673,I took this stuff myself.  See how I turned out?
3544,1539,2,9,30,41,1.3170731707317074,0.08861415670529244,673,So you don't like my offer to gnaw it off? Take this and let me know if you change your mind.
468,1539,4,5,32,41,1.3170731707317074,0.10144699679553863,673,"You wouldn't believe what a rat race med school was."""
426,1539,3,7,31,41,1.3170731707317074,0.09524694726715431,673,"The good news is,you didn't have rabies BEFORE you came in."
353,1539,1,11,29,41,1.3170731707317074,0.08144296515640975,673,I'm going to refer you to a physician who specializes in moles.
493,1539,0,13,28,41,1.3170731707317074,0.07357611282438221,673,I got these free from a pharmaceutical salesperson so I know it's good stuff.
714,1556,4,11,45,60,1.3166666666666667,0.07699022854818702,673,Don't human me out.
2152,1557,2,8,28,38,1.3157894736842106,0.09319112008056446,673,"No, no, no. Last time I told you to take something for your acid reflux — NOT ""take acid for your flaccid reflex.""  No wonder you look at me and see a giant rat."
962,1557,3,6,29,38,1.3157894736842106,0.1005338747316337,673,"''You should wash them down with cheese,I recommend it.''"
1535,1557,1,10,27,38,1.3157894736842106,0.08521801309103934,673,You can fill this prescription at your local pet store.
1502,1560,3,10,38,51,1.3137254901960784,0.0816025570458228,673,Here's the card for my plastic surgeon
3783,1560,5,6,40,51,1.3137254901960784,0.0907061451468265,673,Off-brand is fine. Just don't rat me out to Pfizer.
3738,1562,2,11,35,48,1.3125,0.07965044420724436,673,"Sorry, back to the Race."
3064,1563,0,14,31,45,1.3111111111111111,0.06979205927323111,673,I can personally vouch its effectiveness
2125,1563,1,12,32,45,1.3111111111111111,0.07668789048930226,673,"Oh, and this should help with the hallucinations"
749,1563,2,10,33,45,1.3111111111111111,0.08301285176284588,673,"I know your head looks horrible now, but this medication should have it back looking like normal in no time."
1328,1563,3,8,34,45,1.3111111111111111,0.08888888888888889,673,"Warfarin, at breakfast and dinner!"""
4187,1567,2,9,31,42,1.3095238095238095,0.08680745670170772,673,Just press the lever if you want me to refill your prescription.
2191,1567,1,11,30,42,1.3095238095238095,0.07983792553159452,673,Here’s a prescription for your psychosis.
2310,1567,1,11,30,42,1.3095238095238095,0.07983792553159452,673,"It's ok, I'm a Doctor!"
2393,1567,0,13,29,42,1.3095238095238095,0.07219871305887664,673,Here’s a prescription for something that worked for me.
2465,1567,1,11,30,42,1.3095238095238095,0.07983792553159452,673,This medication is great. I use it myself.
2559,1567,2,9,31,42,1.3095238095238095,0.08680745670170772,673,Relax - it's been tested on humans.
2583,1567,2,9,31,42,1.3095238095238095,0.08680745670170772,673,"Frankly, with your health plan coverage, I am all you can afford"
2688,1567,1,11,30,42,1.3095238095238095,0.07983792553159452,673,"Yes, of course, if you want to keep your doctor, you can keep your doctor."""
3172,1567,4,5,33,42,1.3095238095238095,0.099289550863521,673,Take two and find me in your trash in the morning.
3238,1567,2,9,31,42,1.3095238095238095,0.08680745670170772,673,"You may experience some severe nose-twitching and a strong desire for cheese, but your guilt will be completely eradicated."
3497,1567,4,5,33,42,1.3095238095238095,0.099289550863521,673,"Here, this will guide you through any emotional labyrinth. And, yes, you’’ll get the cheese."
3608,1567,2,9,31,42,1.3095238095238095,0.08680745670170772,673,"Relax Mr Jones, I assure you “rat poison” is just an expression!"
3765,1567,1,11,30,42,1.3095238095238095,0.07983792553159452,673,So many animal studies! Now it is your turn.
3831,1567,1,11,30,42,1.3095238095238095,0.07983792553159452,673,Cut down cheeses and run more mazes.
4150,1567,1,11,30,42,1.3095238095238095,0.07983792553159452,673,"This won't get you out of the maze, but it should help with the dizziness."
4444,1567,2,9,31,42,1.3095238095238095,0.08680745670170772,673,"Here's your prescription for ""Rat""talin, that should calm you down."
4400,1567,2,9,31,42,1.3095238095238095,0.08680745670170772,673,"This is a wireless shocker, Dr. Skinner."
2032,1567,1,11,30,42,1.3095238095238095,0.07983792553159452,673,‘’ You may acquire a taste for extension cords.’’
4256,1567,2,9,31,42,1.3095238095238095,0.08680745670170772,673,Have you ever been a subject of medical  research ?
4221,1567,1,11,30,42,1.3095238095238095,0.07983792553159452,673,"And Above all, NO dairy!  That's a trap."
4173,1567,1,11,30,42,1.3095238095238095,0.07983792553159452,673,"""Prepare to be a-mazed"""
1909,1567,2,9,31,42,1.3095238095238095,0.08680745670170772,673,Do I have something on my face?
1783,1567,3,7,32,42,1.3095238095238095,0.09325757194377995,673,Why would i try to poison you?
1856,1567,3,7,32,42,1.3095238095238095,0.09325757194377995,673,In rare but serious cases patients have turned into rodents.
624,1567,1,11,30,42,1.3095238095238095,0.07983792553159452,673,"It's for Warfarin, a blood thinner also used as rat poison. Here's a taste of your own medicine."
389,1567,1,11,30,42,1.3095238095238095,0.07983792553159452,673,Take these twice a day for a week and you'll soon have your bark back!
1867,1567,2,9,31,42,1.3095238095238095,0.08680745670170772,673,Take this until you find yourself chewing on baseboards.
129,1567,3,7,32,42,1.3095238095238095,0.09325757194377995,673,"Don't worry, it won't bite you."
170,1567,1,11,30,42,1.3095238095238095,0.07983792553159452,673,I assure you it's fine. Several of my colleagues were involved in the clinical trials.
200,1567,3,7,32,42,1.3095238095238095,0.09325757194377995,673,I wanted to be a chef but my parents told me to be practical.
782,1567,4,5,33,42,1.3095238095238095,0.099289550863521,673,"Perhaps you'd feel more comfortable talking to one of my colleagues. Here are the numbers for Drs. Wolf, Dr. Fox and Dr. Bird"
913,1567,2,9,31,42,1.3095238095238095,0.08680745670170772,673,They accept pizza.
80,1567,2,9,31,42,1.3095238095238095,0.08680745670170772,673,Welcome to Philadelphia.
1219,1567,3,7,32,42,1.3095238095238095,0.09325757194377995,673,It's for motion sickness. You'll want to leave the ship only if it's starting to sink.
1323,1567,3,7,32,42,1.3095238095238095,0.09325757194377995,673,This should take care of your pest problem.
1491,1567,1,11,30,42,1.3095238095238095,0.07983792553159452,673,"...and speaking from personal experience, at this dosage it will really boost your maze game."
1596,1567,3,7,32,42,1.3095238095238095,0.09325757194377995,673,We have exactly the same eyes.
1600,1567,0,13,29,42,1.3095238095238095,0.07219871305887664,673,These anticoagulants should help with the paranoia and hallucinations.
1770,1567,3,7,32,42,1.3095238095238095,0.09325757194377995,673,That’ll get you right back in the rat race.
1088,1567,2,9,31,42,1.3095238095238095,0.08680745670170772,673,The only side effect is a fondness for cheese.
1830,1607,3,6,30,39,1.3076923076923077,0.09825636517823155,673,"I would say take these and come back to see me, but you won't see me."
2039,1607,3,6,30,39,1.3076923076923077,0.09825636517823155,673,"Rat-bite fever. Here's a referral and, again, I'm sorry."
1430,1607,5,2,32,39,1.3076923076923077,0.11114570899801877,673,"PROTEST! My 7/29 edition arrived today,7/30, with the mastodon cartoon and a deadline for entry of 7/28!!  Are print readers automatically now excluded from the competition? I have noticed the very tight deadlines before, but this MUST be a mistake!"
2326,1607,0,12,27,39,1.3076923076923077,0.07487142513727502,673,Don't believe what you hear. Rats are NOT everywhere in Baltimore!
2632,1607,0,12,27,39,1.3076923076923077,0.07487142513727502,673,This is your warfarin prescription. I wouldn't touch it myself.
3021,1607,2,8,29,39,1.3076923076923077,0.0911305965783219,673,Try Viagra.Works great. I've had sex with 84 partners since Tuesday.
3972,1607,3,6,30,39,1.3076923076923077,0.09825636517823155,673,"""You don't look like you're hallucinating."""
4505,1607,0,12,27,39,1.3076923076923077,0.07487142513727502,673,Of course these work. Mickey takes 2 a day and look how young he looks.
3830,1607,1,10,28,39,1.3076923076923077,0.08339818923336235,673,You can always get a second opinion from Dr. Wolf if you’d like.
3717,1607,2,8,29,39,1.3076923076923077,0.0911305965783219,673,This prescription is entirely safe—I tested it myself.
3212,1607,3,6,30,39,1.3076923076923077,0.09825636517823155,673,It will make you a new man.
3121,1607,3,6,30,39,1.3076923076923077,0.09825636517823155,673,Take one each morning for the hallucinations.
3078,1607,2,8,29,39,1.3076923076923077,0.0911305965783219,673,"Take my card, I won't bite you"
1307,1607,0,12,27,39,1.3076923076923077,0.07487142513727502,673,What am I? Do YOU know what I am?! Please! I need to know!
2298,1607,2,8,29,39,1.3076923076923077,0.0911305965783219,673,Trust me.  That whole 'eating grandma thing' is just a fairy tale.
904,1607,2,8,29,39,1.3076923076923077,0.0911305965783219,673,Just because I'm not human means I should charge you less?
2236,1607,2,8,29,39,1.3076923076923077,0.0911305965783219,673,I'm sorry. We haven't made it to human testing yet...
1232,1607,1,10,28,39,1.3076923076923077,0.08339818923336235,673,"Side effects? Yes, you may experience a sudden urge to naw
as well as an occasional cheese craving."
240,1607,3,6,30,39,1.3076923076923077,0.09825636517823155,673,It's Fantastic Dr. Fox these days.
283,1607,2,8,29,39,1.3076923076923077,0.0911305965783219,673,We cause preexisting conditions.
186,1607,1,10,28,39,1.3076923076923077,0.08339818923336235,673,Why do you ask about side effects?
744,1607,3,6,30,39,1.3076923076923077,0.09825636517823155,673,"If you like your rat, you can keep your rat."
758,1607,1,10,28,39,1.3076923076923077,0.08339818923336235,673,"Yes there are lots of mazes to solve and hoops to jump through for Med school, luckily I came well prepared."
854,1607,3,6,30,39,1.3076923076923077,0.09825636517823155,673,You look like you’ve never watched Arthur
896,1607,2,8,29,39,1.3076923076923077,0.0911305965783219,673,My cousin is stuck in your what?
365,1607,3,6,30,39,1.3076923076923077,0.09825636517823155,673,The bad news is you’ll instantly transform into a rat. The good news is your body will finally be able to digest all the garbage you eat.
4053,1633,2,7,27,36,1.3055555555555556,0.09611042297212133,673,"Be honest with me, this place is crawling with rats."
3329,1633,2,7,27,36,1.3055555555555556,0.09611042297212133,673,"You're right. I'm a large rat. I'm also your doctor. If you don't like it, get another health care plan."
2698,1633,1,9,26,36,1.3055555555555556,0.0874637743101593,673,"This is for the delusional mirages, but you still need to see an optician..."
2677,1633,0,11,25,36,1.3055555555555556,0.07786276535852611,673,I’ve tried it. You’ll see a change after about a week.
2521,1633,3,5,28,36,1.3055555555555556,0.10404092940368062,673,"Take two pills daily, then call your exterminator about the rats."
1772,1633,1,9,26,36,1.3055555555555556,0.0874637743101593,673,Just because you have the Plague doesn't mean I'm the best doctor for the job.
1289,1633,0,11,25,36,1.3055555555555556,0.07786276535852611,673,"As long as you take these pills, at least your brain stays human. Trust me, I would know."
1648,1633,2,7,27,36,1.3055555555555556,0.09611042297212133,673,"Call my friend at Terminix, he can get you your Warfarin cheap."
603,1633,0,11,25,36,1.3055555555555556,0.07786276535852611,673,I was part of the trials so I can say with authority it works.
533,1633,2,7,27,36,1.3055555555555556,0.09611042297212133,673,My advice? Eat more garbage. If that doesn't do the trick I suggest a strict diet of cheese.
239,1633,2,7,27,36,1.3055555555555556,0.09611042297212133,673,The bubonic plague vaccine is completely safe. I should know.
986,1633,3,5,28,36,1.3055555555555556,0.10404092940368062,673,So in a parallel universe doctor dog is your vet
2052,1633,0,11,25,36,1.3055555555555556,0.07786276535852611,673,"Yes, it has been tested in rats."
832,1633,3,5,28,36,1.3055555555555556,0.10404092940368062,673,I may be a Dirty Rat but I still expect to get paid promptly!
2345,1647,4,5,34,43,1.302325581395349,0.0972198460849993,673,Call any time for a rat's ass probe.
2363,1647,0,13,30,43,1.302325581395349,0.0708662093279121,673,I did my undergrad infestation at NYU and then went to Columbia.
2472,1647,1,11,31,43,1.302325581395349,0.07829073595629517,673,Eat more cheese.
2695,1647,3,7,33,43,1.302325581395349,0.09134702381971774,673,What’s there not to trust?
2817,1647,3,7,33,43,1.302325581395349,0.09134702381971774,673,"No worries. My wife says this prescription changed her life."""
2883,1647,1,11,31,43,1.302325581395349,0.07829073595629517,673,I have a policy of not prescribing any medication tested on animals.
3049,1647,3,7,33,43,1.302325581395349,0.09134702381971774,673,Take two subway pizza slices and see me in the morning.”
3287,1647,1,11,31,43,1.302325581395349,0.07829073595629517,673,Take this and call me in a week if you still smell a rat.
3191,1647,1,11,31,43,1.302325581395349,0.07829073595629517,673,It's still an experimental drug but it's been rat tested.
3538,1647,1,11,31,43,1.302325581395349,0.07829073595629517,673,I'm a Johns Hopkins rat.  I know stuff.
4081,1647,2,9,32,43,1.302325581395349,0.08506973050767944,673,"It took some doing, but we finally found out who moved your cheese."
4402,1647,3,7,33,43,1.302325581395349,0.09134702381971774,673,Take this and you’ll be back dumpster diving in no time.
4300,1647,4,5,34,43,1.302325581395349,0.0972198460849993,673,"This card you will get you in to see the squirrel docs. If you want to see me, I need to see the cash up front."
4115,1647,3,7,33,43,1.302325581395349,0.09134702381971774,673,"Trust me, I was experimented on it myself"
3103,1647,1,11,31,43,1.302325581395349,0.07829073595629517,673,What did you expect when you made an appointment with Dr. Rat?
2250,1647,3,7,33,43,1.302325581395349,0.09134702381971774,673,"A few side effects,  but I take it myself."
1818,1647,2,9,32,43,1.302325581395349,0.08506973050767944,673,"Oh, and welcome to Baltimore."
1631,1647,1,11,31,43,1.302325581395349,0.07829073595629517,673,I'm referring you to our husbandry specialist.
1446,1647,3,7,33,43,1.302325581395349,0.09134702381971774,673,A Dr. Rat is just as impressive as an M.D.
1335,1647,4,5,34,43,1.302325581395349,0.0972198460849993,673,"Take with a couple voles, and you'll be right as rain."
1326,1647,2,9,32,43,1.302325581395349,0.08506973050767944,673,Gnaw on these twice before bed.
1924,1647,1,11,31,43,1.302325581395349,0.07829073595629517,673,"Don't worry, the side effect is only temporary."
1264,1647,2,9,32,43,1.302325581395349,0.08506973050767944,673,You can trust me.  I've eaten garbage from both Harvard and Yale.
1055,1647,1,11,31,43,1.302325581395349,0.07829073595629517,673,I suggest you take this to a pet friendly drug store.
718,1647,2,9,32,43,1.302325581395349,0.08506973050767944,673,"From one rat to another rat, take one."
687,1647,1,11,31,43,1.302325581395349,0.07829073595629517,673,Side effects may include a burning desire for cheese.
616,1647,3,7,33,43,1.302325581395349,0.09134702381971774,673,Here is your Prescription. I know you take the #6 subway. Stop at 14th and pick it up at the end of the platform.
528,1647,3,7,33,43,1.302325581395349,0.09134702381971774,673,"Prepaying before I start your exam 
is relaxing for me."
500,1647,2,9,32,43,1.302325581395349,0.08506973050767944,673,"You'll be fine. It's not rat poison, you know!"
158,1647,3,7,33,43,1.302325581395349,0.09134702381971774,673,"I'm sorry sir, but ""I smell a rat"" is not a medical symptom that we diagnose here."
3416,1677,3,10,40,53,1.3018867924528301,0.07893019118245996,673,"It really is nice having the fur,especially in the winter months,and the heightened ability to smell comes in handy quite often."
1459,1677,4,8,41,53,1.3018867924528301,0.08340062640672652,673,"Your hypertension is fine, but you do have the plague."
4273,1677,1,14,38,53,1.3018867924528301,0.06912739160586275,673,Take these and you will be scampering everywhere! Only problem - you leave little pellets all over the house.
4345,1680,4,4,32,40,1.3,0.10253204627247287,673,Tell the New Yorker editors that the caption contest finalists are not available on the iPad app.
2933,1680,1,10,29,40,1.3,0.08164965809277262,673,I've been taking this for years with no side effects whatsoever.
3003,1680,3,6,31,40,1.3,0.0960768922830523,673,What's wrong? You look like there's something wrong.
3041,1680,2,8,30,40,1.3,0.0891555828241729,673,I've tried it many times myself.
3205,1680,1,10,29,40,1.3,0.08164965809277262,673,"You don’t believe me? Well, pick a card, any card!"
3218,1680,2,8,30,40,1.3,0.0891555828241729,673,It's a contemporary take on a plague mask.
3278,1680,0,12,28,40,1.3,0.0733799385705343,673,"I know you'll miss Dr. Grant, but the hospital insisted on diversity in the staff"
3346,1680,1,10,29,40,1.3,0.08164965809277262,673,Are you experiencing any side effects?
3373,1680,3,9,38,50,1.3,0.08206518066482898,673,We’ve had  good results and are excited about starting animal trials soon.
4324,1680,3,6,31,40,1.3,0.0960768922830523,673,Stop taking the PCP.  Take this prescription for Oxycodone instead.
4015,1680,1,10,29,40,1.3,0.08164965809277262,673,Sheep’s clothing is so last millennium.
3510,1680,2,8,30,40,1.3,0.0891555828241729,673,Don't let the jacket and tie fool ya. I know what I'm talkin' about!
3533,1680,1,10,29,40,1.3,0.08164965809277262,673,"Take these, they helped me out many times when I felt trapped."
3591,1680,2,8,30,40,1.3,0.0891555828241729,673,"Oh, and I forgot to prescribe you something for the hallucinations that might be a side effect of the new medication regiment you started last month."
3634,1680,2,8,30,40,1.3,0.0891555828241729,673,Substitute soy based cheese for dairy. I find it gives less gastric upset.
3877,1680,2,8,30,40,1.3,0.0891555828241729,673,Possible career path for test rats.
3885,1680,0,12,28,40,1.3,0.0733799385705343,673,And I know this is safe.  I was involved in the tests.
2894,1680,1,10,29,40,1.3,0.08164965809277262,673,You need to join the Teamsters.
4550,1680,1,10,29,40,1.3,0.08164965809277262,673,Take one twice a day for a week and your visions of human-like rats should disappear.
3421,1680,1,10,29,40,1.3,0.08164965809277262,673,"I assure you, the results in the mice studies have been very satisfying."
2870,1680,1,10,29,40,1.3,0.08164965809277262,673,"If this improves your sense of smell, so be it."
3383,1680,0,12,28,40,1.3,0.0733799385705343,673,You'll notice a difference after two and a half squeaks.
2528,1680,2,8,30,40,1.3,0.0891555828241729,673,Side effects? Good question. Wish I'd thought of that.
2742,1680,1,10,29,40,1.3,0.08164965809277262,673,Your cholesterol is too high. Lay off the cheese.
68,1680,3,6,31,40,1.3,0.0960768922830523,673,I specialize in infectious diseases.
419,1680,1,10,29,40,1.3,0.08164965809277262,673,I'm quite certain it's Tuberculosis. Have this filled as soon as possible.
680,1680,2,8,30,40,1.3,0.0891555828241729,673,it's not how you see me it's how you see you
933,1680,0,12,28,40,1.3,0.0733799385705343,673,"I've been taking the generic version D-Con for most of my life, in low dose it's verry safe."
1023,1680,0,12,28,40,1.3,0.0733799385705343,673,As to side effects? My colleagues and I have thoroughly tested this.
1173,1680,1,10,29,40,1.3,0.08164965809277262,673,Here you can buy the same mouse costume.
1293,1680,3,6,31,40,1.3,0.0960768922830523,673,You need to move to the country and stop watching Fox News.
786,1680,2,8,30,40,1.3,0.0891555828241729,673,"Yes, no questions asked."
1386,1680,2,8,30,40,1.3,0.0891555828241729,673,Did you just call me a rat?  Do you think I'm the only psychiatrist that doesn't take insurance?
1490,1680,1,10,29,40,1.3,0.08164965809277262,673,Relax. It was tested on me.
1542,1680,2,8,30,40,1.3,0.0891555828241729,673,Eat some cheese and call me in the morning.
1796,1680,3,6,31,40,1.3,0.0960768922830523,673,"Avoid dairy products when taking these, especially cheese."
2319,1680,1,10,29,40,1.3,0.08164965809277262,673,"try cutting out the midnight trips to the bodega, okay?"
2331,1680,1,10,29,40,1.3,0.08164965809277262,673,I'm prescribing aged cheddar. If that doesn't work we'll try gruyere.
2485,1680,0,12,28,40,1.3,0.0733799385705343,673,Side effects may include huffing and puffing and hallucinations about farm animals
2502,1680,2,8,30,40,1.3,0.0891555828241729,673,"Thank you for your application to the Diversity Board, but we already have a human. Might I suggest the dog park? Here's the chihuahua's contact info."
1340,1680,1,10,29,40,1.3,0.08164965809277262,673,I went to Johns Hopkins. Why do you ask?
2932,1721,3,8,36,47,1.297872340425532,0.08556766756593656,673,"When you take these pellets, you may become thirsty and very tired."
2430,1722,1,9,27,37,1.2972972972972974,0.08546696378833456,673,The side effects ARE the perks.
2337,1722,2,7,28,37,1.2972972972972974,0.09384084079279124,673,Give this slip at the counter of the Human Trials room.
4445,1722,1,9,27,37,1.2972972972972974,0.08546696378833456,673,I was part of the trial and I'm almost back to normal.
1651,1722,2,7,28,37,1.2972972972972974,0.09384084079279124,673,Of course it's safe. It was tested on me and all of my thousands of relatives.
1786,1722,2,7,28,37,1.2972972972972974,0.09384084079279124,673,The good news is that you have nothing serious.  The bad news is that I’m about to eat you.
1754,1722,2,7,28,37,1.2972972972972974,0.09384084079279124,673,"No, I'm NOT from Baltimore !"
2467,1722,2,7,28,37,1.2972972972972974,0.09384084079279124,673,"Don’t worry, the pharmacy will know it’s viagra."
1792,1722,2,7,28,37,1.2972972972972974,0.09384084079279124,673,"Don’t worry, we just need to run a few tests."
2732,1722,2,7,28,37,1.2972972972972974,0.09384084079279124,673,Trust me. I've taken these myself.
3998,1722,1,9,27,37,1.2972972972972974,0.08546696378833456,673,"Of course, no humans were harmed in the testing of this product."
2985,1722,3,5,29,37,1.2972972972972974,0.10152637540166345,673,Oy vey
3180,1722,3,5,29,37,1.2972972972972974,0.10152637540166345,673,Who did you expect to see given you made an appointment with Dr. Wolf?
3258,1722,3,5,29,37,1.2972972972972974,0.10152637540166345,673,All you know is that I'm from Baltimore.
3337,1722,3,5,29,37,1.2972972972972974,0.10152637540166345,673,I’ve tried it. It’s perfectly fine.
3374,1722,2,7,28,37,1.2972972972972974,0.09384084079279124,673,"You are correct,I do play a doctor on TV"
3423,1722,1,9,27,37,1.2972972972972974,0.08546696378833456,673,"I couldn't give a rat's ass about the side effects.

David A. Bader - New York, NY"
3851,1722,3,5,29,37,1.2972972972972974,0.10152637540166345,673,Two pounds of Gruyère and call me in the morning.
1568,1722,1,9,27,37,1.2972972972972974,0.08546696378833456,673,Get this filled at the nearest dumpster.
4000,1722,2,7,28,37,1.2972972972972974,0.09384084079279124,673,"As you can see, your snout is already coming in, but the fur will take a few more weeks."
2845,1722,2,7,28,37,1.2972972972972974,0.09384084079279124,673,Seeing things? What kind of things?
1558,1722,2,7,28,37,1.2972972972972974,0.09384084079279124,673,Why does everyone assume I’m going to rat them out?
697,1722,1,9,27,37,1.2972972972972974,0.08546696378833456,673,"Trust me, the side effects are overblown.  I take it myself."
1315,1722,2,7,28,37,1.2972972972972974,0.09384084079279124,673,"The Gouda's generic; the Brie, domestic."
4517,1722,1,9,27,37,1.2972972972972974,0.08546696378833456,673,"No vultures in this law firm, believe me!"
29,1722,1,9,27,37,1.2972972972972974,0.08546696378833456,673,"“It’s over-the-counter, but I found a few under it.”"
231,1722,2,7,28,37,1.2972972972972974,0.09384084079279124,673,"No, I don't do online prescriptions...I guess that makes me weird."
348,1722,1,9,27,37,1.2972972972972974,0.08546696378833456,673,"These, with a tumbler of good scotch, should stop the hallucinations."
351,1722,1,9,27,37,1.2972972972972974,0.08546696378833456,673,Here's your  prescription. Take one a day with food - preferably garbage.
352,1722,1,9,27,37,1.2972972972972974,0.08546696378833456,673,"Listen, Frank, I know it's not ""evidence based,"" but I can't tell you how many of  my patients have felt better after eating garbage!"
1467,1722,1,9,27,37,1.2972972972972974,0.08546696378833456,673,"You're going to be just fine, Mr. Piper.  Have this filled at the dumpster in the alley to your left."
418,1722,2,7,28,37,1.2972972972972974,0.09384084079279124,673,I'm sorry your lab tests were lost.  It's a maze down there!
414,1722,1,9,27,37,1.2972972972972974,0.08546696378833456,673,Take this with a little cheese and call me if you feel the urge to swim through the sewer line.
4055,1722,2,7,28,37,1.2972972972972974,0.09384084079279124,673,I take the same medication and my sense of smell returned immediately.
715,1722,1,9,27,37,1.2972972972972974,0.08546696378833456,673,"Here, this prescription should rejuvenate your anemic nose whiskers."
790,1722,2,7,28,37,1.2972972972972974,0.09384084079279124,673,So you think you're the Pied Piper; and you see what when you look at me?
799,1722,1,9,27,37,1.2972972972972974,0.08546696378833456,673,'Infested' . . . you say that like it's a bad thing.
859,1722,1,9,27,37,1.2972972972972974,0.08546696378833456,673,I recommend you take this drug with a piece of cheese.
4471,1722,1,9,27,37,1.2972972972972974,0.08546696378833456,673,I recommend you get plastic surgery as soon as possible
1170,1722,0,11,26,37,1.2972972972972974,0.07617808344724217,673,We take security here very seriously.
1244,1722,1,9,27,37,1.2972972972972974,0.08546696378833456,673,"Here ya go! Now, where's the cheese?"
469,1722,1,9,27,37,1.2972972972972974,0.08546696378833456,673,"Trust me, this stuff is quality."
4418,1722,1,9,27,37,1.2972972972972974,0.08546696378833456,673,"I hope I'm not being too forward, but call me maybe."
2948,1764,3,10,41,54,1.2962962962962963,0.07765622260704179,673,"You might not have, but if you did pick up a touch of bubonic plague during the exam, this'll help dull the pain."
2711,1765,2,9,33,44,1.2954545454545454,0.08339737432901621,673,There are claimed to be more than 70 documented cases of transplant patients taking on aspects of their donors. Some are more cheery than others.
4080,1765,1,11,32,44,1.2954545454545454,0.07679869525286717,673,"You won't win the race, but you won't care."
4261,1765,2,9,33,44,1.2954545454545454,0.08339737432901621,673,Sorry your card was declined but do you have any food pellets on you?
959,1765,1,11,32,44,1.2954545454545454,0.07679869525286717,673,"Yes, I once infested Baltimore, like Trump now infests the White House."
4111,1769,1,8,25,34,1.2941176470588236,0.089854425391291,673,Take this and then I'll look like a pig and you can get on with your life.
3953,1769,2,6,26,34,1.2941176470588236,0.09927914663561015,673,Studies are now finding health benefits from small regular doses of plague.
3789,1769,0,10,24,34,1.2941176470588236,0.0793176308780285,673,"I know it can be hard in social situations, but try to avoid eating cheese while on this medication."
2940,1769,2,11,38,51,1.2941176470588236,0.07563647655680751,673,"Take these three times a day, and your face will become more interesting."
2554,1769,1,8,25,34,1.2941176470588236,0.089854425391291,673,"As your health  professional.
This drug has no side affecf are no side effects  for you to be concerned about."
2276,1769,2,6,26,34,1.2941176470588236,0.09927914663561015,673,"Remember during open enrollment, you chose Plan B?"
2202,1769,0,10,24,34,1.2941176470588236,0.0793176308780285,673,Don't worry. This is a lighter dose.
2415,1769,0,10,24,34,1.2941176470588236,0.0793176308780285,673,Take two aspirin and bring me a piece of cheese in the morning.
871,1769,1,8,25,34,1.2941176470588236,0.089854425391291,673,"Look, I've tested it myself."
417,1769,1,8,25,34,1.2941176470588236,0.089854425391291,673,"Try these tables, they changed my life."
1721,1769,2,6,26,34,1.2941176470588236,0.09927914663561015,673,"Take two at bedtime, and I will eat you in the morning."
1814,1780,0,12,29,41,1.2926829268292683,0.0719408839207445,673,"""The mozzarella didn't seem to work, so I'm changing your prescription to cheddar"""
3009,1780,2,8,31,41,1.2926829268292683,0.08726118936584544,673,"Ok, ok, last time I swear....is this your prescription?"
3629,1780,3,6,32,41,1.2926829268292683,0.09398950667315947,673,"Here’s your ticket to the rat race, pal."
3680,1780,2,8,31,41,1.2926829268292683,0.08726118936584544,673,You can get this prescription filled at any pet shop.
3700,1780,2,8,31,41,1.2926829268292683,0.08726118936584544,673,"He also is a vet, but he accepts Medicare."
3760,1780,2,8,31,41,1.2926829268292683,0.08726118936584544,673,"Yes, it was Aardvark getting a PHD. Anyway, here’s my card."
2579,1780,3,6,32,41,1.2926829268292683,0.09398950667315947,673,No it's not a mask
2387,1780,2,8,31,41,1.2926829268292683,0.08726118936584544,673,"'No need to worry about side effects Mr Wilson. I've been taking them for years. Theres nothing wrong with me now, is there?'"
2104,1780,2,8,31,41,1.2926829268292683,0.08726118936584544,673,Trust me on this--I test everything I prescribe.
2083,1780,3,6,32,41,1.2926829268292683,0.09398950667315947,673,"Listen, I have a nose for this kind of thing."
1801,1780,1,10,30,41,1.2926829268292683,0.0799687624914878,673,Who better to help you navigate the rat race then a rat?
1049,1780,1,10,30,41,1.2926829268292683,0.0799687624914878,673,"My, what awfully big eyes you have. There’s a pill for that."
1488,1780,1,10,30,41,1.2926829268292683,0.0799687624914878,673,Relax. I worked my way up from the Maze department.
1423,1780,2,8,31,41,1.2926829268292683,0.08726118936584544,673,"Yes, my parents are big Disney fans, just ask my sister Minnie."
1290,1780,1,10,30,41,1.2926829268292683,0.0799687624914878,673,"Two pills once a month, when the moon is full"
4204,1780,2,8,31,41,1.2926829268292683,0.08726118936584544,673,"Of course, it works.  I've had this treatment several times."
3835,1780,3,6,32,41,1.2926829268292683,0.09398950667315947,673,Take one pill before bed and stop watching the Democratic debates.
4412,1780,3,6,32,41,1.2926829268292683,0.09398950667315947,673,This prescription will take care of everything that ails you...except overgrown nose hairs.
1708,1780,1,10,30,41,1.2926829268292683,0.0799687624914878,673,I'd like to try a little experiment.
4154,1780,1,10,30,41,1.2926829268292683,0.0799687624914878,673,Bill - cholesterol reduction is important but you're clearly missing my point about personal grooming . . .
146,1800,1,7,23,31,1.2903225806451613,0.09496517060567579,673,I can vouch for this drug.
843,1800,0,9,22,31,1.2903225806451613,0.08287246824945246,673,My brother tested it. It's safe.
1000,1800,1,7,23,31,1.2903225806451613,0.09496517060567579,673,Woof! Woof!
1470,1800,1,7,23,31,1.2903225806451613,0.09496517060567579,673,"Take two a day, and you'll be back in the rat-race before you know it!"
111,1800,1,7,23,31,1.2903225806451613,0.09496517060567579,673,"Don’t worry, I’ve tested it myself."
3852,1805,2,7,29,38,1.2894736842105263,0.09167242331299509,673,"It's just that, from my perspective, having three years to live is quite remarkable indeed."
1590,1805,1,9,28,38,1.2894736842105263,0.08355452165736653,673,Experimental drugs have really come a long way.
1699,1805,1,9,28,38,1.2894736842105263,0.08355452165736653,673,I've been taking it since I was a young lab rat. It got me through med school.
2041,1805,1,9,28,38,1.2894736842105263,0.08355452165736653,673,"This is a prescription for rat poison, should the tests show you have a terminal disease."
2242,1805,3,5,30,38,1.2894736842105263,0.0991277373027479,673,"Yes, several of us got through Med school in Baltimore, why do you ask?"
2340,1805,3,5,30,38,1.2894736842105263,0.0991277373027479,673,"My buddy didn't make it out of the maze on this stuff, but I did, and now look at me! I'm a doctor! Seriously try it out."
2470,1805,2,7,29,38,1.2894736842105263,0.09167242331299509,673,It's called OxyCamembert.  It won't hurt you.
2609,1805,1,9,28,38,1.2894736842105263,0.08355452165736653,673,Sure it's safe. I've taken it and havn't noticed any side affects.
2759,1805,1,9,28,38,1.2894736842105263,0.08355452165736653,673,"Try it,  it worked for me."
3327,1805,1,9,28,38,1.2894736842105263,0.08355452165736653,673,You seem a little edgy. I want you to start taking these.
3426,1805,1,9,28,38,1.2894736842105263,0.08355452165736653,673,Remember to pay at the front desk as you leave.
3455,1805,2,7,29,38,1.2894736842105263,0.09167242331299509,673,This prescription will help you be comfortable with the fact that I'm really a rat in doctor's clothing!
3476,1805,1,9,28,38,1.2894736842105263,0.08355452165736653,673,I need to warn you that this has only been tested on doctors.
3486,1805,3,5,30,38,1.2894736842105263,0.0991277373027479,673,Humans don't qualify for the clinical trial so I wrote here that you're a rat
3488,1805,0,11,27,38,1.2894736842105263,0.07455791696866067,673,Let me recommend a specialist. He’s a chimp who has had the procedure himself.
3495,1805,2,7,29,38,1.2894736842105263,0.09167242331299509,673,Most folks refer to this as Vitamin Z
3551,1805,1,9,28,38,1.2894736842105263,0.08355452165736653,673,It's been well tested by my family
3630,1805,2,7,29,38,1.2894736842105263,0.09167242331299509,673,"Take two of these three times a day with cheese, and I'm referring you to an ophthalmologist."
1442,1805,3,5,30,38,1.2894736842105263,0.0991277373027479,673,"1500mg warfarin, twice a day with water. You won't need to see me again."
4037,1805,1,9,28,38,1.2894736842105263,0.08355452165736653,673,Eat this and call me in the morning.
1415,1805,2,7,29,38,1.2894736842105263,0.09167242331299509,673,This psychologist will help you with your hallucinations.
1084,1805,2,7,29,38,1.2894736842105263,0.09167242331299509,673,"I know these work, I was one of the first test subjects."
1318,1805,2,7,29,38,1.2894736842105263,0.09167242331299509,673,You have fifteen years to pay off today’s visit.
38,1805,3,5,30,38,1.2894736842105263,0.0991277373027479,673,This did wonders for my cheddar allergy.
39,1805,1,9,28,38,1.2894736842105263,0.08355452165736653,673,"Don't worry, it's safe. I tested it on myself first."
63,1805,1,9,28,38,1.2894736842105263,0.08355452165736653,673,I didn't fell like shaving this morning.
1119,1805,1,9,28,38,1.2894736842105263,0.08355452165736653,673,"Don't worry, my Aunt tested this one personally."
203,1805,1,9,28,38,1.2894736842105263,0.08355452165736653,673,Why would you think you'd get hooked on these?
173,1805,1,9,28,38,1.2894736842105263,0.08355452165736653,673,"Yes, I'm a Bandicoot, not a rat. Did my Australian accent gave it away?"
319,1805,2,7,29,38,1.2894736842105263,0.09167242331299509,673,Please do not call me a rat. I'm a quack.
3999,1805,1,9,28,38,1.2894736842105263,0.08355452165736653,673,Two daily should keep you off the couch.
383,1805,2,7,29,38,1.2894736842105263,0.09167242331299509,673,"If you're not happy with our services, my brother is a lawyer"
587,1805,2,7,29,38,1.2894736842105263,0.09167242331299509,673,Do what the Fox says.
649,1805,3,5,30,38,1.2894736842105263,0.0991277373027479,673,I personally got your lab results.
1008,1805,1,9,28,38,1.2894736842105263,0.08355452165736653,673,Hide them in your food and you probably won't notice.
282,1805,1,9,28,38,1.2894736842105263,0.08355452165736653,673,Side effects include an aversion to light and an intense craving for garbage.
3977,1805,2,7,29,38,1.2894736842105263,0.09167242331299509,673,Supposed side effect of cheese cravings? That is based on faulty vegan-based research.
1735,1842,2,9,34,45,1.288888888888889,0.08178699991918043,673,"Your poison, Mr. Bolton, this should cure world peace."
2807,1842,1,11,33,45,1.288888888888889,0.07535922203472518,673,"When Cagney said “Your dirty rat”, he was not referring to me. OK?"
3358,1842,3,7,35,45,1.288888888888889,0.08774516719387473,673,Nibble on two apples and call me in the morning.
1020,1842,2,9,34,45,1.288888888888889,0.08178699991918043,673,What's wrong?  You're acting squirrelly.
1503,1846,1,13,38,52,1.2884615384615385,0.06912804512336526,673,"Relax, It's for your wife."
3810,1847,2,6,27,35,1.2857142857142858,0.09676644820493972,673,This'll get you into the henhouse.
2347,1847,3,8,38,49,1.2857142857142858,0.08247860988423225,673,What did you expect in Baltimore?
2428,1847,1,10,31,42,1.2857142857142858,0.0783520324066106,673,"If you’re feeling a little mousy, you can take this, but it might make you feel a little squirrelly."
2565,1847,0,10,25,35,1.2857142857142858,0.07747516350666293,673,This new medication is reported to have a few fairly mild side affects; I've been on it myself for about a month now and haven't personally noticed any problems with it at all.
3935,1847,1,8,26,35,1.2857142857142858,0.08765314158255663,673,I speak from experience—this medicine works miracles.
2946,1847,0,10,25,35,1.2857142857142858,0.07747516350666293,673,this'll take care of your nose hair.
3275,1847,1,8,26,35,1.2857142857142858,0.08765314158255663,673,No serious side effects.  I used it myself for years...
3485,1847,0,10,25,35,1.2857142857142858,0.07747516350666293,673,We can’t all be Atul Gawande.
3500,1847,2,6,27,35,1.2857142857142858,0.09676644820493972,673,Take two every morning with a soft cheese.
3753,1847,0,10,25,35,1.2857142857142858,0.07747516350666293,673,"Here’s your receipt for the fox, I mean fax..."
3787,1847,2,6,27,35,1.2857142857142858,0.09676644820493972,673,No worries. I tested this drug myself.
3949,1847,2,8,32,42,1.2857142857142858,0.08544285322996292,673,"And remember, it's not you, it's me."
3996,1847,2,6,27,35,1.2857142857142858,0.09676644820493972,673,"And remember—even if you win the human race, you’re still a human."
4029,1847,1,8,26,35,1.2857142857142858,0.08765314158255663,673,"Trust me, I wouldn't prescribe anything I hadn't first tried myself."
4222,1847,2,6,27,35,1.2857142857142858,0.09676644820493972,673,Don’t act like it’s worse than your other doctor’s handwriting.
4337,1847,2,6,27,35,1.2857142857142858,0.09676644820493972,673,Here—a group of us get together Tuesday evenings.
4344,1847,2,6,27,35,1.2857142857142858,0.09676644820493972,673,Here’s the number to my personal dermatologist.
4528,1847,2,10,37,49,1.2857142857142858,0.07715167498104596,673,My med school debt keeps me in the rat race.
2342,1847,3,6,33,42,1.2857142857142858,0.09198870231668352,673,You can get this filled in the dairy aisle
2108,1847,0,10,25,35,1.2857142857142858,0.07747516350666293,673,"I can vouch for this, I was in the non-placebo group."
2820,1847,2,6,27,35,1.2857142857142858,0.09676644820493972,673,"If you cop me some Muenster, I'll prescribe whatever you need!"
1870,1847,2,8,32,42,1.2857142857142858,0.08544285322996292,673,This medication should stop you from fantasizing about dogs!
4097,1847,1,10,31,42,1.2857142857142858,0.0783520324066106,673,"Fill this script at my Associate the Weasels pharmacy."""
2019,1847,2,6,27,35,1.2857142857142858,0.09676644820493972,673,I'm recommending caseinometaphen; the generic of mozzarella.
4151,1847,2,8,32,42,1.2857142857142858,0.08544285322996292,673,This stuff really works. They tested it on me.
112,1847,1,8,26,35,1.2857142857142858,0.08765314158255663,673,"Not a prescription, two tickets to ""Cats"". I hate that show."
362,1847,1,10,31,42,1.2857142857142858,0.0783520324066106,673,Take this every morning and I'm confident the hallucinations will stop.
429,1847,1,8,26,35,1.2857142857142858,0.08765314158255663,673,I don’t even like pizza.
536,1847,2,6,27,35,1.2857142857142858,0.09676644820493972,673,"For the survival of the planet, all credit cards issued to humans are to be withdrawn and cancelled."
2380,1847,0,10,25,35,1.2857142857142858,0.07747516350666293,673,"I started as a test subject and worked my way here. You can, too."
1860,1847,2,6,27,35,1.2857142857142858,0.09676644820493972,673,"Just grind it up in your food, you'll never notice it."
1180,1847,0,10,25,35,1.2857142857142858,0.07747516350666293,673,Eat two of your young and call me in the morning.
1512,1847,2,6,27,35,1.2857142857142858,0.09676644820493972,673,"Listen, I'm not gonna rat you out if you don't take it, but it's for your own good."
1661,1847,1,8,26,35,1.2857142857142858,0.08765314158255663,673,"Yes, you did say that!"
1765,1847,2,6,27,35,1.2857142857142858,0.09676644820493972,673,This will take care of the huffing and puffing.
598,1847,2,6,27,35,1.2857142857142858,0.09676644820493972,673,"Actually, what's more ironic is that I really do hope you get better."
2625,1883,3,9,41,53,1.2830188679245282,0.0779702526476824,673,"Take these twice a day, it will keep the wolf from
The door !"
2810,1884,2,9,35,46,1.2826086956521738,0.08023542339516758,673,2x a day on the hamster wheel and you’ll be better in no time.
1645,1884,2,9,35,46,1.2826086956521738,0.08023542339516758,673,I’m happy to refer you to a specialist but I have to warn you some patients don’t find him personable.
525,1884,1,11,34,46,1.2826086956521738,0.07396985597202807,673,Here’s hoping after you take this you will want to get off that proverbial hamster wheel.
695,1884,3,7,36,46,1.2826086956521738,0.08604595715244866,673,"Really, Warfarin is OK for you."
1594,1884,1,11,34,46,1.2826086956521738,0.07396985597202807,673,"It's a prescription for Warfarin. I've heard it's effective, though I can't personally recommend it"
3350,1889,2,7,30,39,1.2820512820512822,0.0895988808242798,673,...and stay out of the wheel for a few weeks.
3321,1889,2,7,30,39,1.2820512820512822,0.0895988808242798,673,Listen. An online degree is just as good as a traditional university.
3317,1889,2,7,30,39,1.2820512820512822,0.0895988808242798,673,"Don't worry, I tested these pills myself."
3014,1889,1,9,29,39,1.2820512820512822,0.08172167264346927,673,"I understand, sir, but your insurance doesn't cover human doctors."
2680,1889,2,7,30,39,1.2820512820512822,0.0895988808242798,673,"Doctors and nurses got too expensive for the business.  Plus, they figured we could inform on anyone trying to unionize."
2793,1889,3,5,31,39,1.2820512820512822,0.09683742618575027,673,Take this prescription for warfarin.
2852,1889,2,7,30,39,1.2820512820512822,0.0895988808242798,673,Here is a prescription for an exercise wheel
3228,1889,2,7,30,39,1.2820512820512822,0.0895988808242798,673,I don't give a rat's you-know-what that  you don't like my diagnosis!
2289,1889,2,7,30,39,1.2820512820512822,0.0895988808242798,673,...but I'm also a client.
3564,1889,2,7,30,39,1.2820512820512822,0.0895988808242798,673,"If it works for you, then we'll try it in the lab."
3379,1889,1,9,29,39,1.2820512820512822,0.08172167264346927,673,"If you can figure out what species I am, you're hired!"
3653,1889,1,9,29,39,1.2820512820512822,0.08172167264346927,673,Here's a prescription that'll enhance your cognitive abilities...I was in the beta trials.
3674,1889,1,9,29,39,1.2820512820512822,0.08172167264346927,673,I don't care what you heard. Beatrix Potter University has an excellent medical school.
3731,1889,2,7,30,39,1.2820512820512822,0.0895988808242798,673,"Take 1,000 times the normal dose daily for a year, then we'll dissect your brain."
3806,1889,1,9,29,39,1.2820512820512822,0.08172167264346927,673,"You don’t mind that it was only tested on rodents, do you?"
3874,1889,3,5,31,39,1.2820512820512822,0.09683742618575027,673,"Thanks you for asking, yes I like it here in Baltimore"
2187,1889,1,9,29,39,1.2820512820512822,0.08172167264346927,673,It’s the future of MediCare.
3978,1889,2,7,30,39,1.2820512820512822,0.0895988808242798,673,"What didn't kill me, will make you stronger."
3987,1889,2,7,30,39,1.2820512820512822,0.0895988808242798,673,Take this and leave my baby girl alone.
4199,1889,1,9,29,39,1.2820512820512822,0.08172167264346927,673,"It's still in the trial-phase, but we're seeing positive results among humans"
4350,1889,1,9,29,39,1.2820512820512822,0.08172167264346927,673,"Yes, I am a lab rat. So?"
4423,1889,1,9,29,39,1.2820512820512822,0.08172167264346927,673,Its called Cyclopsadrine.  Take one daily.
4545,1889,2,7,30,39,1.2820512820512822,0.0895988808242798,673,Take this down to the cheese shop behind the pharmacy
3598,1889,0,11,28,39,1.2820512820512822,0.07299934324587595,673,Full disclosure: I participated in the clinical trials.
2136,1889,2,7,30,39,1.2820512820512822,0.0895988808242798,673,"No, there is not an anal option."
2248,1889,2,7,30,39,1.2820512820512822,0.0895988808242798,673,I thought a doctor’s clothing would be better than the sheep’s. It won’t affect your deductible though
1629,1889,2,7,30,39,1.2820512820512822,0.0895988808242798,673,This should take care of your Zoophobia”.
179,1889,2,7,30,39,1.2820512820512822,0.0895988808242798,673,"Here's a prescription for your sore throat, but a shock collar would be more effective."
1630,1889,0,11,28,39,1.2820512820512822,0.07299934324587595,673,"Take one every morning and night. And until they work, might I suggest a nice brie."
539,1889,1,9,29,39,1.2820512820512822,0.08172167264346927,673,"Try it! My research indicated it
is the most effective Recessed Mouth antidote on the market."
548,1889,3,5,31,39,1.2820512820512822,0.09683742618575027,673,You appear to have caught that bug that's going around Baltimore.
572,1889,0,11,28,39,1.2820512820512822,0.07299934324587595,673,"Trust me, the warfarin will keep you alive."
607,1889,2,7,30,39,1.2820512820512822,0.0895988808242798,673,Don't tell anyone where you got it.
630,1889,2,7,30,39,1.2820512820512822,0.0895988808242798,673,"A prescription for Vitamin K1 in case you need it.  Three times a week on the wheel, and keep working the maze to stay sharp."
643,1889,1,9,29,39,1.2820512820512822,0.08172167264346927,673,"This  is a prescription for Warfarin.  It  seems to helps your species  but for me it is just ""rat poison""."
690,1889,1,9,29,39,1.2820512820512822,0.08172167264346927,673,I'm not proud of the fact that we spread disease. But I'm proud to have developed a more efficient way of doing it.
195,1889,3,5,31,39,1.2820512820512822,0.09683742618575027,673,"Thanks to Mitch McConnell, Obamacare no longer covers cock implants."
888,1889,2,7,30,39,1.2820512820512822,0.0895988808242798,673,"When you return next week, Mr. Hood, I'd like you to bring your wife, Red Riding, with you. Better to SEE her too."
1122,1889,2,7,30,39,1.2820512820512822,0.0895988808242798,673,Will help you survive Washington.
1223,1889,3,5,31,39,1.2820512820512822,0.09683742618575027,673,Are you staring at my nose hair?
1375,1889,2,7,30,39,1.2820512820512822,0.0895988808242798,673,Worked for us.
1391,1889,2,7,30,39,1.2820512820512822,0.0895988808242798,673,Take two gouda and call me in the morning.
1405,1889,2,7,30,39,1.2820512820512822,0.0895988808242798,673,"While living in the lab, I studied medicine so I'd be prepared for life on the outside."
1620,1889,1,9,29,39,1.2820512820512822,0.08172167264346927,673,I take them myself and haven't noticed any side effects
886,1889,2,7,30,39,1.2820512820512822,0.0895988808242798,673,"I know what you're thinking, but trust me. Who is better to help you with the stress of the rat race?"
2281,1934,1,12,37,50,1.28,0.07021831844254003,673,"Hey man, ketamine is legal now. I think it's for anxiety or something. I don't know. Anyway, this one is on me."
1890,1935,1,10,32,43,1.2790697674418605,0.07679618359949415,673,Beats me>
2392,1935,3,6,34,43,1.2790697674418605,0.09006938014435852,673,Have you been to Baltimore before?
521,1935,0,12,31,43,1.2790697674418605,0.06921151712956694,673,Take two of these once a month and limit your exposure to the Moon.
4347,1935,1,10,32,43,1.2790697674418605,0.07679618359949415,673,"If yu don't get serious about your diet and exercise, I will huff and I'll puff and I'll blow  your house down."
2641,1935,1,10,32,43,1.2790697674418605,0.07679618359949415,673,"Right now, I'm departing from my role as M.D., and using the powers of hypnosis to convince you that you are a mouse. Is it working?"
1834,1940,2,6,28,36,1.2777777777777777,0.09437439045203015,673,You are way behind in the race.  This will speed you up nicely.
1466,1940,1,8,27,36,1.2777777777777777,0.08555246335372613,673,The only side effect observed in human testing was a desire to eat garbage...so you'll fit right in.
1539,1940,0,10,26,36,1.2777777777777777,0.07570946042991632,673,Take my word for it: experimental therapy can be quite effective.
3173,1940,1,8,27,36,1.2777777777777777,0.08555246335372613,673,Are you sure you have the right lair?
2325,1940,1,8,27,36,1.2777777777777777,0.08555246335372613,673,Stop staring at my mustache!
3584,1940,1,8,27,36,1.2777777777777777,0.08555246335372613,673,"Yes, there is lactose-free gouda."
3766,1940,2,6,28,36,1.2777777777777777,0.09437439045203015,673,This prescription can only be filled in Baltimore
3781,1940,0,10,26,36,1.2777777777777777,0.07570946042991632,673,Take two of these and the hallucinations will get even better.
4497,1940,1,8,27,36,1.2777777777777777,0.08555246335372613,673,"Here you go Mr. Spiegelman. If you continue to experience any more hallucinations take deep breaths and try to relax. If they persist call the office, and contact your congressman. This shouldn't last 4 more years."
4102,1940,1,8,27,36,1.2777777777777777,0.08555246335372613,673,"""And here's a physician-review website should you care to put in a good word or two about your appointment today."""
1995,1940,2,6,28,36,1.2777777777777777,0.09437439045203015,673,We accept all forms of insurance. And Cheese.
1400,1940,1,8,27,36,1.2777777777777777,0.08555246335372613,673,You're lactose intolerant. Bummer of a diagnosis.
770,1940,1,8,27,36,1.2777777777777777,0.08555246335372613,673,"I don't understand your confusion, it clearly states that I am a licensed animal doctor..."
691,1940,1,8,27,36,1.2777777777777777,0.08555246335372613,673,Far easier than being a human.
216,1940,2,6,28,36,1.2777777777777777,0.09437439045203015,673,I'm sorry only New York Rats can qualify for our insurance program.
33,1940,1,8,27,36,1.2777777777777777,0.08555246335372613,673,I've used this myself and I never experienced any side-effects.
1930,1940,2,6,28,36,1.2777777777777777,0.09437439045203015,673,Are you here to see the Vet?
855,1940,1,8,27,36,1.2777777777777777,0.08555246335372613,673,"Yeah, but you're kind of in pain, right?"
656,1958,2,9,36,47,1.2765957446808511,0.0787396537971014,673,"I want you to get some rest, drink lots of water, and don’t get into any mischief."
3837,1958,2,9,36,47,1.2765957446808511,0.0787396537971014,673,"So who you gonna believe, me or those silly black box warnings?
Drew Bridges, Wake Forest, NC"
3280,1960,1,9,30,40,1.275,0.07996393417804533,673,Take two every full moon.
3141,1960,4,3,33,40,1.275,0.10119478551479127,673,"For the best results, take it with sewage."
2283,1960,1,9,30,40,1.275,0.07996393417804533,673,Why would you ask if this medication has any transformative side effects?
2143,1960,2,7,31,40,1.275,0.08761439408728482,673,"This pill has been proven to kill vermin, but I'm sure it's safe for you and your paranoia."
1994,1960,0,11,29,40,1.275,0.07149950690165272,673,100% cure.  The side effects are that you will be wickedly adaptable and may wake up wet in a neighbor's bathroom smelling like poop.
1251,1960,1,9,30,40,1.275,0.07996393417804533,673,This admits you to the maze for your experimental treatment.
2007,1960,1,9,30,40,1.275,0.07996393417804533,673,Take one pill of cheddar twice a day.
553,1960,2,7,31,40,1.275,0.08761439408728482,673,When did your medication run out?
4531,1960,0,11,29,40,1.275,0.07149950690165272,673,"Trust me, I survived this stuff in a test lab."
1118,1960,2,18,60,80,1.275,0.05618403304872525,673,This script should address your hallucinations. Now promise me you’ll go easy on the sticky traps.
3509,1970,3,3,27,33,1.2727272727272727,0.10899617098438,673,"""It's just a bad hair day."""
3399,1970,0,9,24,33,1.2727272727272727,0.0787295821622217,673,Take this and stay away from building inspectors.
3221,1970,1,7,25,33,1.2727272727272727,0.08995713702301454,673,"Trust me, this has been thoroughly tested."
3193,1970,1,7,25,33,1.2727272727272727,0.08995713702301454,673,"""Trust me. These will help. I worked in labs most of my life."""
3092,1970,1,7,25,33,1.2727272727272727,0.08995713702301454,673,This formulation just got approved yesterday from rigorous human lab rat testing.
2577,1970,1,7,25,33,1.2727272727272727,0.08995713702301454,673,"Nibble carefully, and be prepared to bolt."
3087,1970,1,7,25,33,1.2727272727272727,0.08995713702301454,673,This should help with your infestation.
2885,1970,2,5,26,33,1.2727272727272727,0.09993110574449182,673,I apologize for the mask. The witness protection program budget has been slashed. This is all I got.
2874,1970,1,7,25,33,1.2727272727272727,0.08995713702301454,673,"This prescription should stop the six-foot rodent hallucinations, but let's set up a weekly therapy session to deal with your compulsion to shout, ""You dirty rat!"" at passing strangers."
2827,1970,2,5,26,33,1.2727272727272727,0.09993110574449182,673,"On the other hand, if you like the hallucinations, you don't have to take them."
2658,1970,1,7,25,33,1.2727272727272727,0.08995713702301454,673,"Take two with meals, but do NOT mix with cheese."
2719,1970,3,6,35,44,1.2727272727272727,0.0882268144391769,673,"This stuff killed my folks in Baltimore, but it should fix you right up."
2758,1970,1,7,25,33,1.2727272727272727,0.08995713702301454,673,It's just a blood thinner.  I have it all the time.
2770,1970,0,12,32,44,1.2727272727272727,0.0679170334216026,673,Take this too. I'm behind on my kickback quotas.
3524,1970,0,9,24,33,1.2727272727272727,0.0787295821622217,673,I've used it myself with no side effects. Nothing to be concerned about.
3019,1970,2,5,26,33,1.2727272727272727,0.09993110574449182,673,"No, there are no side effects; I take it myself."
3746,1970,0,9,24,33,1.2727272727272727,0.0787295821622217,673,Just tell them that Dr. Fink sent you
4435,1970,2,5,26,33,1.2727272727272727,0.09993110574449182,673,"Trust me, you'll need to fill this prescription before the next full moon."
3794,1970,1,7,25,33,1.2727272727272727,0.08995713702301454,673,I've found these particularly helpful in reducing the tendency to chase.
4487,1970,2,5,26,33,1.2727272727272727,0.09993110574449182,673,I was part of the control group but this worked for my cousin Mickey
4399,1970,2,5,26,33,1.2727272727272727,0.09993110574449182,673,I was in the animal trials for this drug.
2551,1970,2,5,26,33,1.2727272727272727,0.09993110574449182,673,It's a mole.
4395,1970,3,3,27,33,1.2727272727272727,0.10899617098438,673,No one has ever called me a quack
4392,1970,0,9,24,33,1.2727272727272727,0.0787295821622217,673,Take this I was one of the lab rats that discovered it.
4361,1970,1,7,25,33,1.2727272727272727,0.08995713702301454,673,The only side effect that I ever heard of is hallucinations of mice and other vermin. Why do you ask?
4329,1970,0,9,24,33,1.2727272727272727,0.0787295821622217,673,And our co-pay is much lower than your average PPO.
3778,1970,1,7,25,33,1.2727272727272727,0.08995713702301454,673,This should help. It's for an anti-hallucinogen.
4289,1970,1,7,25,33,1.2727272727272727,0.08995713702301454,673,Don’t worry. It’s just Bubonic Plague. Antibiotics should knock it out in a few days.
4042,1970,2,5,26,33,1.2727272727272727,0.09993110574449182,673,"For your condition, I can recommend nothing less than a panda head."
4024,1970,2,5,26,33,1.2727272727272727,0.09993110574449182,673,Didn't you realize that voting for universal health care meant any mammal could become a doctor?
3983,1970,2,5,26,33,1.2727272727272727,0.09993110574449182,673,Takes these pills and you will be able to lick your butt like me.
3974,1970,2,5,26,33,1.2727272727272727,0.09993110574449182,673,"Have this script filled at the pharmacy. Go out the door, turn right, turn right again, turn left, turn right, then turn left , turn left, turn right, and you’re there."
3927,1970,1,7,25,33,1.2727272727272727,0.08995713702301454,673,"You must have misheard, we are disease-ridding creatures."
3910,1970,1,7,25,33,1.2727272727272727,0.08995713702301454,673,Another myth busted. We just carry the plague.
3868,1970,1,7,25,33,1.2727272727272727,0.08995713702301454,673,I'm sorry but Mice Associates doesn't do CAT scans.
4108,1970,1,7,25,33,1.2727272727272727,0.08995713702301454,673,"Yes, this is rat poison, but the benefits outweigh the risks."
2507,1970,0,9,24,33,1.2727272727272727,0.0787295821622217,673,My colleagues said the side effects aren't too bad.
1582,1970,1,7,25,33,1.2727272727272727,0.08995713702301454,673,"And here's your opioid addiction; er, I mean prescription."
2431,1970,3,3,27,33,1.2727272727272727,0.10899617098438,673,I'd like for you to give my genetics counselor a call. Dr. Moreau is a pioneer in his field.
576,1970,2,8,34,44,1.2727272727272727,0.08201760989966524,673,A prescription for rat cheese should take care of that.
45,1970,2,5,26,33,1.2727272727272727,0.09993110574449182,673,"Tell anyone I have O.P.D.! I have other ways of blowing your house down Johnny, Boy."
66,1970,1,7,25,33,1.2727272727272727,0.08995713702301454,673,"It's an experimental procedure, but don't worry -- I've been through hundreds of them."
78,1970,2,5,26,33,1.2727272727272727,0.09993110574449182,673,You'll have to decide if you think I'm a good doctor.   But at least I accept your insurance.
91,1970,1,7,25,33,1.2727272727272727,0.08995713702301454,673,Nothing to worry about. I take this myself!
102,1970,1,7,25,33,1.2727272727272727,0.08995713702301454,673,Big Pharma got to me!
113,1970,1,7,25,33,1.2727272727272727,0.08995713702301454,673,"Trust me, this is not a bait and switch prescription."
131,1970,1,7,25,33,1.2727272727272727,0.08995713702301454,673,What? I got my license on line.
215,1970,1,7,25,33,1.2727272727272727,0.08995713702301454,673,"Even after FDA approval, we are all part of one big longitudinal clinical trial."
322,1970,0,9,24,33,1.2727272727272727,0.0787295821622217,673,I'm prescribing something a little stronger this time: a nice Gorgonzola.
386,1970,0,9,24,33,1.2727272727272727,0.0787295821622217,673,First time working in a lab then?
395,1970,1,7,25,33,1.2727272727272727,0.08995713702301454,673,Is this your card?
596,1970,1,7,25,33,1.2727272727272727,0.08995713702301454,673,I did my own lab testing on this.
666,1970,0,9,24,33,1.2727272727272727,0.0787295821622217,673,"This pain killer is not addictive"""
676,1970,2,5,26,33,1.2727272727272727,0.09993110574449182,673,"Yes, seeing mice everywhere is a listed side effect of this drug.  If it bothers you, there is one where you see cats instead."
18,1970,1,7,25,33,1.2727272727272727,0.08995713702301454,673,"If this works on you, I’ll try it."
779,1970,2,5,26,33,1.2727272727272727,0.09993110574449182,673,Take this once a day for your musophobia!
757,1970,1,7,25,33,1.2727272727272727,0.08995713702301454,673,"The diplomas and my card proves it, I graduated  from R .A.T. not R.I.T."
2477,1970,2,5,26,33,1.2727272727272727,0.09993110574449182,673,A lot of patients have been helped by this. It’s called Jarlsberg.
2327,1970,1,7,25,33,1.2727272727272727,0.08995713702301454,673,Take two and call me in the flooring.
2207,1970,0,9,24,33,1.2727272727272727,0.0787295821622217,673,"I guarantee this medication will work, they tested it on my cousin."
2186,1970,1,7,25,33,1.2727272727272727,0.08995713702301454,673,"Yes, as your doctor I can vouch this prescription is safe. It's been thoroughly tested on lab humans in multiple double-blind clinical trials."
2166,1970,2,5,26,33,1.2727272727272727,0.09993110574449182,673,"Two slices of Camembert, and call me in the morning."
2383,1970,0,9,24,33,1.2727272727272727,0.0787295821622217,673,Take some time off.  There's a little house in the woods....
1934,1970,1,7,25,33,1.2727272727272727,0.08995713702301454,673,"You can trust this one, I`ve experimented it myself"
1636,1970,1,7,25,33,1.2727272727272727,0.08995713702301454,673,My friend says it worked much better than the placebo group.
1601,1970,1,7,25,33,1.2727272727272727,0.08995713702301454,673,It's for coumadin...
1381,1970,2,5,26,33,1.2727272727272727,0.09993110574449182,673,"Not only will you be able to eat dairy again, but you’ll be amazed at how much better cheese tastes!"
1066,1970,2,5,26,33,1.2727272727272727,0.09993110574449182,673,"Think of it as a clinical trial, not a trap."
1002,1970,0,9,24,33,1.2727272727272727,0.0787295821622217,673,I suggest you get an appointment with the Lab Rat. He'll get you a cure.
2107,1970,2,5,26,33,1.2727272727272727,0.09993110574449182,673,"No, it's not the human version of what you think it is."
2182,2040,0,13,35,48,1.2708333333333333,0.06482097094483914,673,Unlax Jack. You get drugs and I get some cheese. Don't rat me out.
2990,2041,1,8,28,37,1.2702702702702702,0.08354611257203337,673,Here’s a prescription for the rabies vaccine. I recommend you get it immediately.
2920,2041,3,4,30,37,1.2702702702702702,0.09991474330098574,673,take 2 and we'll see if you call me in the morning
2763,2041,1,8,28,37,1.2702702702702702,0.08354611257203337,673,The chemicals in this script were lab rat tested.
2674,2041,1,8,28,37,1.2702702702702702,0.08354611257203337,673,"I swear Doug, I thought I was getting into “Big Parma.” Anyway, here’s your prescription."
2668,2041,1,8,28,37,1.2702702702702702,0.08354611257203337,673,Attorneys are the sharks.   We’re just rats.
2620,2041,2,6,29,37,1.2702702702702702,0.09209481216333727,673,I moved here from Baltimore. Why?
2503,2041,1,8,28,37,1.2702702702702702,0.08354611257203337,673,Death is not the end.
2451,2041,1,8,28,37,1.2702702702702702,0.08354611257203337,673,"There isn’t a medicine out there with NO unexpected effects, James."
2432,2041,2,6,29,37,1.2702702702702702,0.09209481216333727,673,Let's try a lower dose.
3072,2041,1,8,28,37,1.2702702702702702,0.08354611257203337,673,I'm sending you to a specialist; Dr. Havarti can cure you.
2369,2041,1,8,28,37,1.2702702702702702,0.08354611257203337,673,"Of course it’s safe, it was tested on my brother."
2643,2041,1,8,28,37,1.2702702702702702,0.08354611257203337,673,Its an office maze anti-depressant
3110,2041,1,8,28,37,1.2702702702702702,0.08354611257203337,673,"Don't worry...I take it myself, and the side effects are minimal."
3754,2041,0,10,27,37,1.2702702702702702,0.07401656182502245,673,First I interned as a lab rat at Stanford .
3241,2041,1,8,28,37,1.2702702702702702,0.08354611257203337,673,"This prescription has been thoroughly tested...on me, as a matter of fact."
3254,2041,1,8,28,37,1.2702702702702702,0.08354611257203337,673,Take this twice a day with water-it’s a new prescription based on AI - Animal Intelligence
3309,2041,2,6,29,37,1.2702702702702702,0.09209481216333727,673,Have you always been intimidates by mustaches?
3563,2041,1,8,28,37,1.2702702702702702,0.08354611257203337,673,"It’s just a side effect. But if you start seeing sheep, let me know."
3590,2041,0,10,27,37,1.2702702702702702,0.07401656182502245,673,"It's a great med, trust me. I was involved in the clinical trial."
3901,2041,0,10,27,37,1.2702702702702702,0.07401656182502245,673,Do you think I would give you a prescription without knowing the side effects?
3906,2041,2,6,29,37,1.2702702702702702,0.09209481216333727,673,Here are your opioids. Don't rat me out.
3989,2041,2,6,29,37,1.2702702702702702,0.09209481216333727,673,I took the same medicine for the same condition. The side effects are trivial.
4225,2041,2,6,29,37,1.2702702702702702,0.09209481216333727,673,Surgery went well. Lick the spot all day for a few days.  You should feel the urge to hump your neighbor’s leg disappear right away.
4293,2041,2,6,29,37,1.2702702702702702,0.09209481216333727,673,I generally don't like to prescribe this out of specie.
4529,2041,0,10,27,37,1.2702702702702702,0.07401656182502245,673,It's perfectly safe. It's been tested on me.
802,2041,1,8,28,37,1.2702702702702702,0.08354611257203337,673,Here's your new prescription. The side effects are less severe.
2321,2041,1,8,28,37,1.2702702702702702,0.08354611257203337,673,"They’re not addictive, trust me."
3214,2041,3,4,30,37,1.2702702702702702,0.09991474330098574,673,"Sorry, I don’t accept Humama insurance"
2258,2041,1,8,28,37,1.2702702702702702,0.08354611257203337,673,"Side effects may include hepatitis, pancreatic cancer, and bubonic plague."
2699,2041,1,8,28,37,1.2702702702702702,0.08354611257203337,673,Here's your prescrip.....wait! Is that a mouse on my desk?
2188,2041,1,8,28,37,1.2702702702702702,0.08354611257203337,673,Hmmm... I see you may have killed my brother!!!
2241,2041,0,10,27,37,1.2702702702702702,0.07401656182502245,673,"And remember, don't let the cat find this card."
360,2041,1,8,28,37,1.2702702702702702,0.08354611257203337,673,Side effects may include hallucinations.
373,2041,0,10,27,37,1.2702702702702702,0.07401656182502245,673,And with this ticket you'll be entitled to free meds in my testing lab.
456,2041,2,6,29,37,1.2702702702702702,0.09209481216333727,673,"This drug isn't FDA approved but trust me, it's been tested."
489,2041,2,6,29,37,1.2702702702702702,0.09209481216333727,673,You'll feel better in two shakes of a lamb's tail.
579,2041,1,8,28,37,1.2702702702702702,0.08354611257203337,673,Take these pills to keep the monster you keep inside in check!!!
605,2041,1,8,28,37,1.2702702702702702,0.08354611257203337,673,"It's perfectly safe, tested on my fellow rats."
618,2041,1,8,28,37,1.2702702702702702,0.08354611257203337,673,"No, I’m not sure if it’s safe, we had to stop testing on humans"
746,2041,1,8,28,37,1.2702702702702702,0.08354611257203337,673,Strange! You're my third patient this week  to contract the bubonic plague. And you say you felt fine when you came in? It's a real head-scratcher!
937,2041,2,6,29,37,1.2702702702702702,0.09209481216333727,673,"I'm Doctor Raton, my card..."
1096,2041,0,10,27,37,1.2702702702702702,0.07401656182502245,673,"Trust me, go give this to your grandma. I'm a doctor."
1117,2041,1,8,28,37,1.2702702702702702,0.08354611257203337,673,You'll get used to the side effects. Just avoid henhouses.
355,2041,1,8,28,37,1.2702702702702702,0.08354611257203337,673,What did this wolf at your door look like?
1147,2041,2,6,29,37,1.2702702702702702,0.09209481216333727,673,"Trust me, bury these pills in your yard and your moles will go away."
1143,2041,2,6,29,37,1.2702702702702702,0.09209481216333727,673,"Bubonic? Nah, it's not life threatening. I've had several times myself."
1908,2041,0,10,27,37,1.2702702702702702,0.07401656182502245,673,"It’s warfarin to you, not rat poison"
1734,2041,1,8,28,37,1.2702702702702702,0.08354611257203337,673,I recommend these because I participated in the clinical trials.
1443,2041,1,8,28,37,1.2702702702702702,0.08354611257203337,673,My residency? Baltimore. Why do you ask?
1413,2041,1,8,28,37,1.2702702702702702,0.08354611257203337,673,Usually you have to run a maze to get stuff this good.
1516,2041,1,8,28,37,1.2702702702702702,0.08354611257203337,673,"This generic may have hallucination side effects, but it's the only one your insurance covers."
1230,2041,2,6,29,37,1.2702702702702702,0.09209481216333727,673,"Take this medication and see me in eight years, I am running for president"
1197,2041,0,10,27,37,1.2702702702702702,0.07401656182502245,673,I'm prescribing a taste of your own medicine
1191,2041,2,6,29,37,1.2702702702702702,0.09209481216333727,673,"He's on the other side of the city, but he's the best barber in Baltimore."
1299,2041,0,10,27,37,1.2702702702702702,0.07401656182502245,673,"...and sensitivity to light and scurrying thru trash at night, should lessen in two weeks"
2097,2096,2,7,32,41,1.2682926829268293,0.08571357751612477,673,"This blood thinner killed my whole family, but you give it a try."
1210,2096,1,9,31,41,1.2682926829268293,0.07827710505307908,673,"Here, these should help deter the hallucinations."
4426,2096,1,9,31,41,1.2682926829268293,0.07827710505307908,673,"I want a C-note on the fifth race at Pimlico, Gorgonzola on the nose."
1799,2099,0,12,33,45,1.2666666666666666,0.06666666666666665,673,Some of my colleagues have found this helpful.
288,2099,2,4,24,30,1.2666666666666666,0.10649411330483191,673,"Side effects include hating, stealing, and twittering."""
114,2099,3,6,36,45,1.2666666666666666,0.08645662192537638,673,You got a problem? This card is a problem.
1344,2099,2,8,35,45,1.2666666666666666,0.08040302522073696,673,Looks like you've got chronic bubonic.
3993,2099,1,10,34,45,1.2666666666666666,0.07385489458759963,673,If you don’t stay on the cheese you’ll never get better
2372,2104,1,11,37,49,1.2653061224489797,0.07007958427903577,673,I went to med school in San Francisco but I grew up in Baltimore.
2986,2105,1,7,26,34,1.2647058823529411,0.08763910287019504,673,"To be honest with you, Norman, most folks don't seem to mind filling their prescription to acquire the medicine that turns them into disgusting rat monsters. Infact, most of the people in this building are damp, hideous, rat-humanoids at this point."
3022,2105,2,5,27,34,1.2647058823529411,0.09727869009288996,673,Here's your script for Warfarin
3096,2105,0,9,25,34,1.2647058823529411,0.07679896586280786,673,Relax. Cheese always works.
3206,2105,2,5,27,34,1.2647058823529411,0.09727869009288996,673,"Take this, and stop the warfarin immediately- that stuff’s poison"
3294,2105,1,7,26,34,1.2647058823529411,0.08763910287019504,673,Take two at bedtime and have your folks call me when they’re mourning.
3467,2105,0,9,25,34,1.2647058823529411,0.07679896586280786,673,"Don't worry, this won't be the side effect she notices..."
3542,2105,0,9,25,34,1.2647058823529411,0.07679896586280786,673,"Don't worry, it worked for me."
3560,2105,1,7,26,34,1.2647058823529411,0.08763910287019504,673,These pills will cure your depression. My expertise is understanding the rat race.
4554,2105,0,9,25,34,1.2647058823529411,0.07679896586280786,673,"Gouda, twice a day for two weeks."
3728,2105,2,5,27,34,1.2647058823529411,0.09727869009288996,673,This should help with your face recognition.
3779,2105,1,7,26,34,1.2647058823529411,0.08763910287019504,673,"No, the 'M' in your HMO stands for 'Mouse-maintained'."
3916,2105,1,7,26,34,1.2647058823529411,0.08763910287019504,673,"That will be two pounds of Limburger and three boxes of 
Cheez-its."
3929,2105,0,9,25,34,1.2647058823529411,0.07679896586280786,673,We're trying to promote awareness of the important role of the rat in medical research.
4163,2105,2,5,27,34,1.2647058823529411,0.09727869009288996,673,"Yes, 
I may be an intern but I've done rotations in toxicology at the poison control center."
4237,2105,0,9,25,34,1.2647058823529411,0.07679896586280786,673,Its experimental but it works.  I know.  I had it.
4429,2105,2,5,27,34,1.2647058823529411,0.09727869009288996,673,"In initial trials, this medication is effective."
2980,2105,0,9,25,34,1.2647058823529411,0.07679896586280786,673,This stuff is great. But it hasn't been tested on humans.
4305,2105,1,7,26,34,1.2647058823529411,0.08763910287019504,673,I can personally vouch for the efficacy of this drug.
2500,2105,1,7,26,34,1.2647058823529411,0.08763910287019504,673,Some of us get out of the maze.
748,2105,0,9,25,34,1.2647058823529411,0.07679896586280786,673,Here's a scrip for rat poison. See you in Baltimore.
2272,2105,0,9,25,34,1.2647058823529411,0.07679896586280786,673,"Take this. I'll forget about your remark about my nose. And, I'll waive the co-pay this time."
2391,2105,0,9,25,34,1.2647058823529411,0.07679896586280786,673,"This should help with the dizziness, now tell me about the hallucinations."
37,2105,1,7,26,34,1.2647058823529411,0.08763910287019504,673,Try these pills. They'll keep your droppings smooth and shiny.
60,2105,1,7,26,34,1.2647058823529411,0.08763910287019504,673,This is where the health care maze begin
378,2105,2,5,27,34,1.2647058823529411,0.09727869009288996,673,The pills will go down easier if you hide them in some cheese.
609,2105,1,7,26,34,1.2647058823529411,0.08763910287019504,673,"No worries, it's a blood thinner, like rat poison, if you have difficulty breathing, give me a call."
660,2105,0,9,25,34,1.2647058823529411,0.07679896586280786,673,Here - this got me through lab residency.
686,2105,2,5,27,34,1.2647058823529411,0.09727869009288996,673,This is my receipt from the dry cleaner. You can have my turtlenecks.
3116,2105,1,7,26,34,1.2647058823529411,0.08763910287019504,673,Now that you're here we may as well get you tested for the Plague.
1014,2105,2,5,27,34,1.2647058823529411,0.09727869009288996,673,Take one capsule 3 times a day and you'll soon look as healthy as me.
1236,2105,2,5,27,34,1.2647058823529411,0.09727869009288996,673,"Relax, I've vetted this script."
1769,2105,1,7,26,34,1.2647058823529411,0.08763910287019504,673,"You want an orthodontist, not a rodent dentist."
1916,2105,1,7,26,34,1.2647058823529411,0.08763910287019504,673,Sure it’s safe. I take it all the time.
1980,2105,1,7,26,34,1.2647058823529411,0.08763910287019504,673,...and the side effects were honestly like the best part.
2209,2105,1,7,26,34,1.2647058823529411,0.08763910287019504,673,This will solve your nightmares about talking rats.
2219,2105,1,7,26,34,1.2647058823529411,0.08763910287019504,673,"Get this prescription filled and no cheese, it's a trap to be avoided."
825,2105,2,5,27,34,1.2647058823529411,0.09727869009288996,673,I won't tell anyone if you won't.
3330,2142,2,6,30,38,1.263157894736842,0.08992023117655254,673,"Side effects of the drug are minimal, believe me, I’ve used it several times."
3600,2142,0,10,28,38,1.263157894736842,0.07239266372688179,673,"Here's your prescription for Warfarin, and stop calling it rat poison."
3750,2142,0,10,28,38,1.263157894736842,0.07239266372688179,673,Take twice daily with cheese.
3774,2142,0,10,28,38,1.263157894736842,0.07239266372688179,673,A prescription pad can’t give you plague.
3938,2142,1,8,29,38,1.263157894736842,0.08162826022989232,673,Stop looking at me as if I had the head of a jackass!
4086,2142,1,8,29,38,1.263157894736842,0.08162826022989232,673,We see the best results in patients born in the Year of the Monkey. You'll want to stock up on bananas.
4182,2142,3,4,31,38,1.263157894736842,0.09750960507319413,673,"You've been eating way too much garbage food.  This script is for real, wholesome garbage."
4147,2142,1,8,29,38,1.263157894736842,0.08162826022989232,673,Once my four turtle sons grew up I went to medical school.
4410,2142,1,8,29,38,1.263157894736842,0.08162826022989232,673,"We've found that when given in low doses, Thallium will do wonders for your latrophobia and musophobia alike."
4264,2142,2,6,30,38,1.263157894736842,0.08992023117655254,673,"I want you to follow this strict diet of Gouda cheese for breakfast, mozzarella for lunch, and Monterey Jack for dinner."
4328,2142,0,10,28,38,1.263157894736842,0.07239266372688179,673,"Your doing really great, this should take care of the irritation. Be sure to elevate and get plenty of  rest. We’ ll have you back in the maze in no time!"
3319,2142,1,8,29,38,1.263157894736842,0.08162826022989232,673,Of course it’s safe. I tested it on my own mother!
4453,2142,1,8,29,38,1.263157894736842,0.08162826022989232,673,I'm referring you to a mole who specializes in moles.
3131,2142,1,8,29,38,1.263157894736842,0.08162826022989232,673,Try this. There's always a chance it won't kill you.
1660,2142,2,6,30,38,1.263157894736842,0.08992023117655254,673,Take this and don’t worry. I graduated from the medical school of mice and men.
3079,2142,2,6,30,38,1.263157894736842,0.08992023117655254,673,In med school they said funny masks would help patients relax.
3005,2142,1,8,29,38,1.263157894736842,0.08162826022989232,673,And take this twice a day for the wild hallucinations.
2961,2142,1,8,29,38,1.263157894736842,0.08162826022989232,673,Congratulations! You've outfoxed the fox.
2598,2142,2,6,30,38,1.263157894736842,0.08992023117655254,673,Take 20 milligrams of Wolfsbane and call me in the ... no need to call.
2417,2142,3,4,31,38,1.263157894736842,0.09750960507319413,673,Based on the results you might as well.
2356,2142,3,4,31,38,1.263157894736842,0.09750960507319413,673,"~ REPUBLICAN HEALTHCARE PLAN ~
[Abnormally loud]...Sorry I wasn't able to help, Mr Wilson...[Whispering] go to the alley behind the building, you will see a black van, knock three times, give them this prescription..."
2196,2142,1,8,29,38,1.263157894736842,0.08162826022989232,673,Eat three bricks of old cheddar and call me in the morning.
2085,2142,1,8,29,38,1.263157894736842,0.08162826022989232,673,Take two and call an exterminator in the morning.
1242,2142,0,10,28,38,1.263157894736842,0.07239266372688179,673,"It's just CBD, there are no side effects."
305,2142,2,6,30,38,1.263157894736842,0.08992023117655254,673,Take two of these and howl...I mean call me in the morning
197,2142,1,8,29,38,1.263157894736842,0.08162826022989232,673,It's a rat race out there
3662,2142,1,8,29,38,1.263157894736842,0.08162826022989232,673,Relax it’s just for cheese
3080,2142,1,8,29,38,1.263157894736842,0.08162826022989232,673,I take one every day and look at me!
1537,2170,3,5,34,42,1.2619047619047619,0.0905495148811283,673,Run this maze and call me in the morning.
2571,2170,1,9,32,42,1.2619047619047619,0.0766572519305696,673,"It's not me, but your card is no good."
2545,2172,1,10,35,46,1.2608695652173914,0.072463768115942,673,Take two a day while you're in Baltimore.
3492,2172,2,8,36,46,1.2608695652173914,0.07884910439846632,673,Call this doctor instead.  I only treat dog persons.
2144,2174,1,5,21,27,1.2592592592592593,0.10116969176390143,673,Be happy you are not a chicken.
1847,2175,1,6,24,31,1.2580645161290323,0.09237303911791196,673,"This medication will not stop your hallucinating rodents, but it will reduce your fear of becoming one."
3651,2175,1,6,24,31,1.2580645161290323,0.09237303911791196,673,I have family in R&D.
3250,2175,1,6,24,31,1.2580645161290323,0.09237303911791196,673,I personally participated in the tests on this.
3277,2178,2,5,28,35,1.2571428571428571,0.09476070829586856,673,Had the same problem.  Take these and stop drinking out of toilet bowl
3441,2178,2,5,28,35,1.2571428571428571,0.09476070829586856,673,"Yes,  a big block of cheese. Eat one and then call me in the morning."
3494,2178,1,7,27,35,1.2571428571428571,0.08543371446816023,673,I'm prescribing the generic cheddar.
3585,2178,1,7,27,35,1.2571428571428571,0.08543371446816023,673,Let me know if this one has fewer side effects.
3720,2178,2,5,28,35,1.2571428571428571,0.09476070829586856,673,Could you open this for me? It’s got a lower mammal-proof lid.
3955,2178,1,7,27,35,1.2571428571428571,0.08543371446816023,673,"If the ants in your pants reappear, follow up with this shampoo..."
3947,2178,2,5,28,35,1.2571428571428571,0.09476070829586856,673,This did not make me into a sheep like you promised.
4064,2178,3,3,29,35,1.2571428571428571,0.10324855498089189,673,"No, I don't want you to take the opioids, I want you to flush them down the toilet so my brother's can get them for free"
4095,2178,1,7,27,35,1.2571428571428571,0.08543371446816023,673,"Just 20 minutes on the wheel, and you won't have to worry about that extra piece of cheese."
3772,2178,0,9,26,35,1.2571428571428571,0.07495496847387481,673,You can fill this at the pharmacy across from the Inner Harbor.
3015,2178,1,7,27,35,1.2571428571428571,0.08543371446816023,673,I think you need to Wolf-out more.
2530,2178,0,9,26,35,1.2571428571428571,0.07495496847387481,673,"No, not the real doctor, but I did sleep in a Holiday Inn loft"
2350,2178,1,7,27,35,1.2571428571428571,0.08543371446816023,673,"Don’t worry, I’m just here for a cartoon contest."
625,2178,1,7,27,35,1.2571428571428571,0.08543371446816023,673,We know risk.
755,2178,0,9,26,35,1.2571428571428571,0.07495496847387481,673,You'll find the maze is much easier to cope with.
970,2178,1,7,27,35,1.2571428571428571,0.08543371446816023,673,Trust me. This is the good stuff.
976,2178,0,9,26,35,1.2571428571428571,0.07495496847387481,673,One should do it.
252,2178,1,7,27,35,1.2571428571428571,0.08543371446816023,673,"Sorry, I don't take a slice of cheese as payment."
1047,2178,2,5,28,35,1.2571428571428571,0.09476070829586856,673,Hn
1702,2178,0,9,26,35,1.2571428571428571,0.07495496847387481,673,"Your fine Mr. McDoogle, but you need this prescription to enhance your nose hair."
2261,2178,2,5,28,35,1.2571428571428571,0.09476070829586856,673,...and that’s how I went from RAT to PHD.
1018,2178,1,7,27,35,1.2571428571428571,0.08543371446816023,673,Handsome is as handsome does. Take this and your nose hair will as beautiful as mine
1927,2200,1,8,30,39,1.2564102564102564,0.07979349797082043,673,This new drug I'm prescribing will overcome your unreasonable fear of rats.
4514,2200,0,10,29,39,1.2564102564102564,0.07083413480167726,673,"You see, when they cut down all the trees, I had to take on an office job to survive."
4041,2200,0,10,29,39,1.2564102564102564,0.07083413480167726,673,"Based on my personal experience, these pills are safe and effective."
3465,2200,1,8,30,39,1.2564102564102564,0.07979349797082043,673,"Now when you cross the boarder to fill the scrip, make sure to tell them Dr Democ-rat sent you."
3070,2200,1,8,30,39,1.2564102564102564,0.07979349797082043,673,Is my tie crooked?
3063,2200,2,6,31,39,1.2564102564102564,0.08784378170215842,673,It's what I take for headaches.
3059,2200,2,6,31,39,1.2564102564102564,0.08784378170215842,673,"Here is your script to try out being a cryptid.  I was eating cheese when I took mine, so maybe stay away from pork."
2051,2200,2,6,31,39,1.2564102564102564,0.08784378170215842,673,Try this. It worked on us in clinical trials.
1926,2200,2,6,31,39,1.2564102564102564,0.08784378170215842,673,"Yes, it’s safe. I’m fine after 3,000 times the human dose. Bigger and smarter too."
996,2200,0,10,29,39,1.2564102564102564,0.07083413480167726,673,And here is the number of my plastic surgeon.
1712,2200,3,4,32,39,1.2564102564102564,0.09521584767807091,673,Breath mint?
1270,2200,2,6,31,39,1.2564102564102564,0.08784378170215842,673,"My kind know how to avoid traps, especially ones set by Medicare."""
1254,2200,3,4,32,39,1.2564102564102564,0.09521584767807091,673,Take this to the sewer drain outside. Tell them Ben sent you.
4573,2200,1,8,30,39,1.2564102564102564,0.07979349797082043,673,"I want you to gnaw one of these every morning, one before bed."
591,2200,1,8,30,39,1.2564102564102564,0.07979349797082043,673,This will help with your hallucinations.
307,2200,0,10,29,39,1.2564102564102564,0.07083413480167726,673,It isn't always a scrip for cheese.
235,2200,1,8,30,39,1.2564102564102564,0.07979349797082043,673,Here; take two cheese and call me in the morning.
104,2200,1,8,30,39,1.2564102564102564,0.07979349797082043,673,Why would you worry who it's been tested on?
1905,2200,1,8,30,39,1.2564102564102564,0.07979349797082043,673,Insurance requires a trial of Swiss and cheddar before they'll cover Brie.
876,2219,3,5,35,43,1.255813953488372,0.08862817707515769,673,Trust me. I've seen worse.
1531,2219,0,11,32,43,1.255813953488372,0.06732528971681358,673,Here. Take two Goudas and call me in the morning!
17,2219,1,9,33,43,1.255813953488372,0.07510069472064661,673,If it worked on me it can work on you.
410,2219,2,7,34,43,1.255813953488372,0.08214337501950254,673,This prescription should solve your anxiety problem about not being able to catch  the rat in your basement.
1160,2223,1,10,36,47,1.2553191489361701,0.07112213509352609,673,Take this with a chicken...I mean soup.
2639,2224,2,4,26,32,1.25,0.10040241611281235,673,Take two sheep and howl for me in the morning.
2686,2224,1,6,25,32,1.25,0.08980265101338746,673,"I used to be ‘the wolf at your door’, but we no longer make house calls."
2814,2224,1,6,25,32,1.25,0.08980265101338746,673,And it also gets you into level three where they've installed a few exercise wheels.
2851,2224,1,6,25,32,1.25,0.08980265101338746,673,"Trust me, in aardvarks this treatment achieved placebo at least 67% of the time."
3288,2224,1,6,25,32,1.25,0.08980265101338746,673,"I want you to try this new, cruelty-free cream, made entirely without human testing."
3306,2224,1,6,25,32,1.25,0.08980265101338746,673,I’ll be honest: you’re not really my usual clientele
3354,2224,1,6,25,32,1.25,0.08980265101338746,673,Take two of these and you'll be calling me doctor again not Rex.
3403,2224,1,6,25,32,1.25,0.08980265101338746,673,"When you have a panic attack, take one of these and scurry back into the wall."
3424,2224,1,6,25,32,1.25,0.08980265101338746,673,"Don't worry, this drug only rewires your brain so you think rats are good."
3490,2224,1,6,25,32,1.25,0.08980265101338746,673,"You know,of course, what I'm prescribing is experimental."
3807,2224,1,8,31,40,1.25,0.07803680919760617,673,Everyone knows what really happens when the cheese stands alone.  You want me on that wall; you need me on that wall
3866,2224,1,6,25,32,1.25,0.08980265101338746,673,Here's a prescription for your rodent problem. It works great.
3964,2224,2,4,26,32,1.25,0.10040241611281235,673,"Take this medicine and you will start looking like me."""
4025,2224,1,6,25,32,1.25,0.08980265101338746,673,Take two of these pills and tell me what I look like in the morning.
4033,2224,0,8,24,32,1.25,0.0777713771047819,673,Here. Take the prescription. It should stop the  hallucinations.
4082,2224,1,6,25,32,1.25,0.08980265101338746,673,"I appreciate your concern, Mr Jones, but can assure you I take patient confidentiality quite seriously."
4188,2224,2,6,32,40,1.25,0.08585915718078574,673,Good luck with my doctors' handwriting.
4303,2224,2,4,26,32,1.25,0.10040241611281235,673,"Your insurance switched your prescription apparently. 
How did that go?"
4306,2224,1,6,25,32,1.25,0.08980265101338746,673,...and avoid cheese.
4349,2224,1,6,25,32,1.25,0.08980265101338746,673,"Try this, it worked in a human model of disease."
4360,2224,1,7,28,36,1.25,0.08333333333333333,673,And why do you think your hallucinations aren’t real?
4362,2224,0,9,27,36,1.25,0.07319250547113999,673,"Here, take these three times a day with cheese."
4485,2224,2,6,32,40,1.25,0.08585915718078574,673,Here's your ticket to Baltimore tell my family I've found a new city to breed in.
4524,2224,2,4,26,32,1.25,0.10040241611281235,673,take this. it will put hair on your nose.
2537,2224,1,7,28,36,1.25,0.08333333333333333,673,"Here's a prescription for eye drops.  Three times a day, for a week.  Then let me know if the condition persists."
2532,2224,1,6,25,32,1.25,0.08980265101338746,673,My handwriting isn't that bad.
2760,2224,1,6,25,32,1.25,0.08980265101338746,673,"It's for LSD, so you won't imagine you're seeing rats anymore."
2419,2224,2,4,26,32,1.25,0.10040241611281235,673,Here's your coumadin.  I've never had a patient complain that they took too much of the stuff.
2367,2224,2,4,26,32,1.25,0.10040241611281235,673,Thank you for being part of our research study for the good of  rodentkind.
76,2224,2,4,26,32,1.25,0.10040241611281235,673,You’re credit card isn’t working. If it helps we also accept cheese.
106,2224,0,8,24,32,1.25,0.0777713771047819,673,"Scientific tests is where I started, now look at me!"
127,2224,1,6,25,32,1.25,0.08980265101338746,673,I may be a rat but this is chickenfeed.
276,2224,1,6,25,32,1.25,0.08980265101338746,673,If you miss a day you’re looking at the consequence.
286,2224,1,6,25,32,1.25,0.08980265101338746,673,you aren't going to weasel out of this Murray!
293,2224,2,8,38,48,1.25,0.0759105483283959,673,This should clear up your catarats in days...
2513,2224,0,8,24,32,1.25,0.0777713771047819,673,"Of course it works, I was in the clinical trials."
440,2224,1,7,28,36,1.25,0.08333333333333333,673,I'm an honorary member of the Rat Pack
546,2224,1,4,19,24,1.25,0.1085143415353039,673,And this is the prescription for the disease I just gave you when I nibbled on your toe.
566,2224,1,6,25,32,1.25,0.08980265101338746,673,"I don't give a rats ass what you think, your fired."
568,2224,2,5,29,36,1.25,0.09236745114890868,673,"Now I'm not going to hound you over this, but you need to be foxy."
323,2224,1,6,25,32,1.25,0.08980265101338746,673,"Trust me, it works on lab rats."
977,2224,1,6,25,32,1.25,0.08980265101338746,673,It’s a prescription for Warfarin
636,2224,3,2,27,32,1.25,0.10998533626601496,673,"Its DOCTOR Ratburn, just take the script and for the last time, there are no side effects."
2351,2224,2,5,29,36,1.25,0.09236745114890868,673,You're stunningly staring at me like you just saw a rat!
2311,2224,0,12,36,48,1.25,0.06316139407998891,673,Take one pill with breakfast everyday. Thanks for participating in round of trials.
2266,2224,2,4,26,32,1.25,0.10040241611281235,673,Of course it tastes like cheese. That's why it works!
2109,2224,0,8,24,32,1.25,0.0777713771047819,673,This will enable you to find some humor in a cartoon with a prescription-providing doctor who is an animal.
2416,2224,1,6,25,32,1.25,0.08980265101338746,673,"Why yes, I am from Baltimore!"
1722,2224,3,3,30,36,1.25,0.10059347702036957,673,"Don’t worry, I’ve been doing open chests for a long time."
1370,2224,1,7,28,36,1.25,0.08333333333333333,673,Take this - I've tested it and it worked wonders for me.
1358,2224,0,8,24,32,1.25,0.0777713771047819,673,"It's over-the-counter. That is, if your landfill has a counter."
1263,2224,1,9,34,44,1.25,0.07360399152702495,673,"Listen, I've got some family in Baltimore who can help you out."
1233,2224,2,4,26,32,1.25,0.10040241611281235,673,50mg of  cyanide should do the trick.
2074,2224,2,4,26,32,1.25,0.10040241611281235,673,"Here, this is for your hallucinations."
4242,2278,1,9,35,45,1.2444444444444445,0.07216392363431012,673,These should take care of your dairy allergy.  Fixed me right up.
1900,2279,0,10,31,41,1.2439024390243902,0.06789956540036612,673,"These are death on parasites
Don Richardson, Napa, CA"
3940,2280,2,5,30,37,1.2432432432432432,0.0900900900900901,673,I know you are in-network but we only accept pet insurance here.
4477,2280,3,3,31,37,1.2432432432432432,0.09807000476160921,673,Put fifty big ones on Ratatouille to win in the fourth.
4315,2280,2,5,30,37,1.2432432432432432,0.0900900900900901,673,This is a tough one to explain
4283,2280,2,5,30,37,1.2432432432432432,0.0900900900900901,673,"Take it from Dr. Weasel, this medication will keep your eyes from popping out of your head."
4180,2280,2,5,30,37,1.2432432432432432,0.0900900900900901,673,A-wooooooooooooooooooooooooooooo!
4176,2280,1,7,29,37,1.2432432432432432,0.0813309463300351,673,I’ m required to warn you that taking these pills causes some bug-eyed people to see a wolf’s head on their doctors and lawyers.
4087,2280,2,5,30,37,1.2432432432432432,0.0900900900900901,673,"Here's your security badge. Just remember, if you see the giant block of cheese, LEAVE IT ALONE."
3448,2280,1,7,29,37,1.2432432432432432,0.0813309463300351,673,Take two and bark at me in the morning.
3816,2280,3,3,31,37,1.2432432432432432,0.09807000476160921,673,smell my finger
2778,2280,2,5,30,37,1.2432432432432432,0.0900900900900901,673,C'mon give it a try.  Look what it did for me!
2488,2280,2,5,30,37,1.2432432432432432,0.0900900900900901,673,"Gastroenterologist, I'd help you myself, but it really is outside my area of expertise."
2388,2280,2,5,30,37,1.2432432432432432,0.0900900900900901,673,"I know what you did to my relatives... But ""let bygones be bygones."" Here is your prescription."
2284,2280,0,9,28,37,1.2432432432432432,0.07150679219093489,673,"No, No, ""To Serve Mankind"" is not my motto or creed -- it's a cookbook."
1778,2280,2,5,30,37,1.2432432432432432,0.0900900900900901,673,"I had to leave the administration, I like being the head rat."
1454,2280,2,5,30,37,1.2432432432432432,0.0900900900900901,673,"Calling me ""Rat Bastard"" won't get you extra refills."
1256,2280,0,9,28,37,1.2432432432432432,0.07150679219093489,673,Wolf it down twice per day.
3166,2280,2,5,30,37,1.2432432432432432,0.0900900900900901,673,This prescription is only good in Baltimore.
82,2280,2,5,30,37,1.2432432432432432,0.0900900900900901,673,It's 92% identical to the one you used to take.
4458,2298,1,6,26,33,1.2424242424242424,0.08736789844447573,673,"I'm leaving the rat race, please refer to my colleague."
2813,2298,1,6,26,33,1.2424242424242424,0.08736789844447573,673,Give this to the cats and you'll be fine.
2725,2298,0,8,25,33,1.2424242424242424,0.07575757575757576,673,"I highly recommend this medication, 200 of my relatives were the lab-rats who first tried it."
2679,2298,1,6,26,33,1.2424242424242424,0.08736789844447573,673,Take two aspirin and run a maze in the morning.
2570,2298,2,4,27,33,1.2424242424242424,0.09760680853579641,673,"If you decide that you want to grow an extra ear on your back, then just take these."
2423,2298,2,4,27,33,1.2424242424242424,0.09760680853579641,673,I'm ordering some tests from the lab. Tell them I say hi.
2060,2298,1,6,26,33,1.2424242424242424,0.08736789844447573,673,My pronouns are rat or rodent
2333,2298,1,6,26,33,1.2424242424242424,0.08736789844447573,673,Take this if those weird visions come back.
2235,2298,0,8,25,33,1.2424242424242424,0.07575757575757576,673,All my friends at the lab say it's safe and effective.
2096,2298,1,6,26,33,1.2424242424242424,0.08736789844447573,673,Take two aspirin and avoid fox hunting
2834,2298,2,4,27,33,1.2424242424242424,0.09760680853579641,673,"You're right, I did do my residency at Johns Hopkins. But then somebody told me that Baltimore was infested with cardiologists, so  I decided to hang out my shingle here in Omaha."
2024,2298,3,2,28,33,1.2424242424242424,0.1068692119671658,673,"And if you don't get to the end of the maze, you'll remain a mouse forever..."
1947,2298,0,8,25,33,1.2424242424242424,0.07575757575757576,673,I'm sending you to a specialist. He has a nose for these things.
2361,2298,0,8,25,33,1.2424242424242424,0.07575757575757576,673,"You enjoy cheese, correct?"
2861,2298,0,8,25,33,1.2424242424242424,0.07575757575757576,673,Don’t worry.  I have a degree from Johns Hopkins.
3406,2298,1,6,26,33,1.2424242424242424,0.08736789844447573,673,"I'm referring  you to specialist, Dr. Marmot."
3203,2298,0,8,25,33,1.2424242424242424,0.07575757575757576,673,Haven't you ever taken an experimental drug before?
3223,2298,0,8,25,33,1.2424242424242424,0.07575757575757576,673,Here take it. You get used to the side effects.
1866,2298,1,6,26,33,1.2424242424242424,0.08736789844447573,673,Try this.  It's 65% effective in mice.
3709,2298,1,6,26,33,1.2424242424242424,0.08736789844447573,673,Ill give you a second opinion:  Grrrr!
3849,2298,1,6,26,33,1.2424242424242424,0.08736789844447573,673,"Complimentary ticket to the rodent-free section of the Trump Tower Grille, certified by me."
3859,2298,0,8,25,33,1.2424242424242424,0.07575757575757576,673,Many folks who take this say that it has changed their life.  I am one of them.
3867,2298,0,8,25,33,1.2424242424242424,0.07575757575757576,673,"First, quick trying to race against my kind, that you’ll always lose."
3876,2298,0,8,25,33,1.2424242424242424,0.07575757575757576,673,"What,you don't think I'm worth it?"
3962,2298,1,6,26,33,1.2424242424242424,0.08736789844447573,673,Don't worry—I've been rat-ified by the FDA.
4330,2298,2,4,27,33,1.2424242424242424,0.09760680853579641,673,Here's Dr. Rat Cliff's prescription to help deal with your hallucinations.
4385,2298,2,4,27,33,1.2424242424242424,0.09760680853579641,673,"I know it'll work, I've tested it myself!"
4452,2298,0,8,25,33,1.2424242424242424,0.07575757575757576,673,"Don't worry, they are perfectly safe plus I participated in the phase one, clinical trial."
2318,2298,1,6,26,33,1.2424242424242424,0.08736789844447573,673,I know it's a little unorthodox but dairy therapy has seen some really promising results.
2923,2298,1,6,26,33,1.2424242424242424,0.08736789844447573,673,"No, really, all my relatives swear by it."
1840,2298,0,8,25,33,1.2424242424242424,0.07575757575757576,673,"Give this to Trump, it has worked on many of my friends."
3521,2298,0,8,25,33,1.2424242424242424,0.07575757575757576,673,This  prescription is to be taken as a prophylactic.
1768,2298,0,8,25,33,1.2424242424242424,0.07575757575757576,673,"Winner winner, chicken dinner!"
214,2298,2,4,27,33,1.2424242424242424,0.09760680853579641,673,Take two and burrow underground.
43,2298,0,8,25,33,1.2424242424242424,0.07575757575757576,673,Try this rat poison. It worked on my cousin
285,2298,1,6,26,33,1.2424242424242424,0.08736789844447573,673,Take these daily for a month and  I promise you’ll look as good as me.
321,2298,2,4,27,33,1.2424242424242424,0.09760680853579641,673,"Here's a prescription of anticoagulant humanicides, you only need to take one."
397,2298,1,6,26,33,1.2424242424242424,0.08736789844447573,673,Take two of these and the hallucinations should stop - or I could become a shark.
570,2298,2,4,27,33,1.2424242424242424,0.09760680853579641,673,I don't believe you. I smell a human.
720,2298,2,4,27,33,1.2424242424242424,0.09760680853579641,673,Take this meat tenderizer and come to see me at lunch time.
768,2298,1,6,26,33,1.2424242424242424,0.08736789844447573,673,A man in a red suit coat? I was told to expect a little girl with a red cloak and a basket!  I’ll never gobble you in three gulps.
783,2298,2,4,27,33,1.2424242424242424,0.09760680853579641,673,No you’re freaking out!
845,2298,2,4,27,33,1.2424242424242424,0.09760680853579641,673,Try to grab this before I jerk it away.
931,2298,0,8,25,33,1.2424242424242424,0.07575757575757576,673,No need for concern. I have given this same prescription to every patient I’ve seen over the last six months.
936,2298,1,6,26,33,1.2424242424242424,0.08736789844447573,673,I barely squeaked through Veterinary School.
951,2298,2,4,27,33,1.2424242424242424,0.09760680853579641,673,"Is it safe?  Of course it’s safe. Confidentially, I’ve been on the same stuff for years and just look at me."
988,2298,0,8,25,33,1.2424242424242424,0.07575757575757576,673,This will ring when it's your turn in the maze.
1050,2298,0,8,25,33,1.2424242424242424,0.07575757575757576,673,"Try this, it should be more addicting."
1787,2298,1,6,26,33,1.2424242424242424,0.08736789844447573,673,"Here take this as directed with two pounds of cheese a day and
you'll be like new in no time."
1164,2298,2,4,27,33,1.2424242424242424,0.09760680853579641,673,I swear to god Jim if you make one more joke about the rat race I will not hesitate to get HR involved.
1633,2298,0,8,25,33,1.2424242424242424,0.07575757575757576,673,"Trust me, the side effects are extremely rare, I participated in the clinical trials myself."
1599,2298,3,2,28,33,1.2424242424242424,0.1068692119671658,673,I only prescribe opiates that I’ve personally tested.
1126,2298,1,6,26,33,1.2424242424242424,0.08736789844447573,673,"I know what you're thinking, but I graduated at the top of my animal research group."
1561,2298,0,8,25,33,1.2424242424242424,0.07575757575757576,673,Chase rabbits. You get a good run and a healthy diet at the end.
1538,2298,0,8,25,33,1.2424242424242424,0.07575757575757576,673,This has worked well for my friends and relatives.
1534,2298,1,6,26,33,1.2424242424242424,0.08736789844447573,673,"It's perfectly safe. We tested on humans"""
1501,2298,0,8,25,33,1.2424242424242424,0.07575757575757576,673,Not to worry. None of my family members were harmed making this drug
1573,2298,1,6,26,33,1.2424242424242424,0.08736789844447573,673,"...and, good luck with that drug trial"
1350,2298,1,6,26,33,1.2424242424242424,0.08736789844447573,673,I can personally guarantee the research done on this drug.
1330,2298,0,8,25,33,1.2424242424242424,0.07575757575757576,673,This will keep the werewolves away.
1296,2298,1,6,26,33,1.2424242424242424,0.08736789844447573,673,"Trust me, it's safe — I tested it on myself."
1273,2298,2,4,27,33,1.2424242424242424,0.09760680853579641,673,The reason I look strange is your eyes are majorly f’d up.
1224,2298,2,4,27,33,1.2424242424242424,0.09760680853579641,673,"Trust me, I've used this medication myself while working as a lab rat to put myself through Medical School."""
1409,2298,0,8,25,33,1.2424242424242424,0.07575757575757576,673,I'm gonna need you to stop dropping acid before checkups.
12,2362,1,5,23,29,1.2413793103448276,0.09488354819831636,673,Give this to Baltimore and say it's from Dr Trump.
1355,2362,0,7,22,29,1.2413793103448276,0.08086923723833499,673,It's a GOP membership card.
3796,2362,0,7,22,29,1.2413793103448276,0.08086923723833499,673,And finally this one's for the hallucinations.
4501,2362,0,7,22,29,1.2413793103448276,0.08086923723833499,673,Remember it’s two slices of Cheddar and one slice of Havarti right before bed.
4149,2366,2,7,37,46,1.2391304347826086,0.0773022339309831,673,This one is for your delusions of rature.
719,2366,1,9,36,46,1.2391304347826086,0.07077748085260739,673,"We'll have you back to normal in no time - here's a prescription for 2 colonies with four refills. I'd like you to take 35,000 ants and termites daily."
3764,2368,1,8,33,42,1.2380952380952381,0.0747393753458591,673,Trust me. Nine of of ten rat-doctors recommend this medication.
836,2368,1,8,33,42,1.2380952380952381,0.0747393753458591,673,I don't guve as fat rat's ass how you got injured. Just fill this prescription and call me in a week for follow up.
1258,2368,3,4,35,42,1.2380952380952381,0.08893174123309444,673,Do I take it before or after I kill the beast?
3100,2368,1,8,33,42,1.2380952380952381,0.0747393753458591,673,"Side effects may include drowsiness, dry mouth, hallucinations and musophobia."
2240,2372,1,7,30,38,1.236842105263158,0.07942011137921938,673,"Yes, you're right, I did write Trump's greatest physical condition letter."
2515,2372,2,5,31,38,1.236842105263158,0.08792058461005162,673,"If you develop the sudden urge to scavenge or squeak, give me a call."
120,2374,1,6,27,34,1.2352941176470589,0.08505868299779072,673,"Don't be concerned, you are not the first guinea pig"
4210,2374,1,6,27,34,1.2352941176470589,0.08505868299779072,673,"The hallucinations can be rough, rough, rough."
3844,2374,2,4,28,34,1.2352941176470589,0.09496057470137043,673,"I've never told a patient this but, your eyes are beautiful."
3060,2374,1,6,27,34,1.2352941176470589,0.08505868299779072,673,"Take this to your preferred fromager"""
2930,2374,2,4,28,34,1.2352941176470589,0.09496057470137043,673,The card says Jackal but the next printing will say Dr. Jekyll.
2888,2374,1,6,27,34,1.2352941176470589,0.08505868299779072,673,There are side effects but at least the headaches should improve.
2648,2374,0,8,26,34,1.2352941176470589,0.07384069581892327,673,What did you expect a pit bull?
2179,2374,0,8,26,34,1.2352941176470589,0.07384069581892327,673,I can’t tell you if this is for cocaine or the sugar water.
1962,2374,0,8,26,34,1.2352941176470589,0.07384069581892327,673,Lemme tell you: I do this because I'm a friend and I care about you.
1815,2374,2,4,28,34,1.2352941176470589,0.09496057470137043,673,"Wolf by name, wolf by nature."
3366,2374,0,8,26,34,1.2352941176470589,0.07384069581892327,673,Take this referral and chew on it for a week.”
1533,2374,2,4,28,34,1.2352941176470589,0.09496057470137043,673,Wolf one of these down each night at bedtime.
1575,2374,2,4,28,34,1.2352941176470589,0.09496057470137043,673,I have something important to tell you.
277,2374,0,8,26,34,1.2352941176470589,0.07384069581892327,673,Take the vaccines. My people didn't spend years on laboratories for you to simply deny it.
326,2374,0,8,26,34,1.2352941176470589,0.07384069581892327,673,Don't let me find out you're selling these to cheddar addicts.
391,2374,2,4,28,34,1.2352941176470589,0.09496057470137043,673,"I'm giving you a prescription for cheese, specifically Swiss."
280,2374,1,6,27,34,1.2352941176470589,0.08505868299779072,673,"I don’t know how it’s spreading, but this should help you avoid it like the plague."
492,2374,2,4,28,34,1.2352941176470589,0.09496057470137043,673,I suggest you leave Baltimore as soon as you can.
505,2374,1,10,40,51,1.2352941176470589,0.06620369810248677,673,"Take two once a day, with pizza."
584,2374,0,8,26,34,1.2352941176470589,0.07384069581892327,673,"Yes, it’s been tested on humans."
437,2374,1,6,27,34,1.2352941176470589,0.08505868299779072,673,Trust me -- negotiating the healthcare system is a maze...
2499,2395,1,9,37,47,1.2340425531914894,0.06944184742215101,673,"What do you mean when you say ""I smell a rat?"""
3229,2396,1,5,24,30,1.2333333333333334,0.09201865544655373,673,"It's an experimental medicine, but we'll throw you in a blender next week and see if it has potential."
3478,2396,1,5,24,30,1.2333333333333334,0.09201865544655373,673,"How do I know that it’s perfectly safe? Why, they tested it on me."
3442,2396,0,7,23,30,1.2333333333333334,0.07854032324531729,673,"Relax, it's not like rat poison or anything."
3393,2396,1,5,24,30,1.2333333333333334,0.09201865544655373,673,"These pills will fuzz up your skin, grow out your nasal hair and move up you mouth."
3378,2396,0,7,23,30,1.2333333333333334,0.07854032324531729,673,"If you're unable to get this filled here in Baltimore, try the Maralago Pharmacy in D.C."
3234,2396,1,5,24,30,1.2333333333333334,0.09201865544655373,673,"As you can see, it did wonders for me."
3161,2396,1,5,24,30,1.2333333333333334,0.09201865544655373,673,"Your insurance company, the pharmaceutical industry, the healthcare system… Rats, we are all rats."
2859,2396,2,3,25,30,1.2333333333333334,0.10376070318239085,673,"Welcome to the CosLab, I think you'll fit right in."
3042,2396,1,5,24,30,1.2333333333333334,0.09201865544655373,673,And don’t dine in dumpsters.
2918,2396,2,3,25,30,1.2333333333333334,0.10376070318239085,673,Warfarin?  No I wouldn't take it myself.
2882,2396,0,7,23,30,1.2333333333333334,0.07854032324531729,673,"Have no fear. Everything I prescribe,  I test on myself first."
2879,2396,0,7,23,30,1.2333333333333334,0.07854032324531729,673,I’m giving you a repeat prescription for Rogaine.
2847,2396,0,7,23,30,1.2333333333333334,0.07854032324531729,673,Studies with lab rodents have shown this medication to be highly effective.
3606,2396,0,7,23,30,1.2333333333333334,0.07854032324531729,673,"Here we go, blue cheese twice a day."
2776,2396,1,5,24,30,1.2333333333333334,0.09201865544655373,673,"You can get this filled at the pharmacy.
Just go around back by the dumpster."
3151,2396,0,7,23,30,1.2333333333333334,0.07854032324531729,673,Best Price at Pets Are Us
3610,2396,1,5,24,30,1.2333333333333334,0.09201865544655373,673,It's just an allergy. Take these daily and have your cat boiled alive
2215,2396,1,5,24,30,1.2333333333333334,0.09201865544655373,673,Just in case you ever do have chronic pain.
3705,2396,1,5,24,30,1.2333333333333334,0.09201865544655373,673,It's not rat poison!
2676,2396,1,5,24,30,1.2333333333333334,0.09201865544655373,673,Check it.  It's a real doctor's license. I just didn't have this mustache when I took the picture.
3447,2396,1,5,24,30,1.2333333333333334,0.09201865544655373,673,"If it worked for me, it'll work for you."
4546,2396,2,3,25,30,1.2333333333333334,0.10376070318239085,673,"This will take  care of your ED, just as I did."
4428,2396,1,5,24,30,1.2333333333333334,0.09201865544655373,673,"It's okay, I always prescribe cheese."
4394,2396,0,7,23,30,1.2333333333333334,0.07854032324531729,673,Take two and squeak for me in the morning.
4389,2396,1,5,24,30,1.2333333333333334,0.09201865544655373,673,"It’s your next appointment, not the bubonic plague."
4374,2396,1,5,24,30,1.2333333333333334,0.09201865544655373,673,I can testify that this drug had a really positive effect onme.
3616,2396,1,5,24,30,1.2333333333333334,0.09201865544655373,673,"Here, take an ounce of provolone twice
 a day for a week, stay away from those pellets and call me in a week."
4307,2396,1,5,24,30,1.2333333333333334,0.09201865544655373,673,"I've taken this myself for years...
This will bring out your inner self..."
4223,2396,0,7,23,30,1.2333333333333334,0.07854032324531729,673,"Take three a day with cheese, it's worked wonders on me."
4162,2396,0,7,23,30,1.2333333333333334,0.07854032324531729,673,"Just because i was caught on You Tube eating a slice of pizza in the subway, still doesn't mean that i'm not a damn good doctor!"
4144,2396,1,5,24,30,1.2333333333333334,0.09201865544655373,673,"Before taking, hide this in liverwurst."
4071,2396,1,5,24,30,1.2333333333333334,0.09201865544655373,673,"Our motto? ""Your money or your life"". Why do you ask?"
4017,2396,1,5,24,30,1.2333333333333334,0.09201865544655373,673,Take this prescription and avoid human contact like the plague.
3785,2396,1,5,24,30,1.2333333333333334,0.09201865544655373,673,YOU be responsible for a nationwide opiod epidemic and see what you look like!
3767,2396,1,5,24,30,1.2333333333333334,0.09201865544655373,673,It’s all in your head.
4262,2396,0,7,23,30,1.2333333333333334,0.07854032324531729,673,"OK OK, I was wrong about the trashcan on 7th and 11th."
2671,2396,0,7,23,30,1.2333333333333334,0.07854032324531729,673,"I don't know, they worked on me."
1887,2396,1,5,24,30,1.2333333333333334,0.09201865544655373,673,It's a prescription for bug eye.
2603,2396,2,3,25,30,1.2333333333333334,0.10376070318239085,673,"It's alternative rodent medicine, and highly recommended."
1238,2396,1,5,24,30,1.2333333333333334,0.09201865544655373,673,"Believe me, it works I use it myself"
1226,2396,0,7,23,30,1.2333333333333334,0.07854032324531729,673,"Yes, yes, I know rats are not people, but this was a wonder drug for over 50% of  my cage-mate's litter."
1032,2396,1,5,24,30,1.2333333333333334,0.09201865544655373,673,Take two of cheese and call me in the morning.
957,2396,0,7,23,30,1.2333333333333334,0.07854032324531729,673,Take it with grubs.
887,2396,0,7,23,30,1.2333333333333334,0.07854032324531729,673,I've personally tested this one.
722,2396,0,7,23,30,1.2333333333333334,0.07854032324531729,673,It’s recommended by 9 out of 10 rats...
1333,2396,1,5,24,30,1.2333333333333334,0.09201865544655373,673,Take two of these every fours with cheese.
657,2396,0,7,23,30,1.2333333333333334,0.07854032324531729,673,I wouldn’t prescribe this if I didn’t test it myself.
601,2396,1,5,24,30,1.2333333333333334,0.09201865544655373,673,It's a living!
523,2396,2,3,25,30,1.2333333333333334,0.10376070318239085,673,We are an upward bound firm. Shaving is out of style.
478,2396,1,5,24,30,1.2333333333333334,0.09201865544655373,673,Let's see if these don't help with the hallucinations.
448,2396,0,7,23,30,1.2333333333333334,0.07854032324531729,673,But I'm allergic to Munster!
376,2396,1,5,24,30,1.2333333333333334,0.09201865544655373,673,"The first symptom is the eyes, why do you ask?"
331,2396,0,7,23,30,1.2333333333333334,0.07854032324531729,673,Take two pieces of cheddar twice a day and see me in a month!
635,2396,1,5,24,30,1.2333333333333334,0.09201865544655373,673,believe me - I’ve seen some positive results with this stuff.
1367,2396,2,3,25,30,1.2333333333333334,0.10376070318239085,673,Take two of these and you won’t see all doctors as pill-pushing money-grabbing hyenas.
1286,2396,0,7,23,30,1.2333333333333334,0.07854032324531729,673,"I'll refill it, but don't hesitate to call about any side effects."
1701,2396,0,7,23,30,1.2333333333333334,0.07854032324531729,673,Give this to your cat to make him sleep.
2584,2396,0,7,23,30,1.2333333333333334,0.07854032324531729,673,I  can see you're worried about my online diplomas...
2581,2396,1,5,24,30,1.2333333333333334,0.09201865544655373,673,Let's role play for a moment here.
2536,2396,2,3,25,30,1.2333333333333334,0.10376070318239085,673,"Actually, its pro-anxiety."
2520,2396,1,5,24,30,1.2333333333333334,0.09201865544655373,673,This new medicine is safe. I was part of the clinical trials. There were no side effects in the mouse studies.
2286,2396,1,5,24,30,1.2333333333333334,0.09201865544655373,673,"Thank goodness for technology.
I wasn't able to keep up with all my kids until I had a smartphone."
1517,2396,1,5,24,30,1.2333333333333334,0.09201865544655373,673,"Next time, my advice is to just let the cat sleep."
2640,2396,0,7,23,30,1.2333333333333334,0.07854032324531729,673,It works. Trust me!
2256,2396,1,5,24,30,1.2333333333333334,0.09201865544655373,673,"I am recommending you eat a piece of cheese, always makes me feel better"""
1972,2396,1,5,24,30,1.2333333333333334,0.09201865544655373,673,"Take three slices of cheese in the morning, then three slices of cheese at bedtime."
1935,2396,1,5,24,30,1.2333333333333334,0.09201865544655373,673,"I've never seen such a severe stigmatism. If  this doesn't work, you will have to consult Dr Baer."
223,2396,0,7,23,30,1.2333333333333334,0.07854032324531729,673,"I prescribe you with a bottle of whisker growth, and you should get a lifetime supply of tuna cans."
1862,2396,1,5,24,30,1.2333333333333334,0.09201865544655373,673,"Trust me, I'm a real doctor."
1767,2396,0,7,23,30,1.2333333333333334,0.07854032324531729,673,"Yes some side effects, but worked for me!"
1757,2396,1,5,24,30,1.2333333333333334,0.09201865544655373,673,"Don't worry, lupus is my specialty."
2192,2396,1,5,24,30,1.2333333333333334,0.09201865544655373,673,I don't see anything wrong with you?
3411,2468,1,8,34,43,1.2325581395348837,0.07319030627622727,673,"This should help with your completely irrational fear of all medical doctors, who made it."
3232,2469,1,7,31,39,1.2307692307692308,0.0775949069444807,673,The position is in our Human Resources department.
309,2469,2,2,22,26,1.2307692307692308,0.11512791959304433,673,"I’m recommending regular chewing gum, the kind with sugar."
1652,2469,1,7,31,39,1.2307692307692308,0.0775949069444807,673,Doctor...I think you have given me the wrong medication
2783,2472,0,8,27,35,1.2285714285714286,0.0720144043214405,673,Don't be startled. Wearing this weasel head is part of my probation.
1348,2472,2,4,29,35,1.2285714285714286,0.09245225236621893,673,What did you expect from socialized medicine?
2471,2472,2,4,29,35,1.2285714285714286,0.09245225236621893,673,"Yes, I took it myself, but don't worry, this side effect is rare."
2,2475,1,8,35,44,1.2272727272727273,0.07170261260935148,673,Here's the number of a guy I know who studies your condition.
2670,2475,1,8,35,44,1.2272727272727273,0.07170261260935148,673,"Trust me, Wolf these down and you’ll relax."
3101,2477,2,3,26,31,1.2258064516129032,0.10063964694019434,673,"It's the same prescription I take,what's the problem?"
3082,2477,0,7,24,31,1.2258064516129032,0.07633651333031764,673,"Yes, I know it seems unusual. But I assure you, only I can validate your parking"
2965,2477,2,3,26,31,1.2258064516129032,0.10063964694019434,673,"I'd like to refer you to Dr. that specializes in rat-bastards.
I specialize in possum-bastards."
2959,2477,2,3,26,31,1.2258064516129032,0.10063964694019434,673,This will help with your betrayal issues
2928,2477,2,3,26,31,1.2258064516129032,0.10063964694019434,673,"This won't work for you, but it's covered by insurance."
2904,2477,1,5,25,31,1.2258064516129032,0.08931853616040941,673,You may experience a strong desire to eat moldy cheese.
2653,2477,1,5,25,31,1.2258064516129032,0.08931853616040941,673,Ive booked you a maze test.  Look what it did for me.
2249,2477,1,5,25,31,1.2258064516129032,0.08931853616040941,673,No. No side effects. Why do you ask?
2595,2477,1,5,25,31,1.2258064516129032,0.08931853616040941,673,Here's where I got the shrew mask. So tell me your symptoms.
2574,2477,3,1,27,31,1.2258064516129032,0.1108100905633398,673,It’s a referral for my colleague in Baltimore.
2409,2477,1,5,25,31,1.2258064516129032,0.08931853616040941,673,"Hey, the maze and education was easy. Getting insurance coverage is the hard part."
2397,2477,1,5,25,31,1.2258064516129032,0.08931853616040941,673,Take two ounces of Gorgonzola every six hours for ten days.
2375,2477,0,7,24,31,1.2258064516129032,0.07633651333031764,673,Does your insurance cover out-of-species providers?
2357,2477,1,5,25,31,1.2258064516129032,0.08931853616040941,673,But I did stay in a Holiday Inn last night.
3112,2477,1,5,25,31,1.2258064516129032,0.08931853616040941,673,"I'm not saying it's a trap, but I'd recommend taking this with a small wedge of cheese"
2647,2477,1,5,25,31,1.2258064516129032,0.08931853616040941,673,"Quick! Call the lab.  The trial sample was supposed to hurt you, not me."
3127,2477,1,5,25,31,1.2258064516129032,0.08931853616040941,673,What did you say you smell?
3269,2477,0,7,24,31,1.2258064516129032,0.07633651333031764,673,Johns Hopkins obviously.
4201,2477,0,7,24,31,1.2258064516129032,0.07633651333031764,673,I think the cheese will help. This card will get you through the maze.
4190,2477,1,5,25,31,1.2258064516129032,0.08931853616040941,673,"Lice, mice, whatever it’ll get rid of it. Take two and call me tomorrow."
4167,2477,0,7,24,31,1.2258064516129032,0.07633651333031764,673,Take these pills along with a box of Kibble  Works for me.
4143,2477,0,7,24,31,1.2258064516129032,0.07633651333031764,673,"Look, I know doctors make some people nervous. If it helps, I'm just like you and put my shoes on one paw at a time."
4130,2477,2,3,26,31,1.2258064516129032,0.10063964694019434,673,"Quite frankly, Peter, your only option is the Keto diet."
3899,2477,0,7,24,31,1.2258064516129032,0.07633651333031764,673,"No, really, this prescription will help stop your hallucinations!"
4566,2477,1,5,25,31,1.2258064516129032,0.08931853616040941,673,Take two tablets before bedtime and try hard to forget this meeting.
3848,2477,1,5,25,31,1.2258064516129032,0.08931853616040941,673,Here. Just don't rat me out for this.
3773,2477,0,7,24,31,1.2258064516129032,0.07633651333031764,673,Many members of my family have used this drug.
3644,2477,0,7,24,31,1.2258064516129032,0.07633651333031764,673,Some days I feel trapped as well.
3639,2477,2,3,26,31,1.2258064516129032,0.10063964694019434,673,Take 20 aspirin and call me in the morning.
3579,2477,2,3,26,31,1.2258064516129032,0.10063964694019434,673,Face it. Rats rule Baltimore.
4235,2477,1,5,25,31,1.2258064516129032,0.08931853616040941,673,"I have no idea what’s wrong with you, but here’s a coupon for cheese."
3290,2477,1,5,25,31,1.2258064516129032,0.08931853616040941,673,"You need cheese, dammit, lots of cheese! Take this 'scrip to the dairy counter and don't get lost in the maze!"
3776,2477,2,3,26,31,1.2258064516129032,0.10063964694019434,673,Please don’t confuse your Google search with my maze running degree.
2212,2477,0,7,24,31,1.2258064516129032,0.07633651333031764,673,Take all the pills from this prescription and  I'll look like my own self again on your next visit.
1165,2477,2,3,26,31,1.2258064516129032,0.10063964694019434,673,"Take this twice daily with cheese, and let's avoid maze running for a few days."
1998,2477,0,7,24,31,1.2258064516129032,0.07633651333031764,673,"This is more of an old family remedy, but when my children aren't thriving, I eat them."
57,2477,1,5,25,31,1.2258064516129032,0.08931853616040941,673,"It’s just a cold, not the bubonic plague or anything."
83,2477,1,5,25,31,1.2258064516129032,0.08931853616040941,673,I have personally tested this drug-- it worked wonders!
193,2477,0,7,24,31,1.2258064516129032,0.07633651333031764,673,We don't honor any card that has been used at a cat house.
514,2477,2,3,26,31,1.2258064516129032,0.10063964694019434,673,"You know, you are what you eat."
595,2477,2,3,26,31,1.2258064516129032,0.10063964694019434,673,Rats in Baltimore?  More like the White House
621,2477,1,5,25,31,1.2258064516129032,0.08931853616040941,673,Would you like some rat cheese?
743,2477,1,5,25,31,1.2258064516129032,0.08931853616040941,673,"I can assure you that, after extensive personal experimentation, this drug has no perceptible side effects, apart from a maniacal obsession for cheese."
803,2477,1,5,25,31,1.2258064516129032,0.08931853616040941,673,It’s okay—you’re just a little horse.
839,2477,1,5,25,31,1.2258064516129032,0.08931853616040941,673,"No, No, I'm Karl Samsa.  Your thinking of Gregor."
860,2477,1,5,25,31,1.2258064516129032,0.08931853616040941,673,Don't worry about his new drug. It worked on me.
875,2477,1,5,25,31,1.2258064516129032,0.08931853616040941,673,Let's double down on the Ambien.
2040,2477,0,7,24,31,1.2258064516129032,0.07633651333031764,673,There may be some side effects.
1045,2477,1,5,25,31,1.2258064516129032,0.08931853616040941,673,Let me assure you I’m a fully qualified doctor as well as your best friend.
1076,2477,0,7,24,31,1.2258064516129032,0.07633651333031764,673,Just take two Advil and try to stay out of the rat race for a while
1098,2477,0,7,24,31,1.2258064516129032,0.07633651333031764,673,"Here's a prescription that should help with the hallucinations, and by the way thanks for the basket of goodies."
883,2477,0,7,24,31,1.2258064516129032,0.07633651333031764,673,It's bubonic plague. Seems to be going around recently.
1225,2477,1,5,25,31,1.2258064516129032,0.08931853616040941,673,"It'll end the hallucinations, but give me a call if that side effect lasts longer than four hours."
1997,2477,1,5,25,31,1.2258064516129032,0.08931853616040941,673,baltimore doctor ?
1990,2477,0,7,24,31,1.2258064516129032,0.07633651333031764,673,"I know this drug is effective, my cousins were involved in the original clinical lab tests."
1978,2477,2,3,26,31,1.2258064516129032,0.10063964694019434,673,Take one of these next time she's in heat.
1155,2477,0,7,24,31,1.2258064516129032,0.07633651333031764,673,"We accept Visa, Mastercard, American Express, and hunks of cheddar cheese."
19,2477,1,5,25,31,1.2258064516129032,0.08931853616040941,673,Look! Does that say RAT to you?
1720,2477,1,5,25,31,1.2258064516129032,0.08931853616040941,673,"Don't worry, there are no side effects. I take two a day."
1715,2477,0,7,24,31,1.2258064516129032,0.07633651333031764,673,"Sir, it's inappropriate to call me foxy."
1964,2477,1,5,25,31,1.2258064516129032,0.08931853616040941,673,We just call it poison.
1626,2477,1,5,25,31,1.2258064516129032,0.08931853616040941,673,Payment accepted in camembert.
1576,2477,1,5,25,31,1.2258064516129032,0.08931853616040941,673,Everybody knows that rat poison in small doses is good for you.
1497,2477,0,7,24,31,1.2258064516129032,0.07633651333031764,673,I have your diagnosis--you need a new head to express your inner animal spirits--right now there's a sale on hybrids at wolvesareus.com
1378,2477,1,5,25,31,1.2258064516129032,0.08931853616040941,673,"What? You think mice can't be doctors? I'm referring you to a psychologist. Here, he is a good mouse friend of mine."
1373,2477,2,3,26,31,1.2258064516129032,0.10063964694019434,673,Sheep's milk brie only. No generics.
1260,2477,1,5,25,31,1.2258064516129032,0.08931853616040941,673,Take two cubes of mozzarella and stay away from cats for a while.
1677,2477,0,7,24,31,1.2258064516129032,0.07633651333031764,673,Yes—insurance pays for it—what's the harm?
1331,2545,2,5,33,40,1.225,0.08387643536927646,673,Double or nothing for your medical bill.
1753,2545,1,7,32,40,1.225,0.07584988548577466,673,Now I'm going to ask you a series of questions about cheese...
3840,2545,2,5,33,40,1.225,0.08387643536927646,673,"I don’t have to literally hand this to you under the table, but it wouldn’t hurt."
3299,2548,1,4,22,27,1.2222222222222223,0.09745089103411433,673,"Pick a card, any card, and we'll find out what's wrong with you."""
3062,2548,2,2,23,27,1.2222222222222223,0.11111111111111109,673,This should alleviate your Baltimore fixation-itus.
3084,2548,1,4,22,27,1.2222222222222223,0.09745089103411433,673,"Well, I was expecting a normal-sized mouse too, but IT hasn't gotten back to me yet."
3149,2548,0,6,21,27,1.2222222222222223,0.0815332650783714,673,This script has a side effect that might leave you mousy. Just keep away from cats ok.
4096,2548,2,2,23,27,1.2222222222222223,0.11111111111111109,673,"I'm doing this for you as a favor, Lenny, but if you tell anyone-- well, let's just say that I know some guys."
3443,2548,2,4,30,36,1.2222222222222223,0.09007149815308639,673,They're 98% effective. Plus I take them myself.
4386,2548,0,6,21,27,1.2222222222222223,0.0815332650783714,673,I was suffering from the same thing. Look at me now.
4434,2548,0,8,28,36,1.2222222222222223,0.07027283689263064,673,"The  tests are fine, so since your insurance company is on board Doctor Moreau will schedule surgery once he's back from his Caribbean vacation."
4441,2548,1,4,22,27,1.2222222222222223,0.09745089103411433,673,Of course its legal !!  I'm a doctor.
2665,2548,0,10,35,45,1.2222222222222223,0.06267511942419622,673,Take two tablets nightly and see me on the next full moon.
4379,2548,1,4,22,27,1.2222222222222223,0.09745089103411433,673,"OK, 15 apiece, do it for Bill & Hillary"
2106,2548,1,4,22,27,1.2222222222222223,0.09745089103411433,673,It's only a temporary side effect. In a week you'll look like me again.
2716,2548,1,4,22,27,1.2222222222222223,0.09745089103411433,673,You may find yourself howling at the moon
1871,2548,1,4,22,27,1.2222222222222223,0.09745089103411433,673,This one should work. Your eyes were going to bulge; it's not a side effect.
1741,2548,0,6,21,27,1.2222222222222223,0.0815332650783714,673,Side effects include hallucinations and  bulging eyes.
2001,2548,2,4,30,36,1.2222222222222223,0.09007149815308639,673,"We’re called “The AristocRATS”. We play every Friday at 8pm, you should stop by!"
1456,2548,1,4,22,27,1.2222222222222223,0.09745089103411433,673,There will be two of these waiting each time you successfully navigate the maze.
1168,2548,1,4,22,27,1.2222222222222223,0.09745089103411433,673,When you haven't slept in so long you start to hallucinate
1061,2548,0,6,21,27,1.2222222222222223,0.0815332650783714,673,Control-group patients meet Dr House.
932,2548,1,4,22,27,1.2222222222222223,0.09745089103411433,673,Take this.  It will help to get ride of your  delusions
586,2548,1,4,22,27,1.2222222222222223,0.09745089103411433,673,Eat two chickens and call me in the morning.
473,2548,1,4,22,27,1.2222222222222223,0.09745089103411433,673,So you're the one who ratted me out!
187,2548,0,6,21,27,1.2222222222222223,0.0815332650783714,673,Don't worry about any side effects.
81,2548,0,6,21,27,1.2222222222222223,0.0815332650783714,673,These were not tested on humans.
52,2548,0,6,21,27,1.2222222222222223,0.0815332650783714,673,Happy to report that there is neigh-thing wrong with you.
1421,2573,1,7,33,41,1.2195121951219512,0.07418003085729535,673,The race chose me.
708,2573,2,5,34,41,1.2195121951219512,0.0819889576291298,673,"I care enough to give a rats ass-pirin, twice a day, with food."
4482,2575,1,5,26,32,1.21875,0.08676970585889242,673,Try these they always make me feel foxy
4396,2575,2,3,27,32,1.21875,0.09769908334829336,673,"As the new head of the CDC, I'm one of the more credible Presidential appointments."
4270,2575,1,5,26,32,1.21875,0.08676970585889242,673,HERE'S  YOUR VIAGRA.  DON'T THINK OF ME WHEN YOU TAKE IT!
4092,2575,1,5,26,32,1.21875,0.08676970585889242,673,"Here, take my card and call me whenever you have a cold or if there´s a ball to be fetched."
3438,2575,0,7,25,32,1.21875,0.07424858801742054,673,Did I say “strychnine”?
3155,2575,1,5,26,32,1.21875,0.08676970585889242,673,We got the lab tests back. I’m prescribing fortified seeds to be taken twice a day.
3018,2575,1,5,26,32,1.21875,0.08676970585889242,673,This stuff got me through medical school.
2958,2575,2,3,27,32,1.21875,0.09769908334829336,673,"I recommend reading ""Little Red Riding Hood"" before our next appointment."
2951,2575,0,7,25,32,1.21875,0.07424858801742054,673,"Take it from a lab rat, this cure works."
2791,2575,1,5,26,32,1.21875,0.08676970585889242,673,This should help with your itchy ass.
2482,2575,1,5,26,32,1.21875,0.08676970585889242,673,"Turophobia? Let's start with some maze therapy."""
2201,2575,1,5,26,32,1.21875,0.08676970585889242,673,...And be sure to take it with cheese.
1893,2575,0,7,25,32,1.21875,0.07424858801742054,673,I told you I’m not interested in the nose Rogaine prescription.
987,2575,1,5,26,32,1.21875,0.08676970585889242,673,Call this number if you get sick and tired of the rat race.
1714,2575,1,5,26,32,1.21875,0.08676970585889242,673,"After reading this, you'll know what the fox says."
1073,2575,1,5,26,32,1.21875,0.08676970585889242,673,"One tablet three times a day, and stop watching Donnie Darko every night."
1043,2575,1,5,26,32,1.21875,0.08676970585889242,673,Send for the big cheese.
999,2575,1,5,26,32,1.21875,0.08676970585889242,673,Well of course I still prescribe warfarin.
4537,2575,0,7,25,32,1.21875,0.07424858801742054,673,It's a blood thinner.It's not going to kill you.
793,2575,1,5,26,32,1.21875,0.08676970585889242,673,"Look, my cousin is way more relaxed now when he is forced to swim. I think this could really help."
736,2575,2,3,27,32,1.21875,0.09769908334829336,673,This prescription will take away your tendencies toward misidentification.
694,2575,0,7,25,32,1.21875,0.07424858801742054,673,"Seriously Doc, you’ve got to stop coming straight to work from Epstein’s Eyes Wide Shut parties!"
423,2575,2,3,27,32,1.21875,0.09769908334829336,673,"As White House physician, I have to prescribe these to all staff."
312,2575,2,3,27,32,1.21875,0.09769908334829336,673,"This may seem like a large number, but in my experience, 
you have to consume large quantities of any medication."
180,2575,1,5,26,32,1.21875,0.08676970585889242,673,This will help with the hallucinations.
2355,2575,1,5,26,32,1.21875,0.08676970585889242,673,This will do wonders for your tail and whiskers!
1789,2575,2,3,27,32,1.21875,0.09769908334829336,673,"The better to diagnose you, my dear."
1996,2602,1,3,19,23,1.2173913043478262,0.10810114095792364,673,Take two of these and ferret me out in the morning.
1696,2602,0,5,18,23,1.2173913043478262,0.08793911249520546,673,"Take it from me, this stuff works."
1163,2602,0,5,18,23,1.2173913043478262,0.08793911249520546,673,"Don't worry, it's not poison !"
711,2602,0,5,18,23,1.2173913043478262,0.08793911249520546,673,I’m your lawyer; trust me!
135,2606,2,4,31,37,1.2162162162162162,0.08780895806134204,673,This should help with the hallucinations . . .
1306,2606,1,6,30,37,1.2162162162162162,0.07879664722763921,673,Take two D-cons and call me in the morning.
2876,2606,1,6,30,37,1.2162162162162162,0.07879664722763921,673,"""Doc, maybe I should stop using generic pills."""
2999,2606,1,6,30,37,1.2162162162162162,0.07879664722763921,673,"I'm telling you, everybody's going to avoid you like the plague if you get a reputation as a carrier."
4185,2606,3,2,32,37,1.2162162162162162,0.09597871960658792,673,It's gouda that you came in today!
4397,2606,2,4,31,37,1.2162162162162162,0.08780895806134204,673,"Yeah, we'll have that massive schnoz fixed up in no time."
3213,2612,0,9,33,42,1.2142857142857142,0.06408213992247219,673,"What? It's casual Dr. Jackal day"""
3083,2612,1,4,23,28,1.2142857142857142,0.09424081021458665,673,"Don't worry, it's been tested in mice."
3069,2612,1,4,23,28,1.2142857142857142,0.09424081021458665,673,"TAKE TWO TABS BY MOUTH EVERY 8 HOURS
AS NEEDED FOR ANXIETY 
FOR 30 DAYS
BEGIN DETOX AT:  ‘I Don’t Give a Rat’s Ass Rehab’
FOR THE NEXT 30 YEARS"
3034,2612,0,6,22,28,1.2142857142857142,0.07896725691322382,673,Hopefully you won't have the same side effects as we did.
2887,2612,0,6,22,28,1.2142857142857142,0.07896725691322382,673,I'm prescribing you warfarin for your heart condition. Wouldn't touch the stuff myself but I think you'll find it very helpful.
2858,2612,1,4,23,28,1.2142857142857142,0.09424081021458665,673,"Of course, it’s a good prescription! Who would know better than me? I was the test subject!"
2797,2612,1,4,23,28,1.2142857142857142,0.09424081021458665,673,Cheese is good for you!
2576,2612,0,6,22,28,1.2142857142857142,0.07896725691322382,673,"Don't be afraid, I tested it myself."
2610,2612,1,4,23,28,1.2142857142857142,0.09424081021458665,673,"With rare exceptions,I skip the fiction."
2590,2612,1,4,23,28,1.2142857142857142,0.09424081021458665,673,We’ll try this first....it’s topical.  If you still have that odd appearance after three months we’ll think about surgery.
3271,2612,1,4,23,28,1.2142857142857142,0.09424081021458665,673,I can’t find any humor in your euphemistic use of the term ‘rat poison’.
2534,2612,1,4,23,28,1.2142857142857142,0.09424081021458665,673,I won't tell anyone about your opioid addiction--I'm not that kind of rat.
2481,2612,0,6,22,28,1.2142857142857142,0.07896725691322382,673,You should try this new massage service.
2237,2612,0,6,22,28,1.2142857142857142,0.07896725691322382,673,"Side effects may include dizziness, vomiting, and an increased appetite for cheese."
2173,2612,0,6,22,28,1.2142857142857142,0.07896725691322382,673,"No, no, no. It's not a referral. It's a ticket to Into the Woods. I hope you sort it all out."
2619,2612,0,6,22,28,1.2142857142857142,0.07896725691322382,673,"No, I’ve never seen “Doctor Strange.” Why do you ask?"
3334,2612,2,2,24,28,1.2142857142857142,0.10736308935292606,673,Don't you love opposite day?
3388,2612,0,6,22,28,1.2142857142857142,0.07896725691322382,673,Take my word. We are the best in the world for organ transplants.
3348,2612,1,4,23,28,1.2142857142857142,0.09424081021458665,673,The results are promising in the human trail.
4568,2612,0,6,22,28,1.2142857142857142,0.07896725691322382,673,"Don't be such a human! With all the latest medical advances, we think it's your turn to contribute to science."
4562,2612,1,4,23,28,1.2142857142857142,0.09424081021458665,673,"Here you are Mr. Willard, I prescribe this to all my patients who want to rejoin the rat race."
4539,2612,1,4,23,28,1.2142857142857142,0.09424081021458665,673,I’m afraid you’ll have to get used to my good looks Mr Jenkins because I’m the only Doc within 100 miles who’s willing to take Medicaid patients.
4341,2612,0,6,22,28,1.2142857142857142,0.07896725691322382,673,"Take this and, oh, what big (cough) you'll have!"
4333,2612,0,6,22,28,1.2142857142857142,0.07896725691322382,673,Apply here. I happen to know there's a vacancy in their lab.
4265,2612,1,4,23,28,1.2142857142857142,0.09424081021458665,673,Just a few lab tests...no need to worry.
4240,2612,0,6,22,28,1.2142857142857142,0.07896725691322382,673,This side effects for this new prescription don't include hallucinations. But it will burn when you pee.
4137,2612,0,6,22,28,1.2142857142857142,0.07896725691322382,673,"The side effects are modest, I take it twice a day."
4022,2612,1,4,23,28,1.2142857142857142,0.09424081021458665,673,If you see a cat in the lobby hand him this catnip and tell him to go away
3677,2612,1,4,23,28,1.2142857142857142,0.09424081021458665,673,"Look, I have no idea what I'm doing. Dr. Stevens no longer takes insurance. I'm just his stand-in. Here's a prescription of bourbon for your troubles."
3648,2612,0,6,22,28,1.2142857142857142,0.07896725691322382,673,Take your medication or the hallucinations will continue.
3602,2612,1,4,23,28,1.2142857142857142,0.09424081021458665,673,I was the test subject and nothing happened to me!
3549,2612,1,4,23,28,1.2142857142857142,0.09424081021458665,673,How do you think I got through the maze?
3461,2612,0,6,22,28,1.2142857142857142,0.07896725691322382,673,This prescription will help you learn to enjoy rats.
2068,2612,0,6,22,28,1.2142857142857142,0.07896725691322382,673,"That was before Elizabeth Warren, so get used to it."
3336,2612,0,6,22,28,1.2142857142857142,0.07896725691322382,673,This will get you back in the race.
1952,2612,0,6,22,28,1.2142857142857142,0.07896725691322382,673,I know the bubonic plague when I see it.
2088,2612,2,2,24,28,1.2142857142857142,0.10736308935292606,673,Welcome to Baltimore.  This will get you one can of Raid.
1800,2612,0,6,22,28,1.2142857142857142,0.07896725691322382,673,Here is the number of an associate who can help you. I am dropping out of the rat race.
713,2612,1,4,23,28,1.2142857142857142,0.09424081021458665,673,the side effects are minimal. I take it myself
700,2612,1,4,23,28,1.2142857142857142,0.09424081021458665,673,Pizza Rat swears by it for indigestion.
527,2612,0,6,22,28,1.2142857142857142,0.07896725691322382,673,That’s true but your condition is no fairytale.
480,2612,0,6,22,28,1.2142857142857142,0.07896725691322382,673,I am not part of the rat race that has created your anxiety.
439,2612,1,4,23,28,1.2142857142857142,0.09424081021458665,673,"Don’t get catty with me, sir."
430,2612,0,6,22,28,1.2142857142857142,0.07896725691322382,673,"Here is a little something for the pain in the meantime, but we're going to have to run some further expiremen- er, tests."
398,2612,0,6,22,28,1.2142857142857142,0.07896725691322382,673,I swear by it... the only side effect is some minor shedding
343,2612,1,4,23,28,1.2142857142857142,0.09424081021458665,673,"Well, yes, it has been animal tested."
244,2612,1,4,23,28,1.2142857142857142,0.09424081021458665,673,"Don't look shocked. Corporate WealthCare ""infestation"" was here way before Trump got into the act."
230,2612,1,4,23,28,1.2142857142857142,0.09424081021458665,673,"I'm the one doctor out of  ten, who thinks nicotine is okay."
204,2612,0,6,22,28,1.2142857142857142,0.07896725691322382,673,"Take two of these AFTER a meal. I didn't, and well, I'm sure I don't have to tell you what happened next."
130,2612,0,6,22,28,1.2142857142857142,0.07896725691322382,673,"Trust me, I have extensive knowledge of infectious diseases."
58,2612,1,4,23,28,1.2142857142857142,0.09424081021458665,673,"No problem. We have been seeing this a lot with people who have been spending too much time in Canada, Colorado or Washington State."
11,2612,1,4,23,28,1.2142857142857142,0.09424081021458665,673,"Take one, per day, in a saucer of milk."
1813,2612,0,6,22,28,1.2142857142857142,0.07896725691322382,673,"After you take these pills, I won't look like such a rat."
800,2612,2,2,24,28,1.2142857142857142,0.10736308935292606,673,"Worry not, it's only an antihistamine.  It's not like it's rat poison or anything."
827,2612,1,4,23,28,1.2142857142857142,0.09424081021458665,673,Thank you for your payment. What made you choose Johns Hopkins Hospital in Baltimore anyway?
628,2612,1,4,23,28,1.2142857142857142,0.09424081021458665,673,I’m hiding. I don’t want anyone to know I voted for that animal!
861,2612,2,2,24,28,1.2142857142857142,0.10736308935292606,673,Rats!  I never expected that.
1797,2612,1,4,23,28,1.2142857142857142,0.09424081021458665,673,"Black is my name, Black Death. But dont worry its just the alias I got from the time in my metal band."
1773,2612,1,4,23,28,1.2142857142857142,0.09424081021458665,673,Use this to contact us from inside the maze. Good luck.
1716,2612,0,6,22,28,1.2142857142857142,0.07896725691322382,673,I can do a house call at the henhouse.
846,2612,1,4,23,28,1.2142857142857142,0.09424081021458665,673,"The side effects aren't that bad, Bob. I've been taking it for years and have only noticed an increased appetite for cheese."
1695,2612,0,6,22,28,1.2142857142857142,0.07896725691322382,673,"Unfortunately, your tests show that you’ll start transformation in about a week."
1559,2612,0,6,22,28,1.2142857142857142,0.07896725691322382,673,Not more rat poison?
1427,2612,3,0,25,28,1.2142857142857142,0.11904761904761905,673,"Listen, I'm the best Dr. in Baltimore- take two and call me in the morning."
1710,2612,0,6,22,28,1.2142857142857142,0.07896725691322382,673,"What's wrong, do you smell a rat??"
1297,2612,0,6,22,28,1.2142857142857142,0.07896725691322382,673,"Using the term experiment doesn't seem quite appropriate now, does it?"
1283,2612,2,2,24,28,1.2142857142857142,0.10736308935292606,673,This will help you huff and puff better.
1274,2612,1,4,23,28,1.2142857142857142,0.09424081021458665,673,Side effects include the sudden urge to jump on an exercise wheel.
1022,2612,1,4,23,28,1.2142857142857142,0.09424081021458665,673,"30,000 ants q.d."
1013,2612,2,2,24,28,1.2142857142857142,0.10736308935292606,673,"Don't worry about anything, the only things that really counts are the billing codes I enter."
926,2612,0,6,22,28,1.2142857142857142,0.07896725691322382,673,Here's the referral to Johns Hopkins for your Bug-Eye Syndrome. Baltimore is lovely this time of year.
1410,2612,1,4,23,28,1.2142857142857142,0.09424081021458665,673,"Do not worry man. If you have no talent and just can say nonsense, you can apply for the next presidential election."
2696,2684,0,7,26,33,1.2121212121212122,0.07226812131946558,673,"To help you deal with your anxiety disorder, here is a little maze I would like you to follow."
1993,2684,0,7,26,33,1.2121212121212122,0.07226812131946558,673,"Did you order a pizza with extra cheese? If you did, I’ll have to deny we have a relationship!"
72,2684,1,5,27,33,1.2121212121212122,0.08436006610348519,673,Take this twice a day and lay of the Acid.
416,2684,1,5,27,33,1.2121212121212122,0.08436006610348519,673,"If they try to give you white, insist on yellow."
458,2688,1,6,31,38,1.2105263157894737,0.07690579795683228,673,It'll keep you from turning into me.
2672,2688,1,6,31,38,1.2105263157894737,0.07690579795683228,673,The Opioid  Epidemic: Dr. Ratner pushes pain pills.
1514,2688,0,8,30,38,1.2105263157894737,0.06702258315442247,673,Here's your prescription for sheeping pills.
2400,2691,0,5,19,24,1.2083333333333333,0.08468112965594382,673,You dirty rat!  Where did you get your license to practice medicine?
3808,2691,1,3,20,24,1.2083333333333333,0.10389457216622949,673,Don't take these on an empty stomach as it could lead to paranoia
2006,2691,0,5,19,24,1.2083333333333333,0.08468112965594382,673,This should help with you urge to mark your territory
764,2691,1,3,20,24,1.2083333333333333,0.10389457216622949,673,I may be a weasel but I’m no rat.
4440,2695,1,4,24,29,1.206896551724138,0.09123280382981348,673,Take these daily for three weeks. They turn you into whatever you really are.
3710,2695,1,4,24,29,1.206896551724138,0.09123280382981348,673,"...but if you're looking to win the rat race, here's my card."
3671,2695,1,4,24,29,1.206896551724138,0.09123280382981348,673,"Why continue this cat and mouse game, just trust me on my instincts!"
3539,2695,1,4,24,29,1.206896551724138,0.09123280382981348,673,"This has a high success rate on rats! Believe me, it will cure your cancer, too!"
3522,2695,1,4,24,29,1.206896551724138,0.09123280382981348,673,"Now that you have taken the medication, what do you see now?"
3484,2695,1,4,24,29,1.206896551724138,0.09123280382981348,673,I've tried these myself. The results are 'mazing!
3449,2695,0,6,23,29,1.206896551724138,0.07655305550699536,673,"Look into my eyes, look into my eyes...you now are in a deep sleep. Where's the cheese?"
3425,2695,0,6,23,29,1.206896551724138,0.07655305550699536,673,"I know it sounds cheesy, but it works!"
3372,2695,0,6,23,29,1.206896551724138,0.07655305550699536,673,Take an extra treat in the afternoon.
3352,2695,0,6,23,29,1.206896551724138,0.07655305550699536,673,This should help with the murine hallucinations.
3283,2695,0,6,23,29,1.206896551724138,0.07655305550699536,673,All the better to treat you with...
3194,2695,0,6,23,29,1.206896551724138,0.07655305550699536,673,Spray each cat twice daily till they’re all gone.
3160,2695,0,6,23,29,1.206896551724138,0.07655305550699536,673,"Many people say they smell a rat while doing business with me, but that is just how I was born."
3158,2695,0,6,23,29,1.206896551724138,0.07655305550699536,673,The only side effect of these pills is they may make you feel like you're a real doctor one day.
3106,2695,0,6,23,29,1.206896551724138,0.07655305550699536,673,"These will make you feel young again, guaranteed!"
3073,2695,0,6,23,29,1.206896551724138,0.07655305550699536,673,"Take 3 pieces of Cheese at bedtime, and one in the morning."
2809,2695,1,4,24,29,1.206896551724138,0.09123280382981348,673,"Nah, I fell for that last dream"
2772,2695,1,4,24,29,1.206896551724138,0.09123280382981348,673,"Here, my card says Bob Smith...not lab rat."
2755,2695,1,4,24,29,1.206896551724138,0.09123280382981348,673,It's a prescription for CBD infused cheese.
2697,2695,2,2,25,29,1.206896551724138,0.10385797360742866,673,"Don't worry.  It's still me.   I just got a head transplant
michael.rogness@gmail.com"
3725,2695,1,4,24,29,1.206896551724138,0.09123280382981348,673,'No I haven't got the plague.'
3756,2695,0,6,23,29,1.206896551724138,0.07655305550699536,673,"This is a prescription for swiss cheese, it always works for me."
3792,2695,1,4,24,29,1.206896551724138,0.09123280382981348,673,This should help keep you awake while you are guarding the hen house.
3847,2695,0,6,23,29,1.206896551724138,0.07655305550699536,673,Turns out the cheese was a red herring.  The real prize at the end of the maze was personal growth.
4500,2695,0,6,23,29,1.206896551724138,0.07655305550699536,673,What makes you think I would tell people about your condition?
2646,2695,0,6,23,29,1.206896551724138,0.07655305550699536,673,"We've taken over, you'd better get used to it..."
4364,2695,0,6,23,29,1.206896551724138,0.07655305550699536,673,"Trust me, the side effects are minimal."
608,2695,1,4,24,29,1.206896551724138,0.09123280382981348,673,"Take two, and don't see me in the morning."
4297,2695,0,6,23,29,1.206896551724138,0.07655305550699536,673,Many of my friends at the lab swear by this drug.
4295,2695,0,6,23,29,1.206896551724138,0.07655305550699536,673,"Just don't you worry about my degree. I'm wearing the white coat and writing you a prescription, aren't I?"
4219,2695,0,6,23,29,1.206896551724138,0.07655305550699536,673,Take one of these a day and see your own veterinarian when you get back home.
4206,2695,1,4,24,29,1.206896551724138,0.09123280382981348,673,"Go to the bank, get a loan, then head for the nearest drug store and get this filled out. Other option: get stoned."
4192,2695,0,6,23,29,1.206896551724138,0.07655305550699536,673,"Call my direct line immediately if the pain increases, or if you find any cheese lying around."
4419,2695,1,4,24,29,1.206896551724138,0.09123280382981348,673,"For the last time, my name is NOT Pavlov."
4175,2695,0,6,23,29,1.206896551724138,0.07655305550699536,673,It tests very well; I've been taking it myself for months.
4118,2695,1,4,24,29,1.206896551724138,0.09123280382981348,673,It's perfectly safe.  I tested it myself.
4072,2695,1,4,24,29,1.206896551724138,0.09123280382981348,673,"Take it from me, once you get out of the rat race you can get a new life."""
3969,2695,2,2,25,29,1.206896551724138,0.10385797360742866,673,"I'm late, but break the rules, because my proposed caption for cartoon 671 (?) of the two elephants facing each other is far better than the 3 lame candidates you offered.   Here it is:   ""I thought we were supposed to be symbiotic.""  Regards."
3954,2695,1,4,24,29,1.206896551724138,0.09123280382981348,673,Call me tomorrow. I’ll be in the lab
3941,2695,1,4,24,29,1.206896551724138,0.09123280382981348,673,You should be back to your old self in the morning Mr. Samsa.
3930,2695,1,4,24,29,1.206896551724138,0.09123280382981348,673,Take two and call me tomorrow if your plague symptoms persist.
3925,2695,0,6,23,29,1.206896551724138,0.07655305550699536,673,You’re in good hands. Before med school I was a rodent scholar.
3922,2695,0,6,23,29,1.206896551724138,0.07655305550699536,673,This will help you overcome your fear of rodents.
3865,2695,1,4,24,29,1.206896551724138,0.09123280382981348,673,I can’t keep writing you sick notes for work. What’s going to happen if people start questioning my credentials?
4170,2695,1,4,24,29,1.206896551724138,0.09123280382981348,673,"Well, if you’re surprised that I am the one writing the Rx wait until you see the cost of it."
2594,2695,0,6,23,29,1.206896551724138,0.07655305550699536,673,Take two Cheezits and call me in the morning.
377,2695,1,4,24,29,1.206896551724138,0.09123280382981348,673,Sorry I bit you.  This ointment should prevent infection.
2476,2695,0,6,23,29,1.206896551724138,0.07655305550699536,673,Should ir-rat-icate your cough with a lovely cheese flavor to boot.
1209,2695,1,4,24,29,1.206896551724138,0.09123280382981348,673,Take this to the pharmacy window. Just turn right and go through the maze.
1203,2695,0,6,23,29,1.206896551724138,0.07655305550699536,673,This 'Ratsative' should help you feel better.
1198,2695,0,6,23,29,1.206896551724138,0.07655305550699536,673,This drug saved my wife’s life when she was part of a lab experiment.
990,2695,1,4,24,29,1.206896551724138,0.09123280382981348,673,"Well, besides dog-tired, you do sound horse."
969,2695,0,6,23,29,1.206896551724138,0.07655305550699536,673,If this doesn't stop the hallucinations I'll have you see a mongoose next week.
939,2695,1,4,24,29,1.206896551724138,0.09123280382981348,673,One way to survive this is to refuse all medications. That's how I got through med school...
819,2695,0,6,23,29,1.206896551724138,0.07655305550699536,673,Just because I'm experiencing this side effect doesn't mean that you will.
794,2695,0,6,23,29,1.206896551724138,0.07655305550699536,673,If you end up selling these on the streets please don’t give any to my son...
1239,2695,1,4,24,29,1.206896551724138,0.09123280382981348,673,"Trust me, it's got incredible street value!"""
742,2695,0,6,23,29,1.206896551724138,0.07655305550699536,673,Experience? I started out as a lab rat.
645,2695,0,6,23,29,1.206896551724138,0.07655305550699536,673,"Take two pills before bedtime and if you have morning, hallucinations slice some provolone and give me a call."
642,2695,0,6,23,29,1.206896551724138,0.07655305550699536,673,The generic will be less expensive but if you really want to save some serious money I suggest you try the placebo.
555,2695,0,6,23,29,1.206896551724138,0.07655305550699536,673,You should have seen my handwriting before the accident.
515,2695,0,6,23,29,1.206896551724138,0.07655305550699536,673,Some one has given you human poison!!!
486,2695,0,6,23,29,1.206896551724138,0.07655305550699536,673,"You have nothing to worry about, none of my litter mates reported any significant side effects in clinical trials."
485,2695,0,6,23,29,1.206896551724138,0.07655305550699536,673,Let me know if this works.
471,2695,1,4,24,29,1.206896551724138,0.09123280382981348,673,"Trust me, I know about adverse side effects."
314,2695,0,6,23,29,1.206896551724138,0.07655305550699536,673,"50/50, this prescription will either stop the hallucinations or turn you into a fox."
659,2695,1,4,24,29,1.206896551724138,0.09123280382981348,673,"Now that we have ""Medicare for All,"" everything comes in a suppository."
2483,2695,1,4,24,29,1.206896551724138,0.09123280382981348,673,your expressions shows you are from Canada!
1275,2695,1,4,24,29,1.206896551724138,0.09123280382981348,673,I'll have you know I was first in my class...to reach the cheese!
1285,2695,0,6,23,29,1.206896551724138,0.07655305550699536,673,"Yes, this medication has been tested on lab humans."
2307,2695,1,4,24,29,1.206896551724138,0.09123280382981348,673,"Trust me, I KNOW this drug is safe."
2282,2695,0,6,23,29,1.206896551724138,0.07655305550699536,673,I'M not crazy -- YOU'RE the one in here for psychiatric meds!
2246,2695,1,4,24,29,1.206896551724138,0.09123280382981348,673,"Our practice is open to all newcomers regardless of evolutionary status.

Howard Lubar, Boulder, CO"
2216,2695,1,4,24,29,1.206896551724138,0.09123280382981348,673,Personally I use the CBD oil in moderation!
2172,2695,1,4,24,29,1.206896551724138,0.09123280382981348,673,"These meds can be a little rough on your stomach, I recommend taking them with garbage."
2149,2695,0,6,23,29,1.206896551724138,0.07655305550699536,673,i want to be president teach me to tweet
1276,2695,1,4,24,29,1.206896551724138,0.09123280382981348,673,It’s impossible to get plague from a prescription pad.  Now get out of my office.
1804,2695,0,6,23,29,1.206896551724138,0.07655305550699536,673,Disguises are good when the diagnosis is shit.
1794,2695,1,4,24,29,1.206896551724138,0.09123280382981348,673,Our studies show that howling at the moon will soon make viagra a thing of the past.
1791,2695,0,6,23,29,1.206896551724138,0.07655305550699536,673,"Trust me, you'll love the maze!"
1659,2695,1,4,24,29,1.206896551724138,0.09123280382981348,673,"I am sorry to be the one to tell you this, but you have the clap."
1628,2695,0,6,23,29,1.206896551724138,0.07655305550699536,673,Very effective drug - I tested it myself.
1431,2695,1,4,24,29,1.206896551724138,0.09123280382981348,673,"Take these and if the hallucinations don't subside in 10 days, get back to me and we'll talk about the next steps."
1428,2695,0,6,23,29,1.206896551724138,0.07655305550699536,673,"Two pills daily, three when the moon is full"""
1369,2695,1,4,24,29,1.206896551724138,0.09123280382981348,673,"If I'm not exterminated, I'll see you in two weeks."
1362,2695,1,4,24,29,1.206896551724138,0.09123280382981348,673,"You'll love this, my cousin tested it, new to market"
1288,2695,1,4,24,29,1.206896551724138,0.09123280382981348,673,you'll be part of a clinical trial before we allow use in the general rodent population.
2406,2695,1,4,24,29,1.206896551724138,0.09123280382981348,673,"These pills should help you sleep. Personally, I prefer curling up with a good book ... I like to chew on the covers."
2463,2695,0,6,23,29,1.206896551724138,0.07655305550699536,673,Research found that your species could no longer sustain the rate of price increases.
4113,2784,0,7,27,34,1.2058823529411764,0.07038741487212934,673,"Come on Doc, what RATe are you getting on this?"
4060,2784,0,7,27,34,1.2058823529411764,0.07038741487212934,673,Trust me....I was in the research study that proved our burnout rate was much lower than the human control group.
2740,2784,1,5,28,34,1.2058823529411764,0.08207873882240854,673,Studies show that 90 percent of white people feel better about tattling with this prescription.
3817,2784,1,5,28,34,1.2058823529411764,0.08207873882240854,673,Haven't you heard of lab rats?
1816,2784,1,5,28,34,1.2058823529411764,0.08207873882240854,673,Two pills a day for your sloth.
2816,2789,1,6,32,39,1.205128205128205,0.07510215426707977,673,I think you should definitely get a second opinion
1080,2790,1,7,36,44,1.2045454545454546,0.06957698714453991,673,I'm just a wolf in MD's clothing.
1731,2791,0,6,24,30,1.2,0.07427813527082072,673,"Here's my card, call me when you have an authentic problem."
1776,2791,0,7,28,35,1.2,0.06859943405700354,673,I want to show you a card trick.  This has nothing to do with your assessment.
1819,2791,2,5,38,45,1.2,0.07521014330903551,673,Take this coupon for a discount on Swiss cheese to your favorite supermarket.  You'll feel better in no time.
1971,2791,1,4,25,30,1.2,0.08840866447369841,673,"Side effects may include whiskers, a tail, and an inexplicable desire for cheese."
2180,2791,0,5,20,25,1.2,0.08164965809277261,673,I'm enrolling you in a drug trial.
2832,2791,1,4,25,30,1.2,0.08840866447369841,673,I have cancer
2881,2791,1,4,25,30,1.2,0.08840866447369841,673,"Take two lefts, a right, then straight ahead to get your reward."
2910,2791,0,7,28,35,1.2,0.06859943405700354,673,Take this to the Anthill on 83rd Street and await further instruction
2984,2791,0,9,36,45,1.2,0.06030226891555274,673,"Don’t worry, I’m vaccinated."
3513,2791,1,4,25,30,1.2,0.08840866447369841,673,The only side effect is a craving for raw deer meat.
3536,2791,0,6,24,30,1.2,0.07427813527082072,673,I'm upgrading your prescription to brie.
3661,2791,0,6,24,30,1.2,0.07427813527082072,673,Is the white coat making you uncomfortable?
3673,2791,2,2,26,30,1.2,0.10057307059414874,673,"Don't worry, there's always the subway tracks."
3733,2791,1,4,25,30,1.2,0.08840866447369841,673,Stop taking this if you start experiencing hallucinations.
3886,2791,1,4,25,30,1.2,0.08840866447369841,673,"And, for the last time, it's Dr. Ratficker--with an ""i""!"
4121,2791,1,4,25,30,1.2,0.08840866447369841,673,"Hey, don't worry. They got me out of the maze and into med school."
4322,2791,1,4,25,30,1.2,0.08840866447369841,673,"OPIOIDS, For vision health?"
4334,2791,1,4,25,30,1.2,0.08840866447369841,673,THIS is your LAST opioid prescription from me!!
3302,2791,1,4,25,30,1.2,0.08840866447369841,673,It’s a harmless drug. I take it myself.
1619,2791,0,6,24,30,1.2,0.07427813527082072,673,"This prescription will unleash your inner self.  
It has gotten me three promotions."
1417,2791,1,4,25,30,1.2,0.08840866447369841,673,"Look,the side effects are minimal compared to the copay."
4338,2791,1,4,25,30,1.2,0.08840866447369841,673,Thank you for participating in the “ human lab testing” for our new drug. I would now recommend getting a vasectomy”
1828,2791,0,6,24,30,1.2,0.07427813527082072,673,These have been successfully tested on lab rats with no side effects.
35,2791,1,4,25,30,1.2,0.08840866447369841,673,These suppositories will make you feel more normal.
4473,2791,1,3,21,25,1.2,0.1,673,Why yes the Black Plague is still quite common in this area.
71,2791,0,6,24,30,1.2,0.07427813527082072,673,Four out of five rats recommend this for their patients.
103,2791,1,4,25,30,1.2,0.08840866447369841,673,"Don""t weasel your way out of this colonoscopy appointment."
227,2791,1,4,25,30,1.2,0.08840866447369841,673,"Pay no mind, office costume party, but can I get you some cheese with this prescription hahahaha."
335,2791,1,4,25,30,1.2,0.08840866447369841,673,"Remember, 'omerta' means nothing in our culture."
394,2791,0,6,24,30,1.2,0.07427813527082072,673,Methinks I shall skip my next appointment.
1422,2791,1,4,25,30,1.2,0.08840866447369841,673,"You may look weird but you won’t 
die."
433,2791,0,6,24,30,1.2,0.07427813527082072,673,"Now when you get these glasses, make sure to ask for the extra long  frames"
606,2791,0,6,24,30,1.2,0.07427813527082072,673,"My card .., in case you decide to stay in network."
4540,2791,0,6,24,30,1.2,0.07427813527082072,673,You`re drugged
868,2791,0,6,24,30,1.2,0.07427813527082072,673,I can personally vouch for this drug--it cured my brother in laboratory tests.
897,2791,0,6,24,30,1.2,0.07427813527082072,673,Here's your ticket out of Baltimore.
1021,2791,1,4,25,30,1.2,0.08840866447369841,673,Here is a referral to a proctologist I know...he is the best.
1046,2791,0,6,24,30,1.2,0.07427813527082072,673,Imagine what this lab test could do for you.
1199,2791,0,6,24,30,1.2,0.07427813527082072,673,"Don't worry, you're no spring chicken."
1407,2791,0,6,24,30,1.2,0.07427813527082072,673,"Side effects include dry mouth, blurred vision, and leaving droppings in the pantry."
543,2791,0,6,24,30,1.2,0.07427813527082072,673,Take two pellets and call me in the morning.
4357,2791,0,7,28,35,1.2,0.06859943405700354,673,Take 2 of these each morning with cheese.
3074,2833,1,4,26,31,1.1935483870967742,0.08575226682742745,673,This drug worked well  for hallucinations in studies in mice
2151,2833,1,4,26,31,1.1935483870967742,0.08575226682742745,673,"Don't be alarmed, we doctors from Hideous Rat Land are better educated and trained than most human doctors. 
Now here's your prescription for bulging eye syndrome."
2746,2833,0,6,25,31,1.1935483870967742,0.07213122508063836,673,They gave it to me in the clinical trial and look where I am now.
2544,2833,0,6,25,31,1.1935483870967742,0.07213122508063836,673,Take two of these and squeak me in the morning.
3607,2833,0,6,25,31,1.1935483870967742,0.07213122508063836,673,"I can't be the first rodent you've seen in Baltimore, Jared."
3821,2833,1,4,26,31,1.1935483870967742,0.08575226682742745,673,"Clinical trials are perfectly safe. So, do you want the green card or not?"
155,2833,0,6,25,31,1.1935483870967742,0.07213122508063836,673,Eat more garbage.
3965,2833,0,6,25,31,1.1935483870967742,0.07213122508063836,673,It seems your credit card isn’t worth the proverbial rat’s you-know what.
4003,2833,1,4,26,31,1.1935483870967742,0.08575226682742745,673,"Mr. Skinner, this medication will have you positively thinking outside the box."
4157,2833,0,6,25,31,1.1935483870967742,0.07213122508063836,673,"Relax, I was an experimental subject in a top-ranked animal testing lab before I went to medical school."
4212,2833,1,4,26,31,1.1935483870967742,0.08575226682742745,673,Next time bring your owner.
4472,2833,1,4,26,31,1.1935483870967742,0.08575226682742745,673,These will expire in two dog years.
2036,2833,0,6,25,31,1.1935483870967742,0.07213122508063836,673,Helps reduce scabs.
3845,2833,1,4,26,31,1.1935483870967742,0.08575226682742745,673,It's for a maze.  It gave me the inspiration to go to medical school.
1929,2833,1,4,26,31,1.1935483870967742,0.08575226682742745,673,Eat more cheese? That's your prescription?
2527,2833,1,4,26,31,1.1935483870967742,0.08575226682742745,673,Laboratory tests were inconclusive of any side effects.
1614,2833,1,4,26,31,1.1935483870967742,0.08575226682742745,673,This cheese is available only by prescription.
1690,2833,0,6,25,31,1.1935483870967742,0.07213122508063836,673,"I can assure you, this has been thoroughly tested."
267,2833,1,4,26,31,1.1935483870967742,0.08575226682742745,673,"I tried these myself this morning and the itch definitely went away. By the way, you wouldn’t happen to have any cheese on you?"
511,2833,0,6,25,31,1.1935483870967742,0.07213122508063836,673,"Sir, I assure you I'm a professional Lab Rat."
520,2833,1,4,26,31,1.1935483870967742,0.08575226682742745,673,"It's all recorded right here, and man, you're going to pay, said Dr. Rat."
610,2833,0,6,25,31,1.1935483870967742,0.07213122508063836,673,"It's highly effective, but we need a human canidate to test on."
844,2833,0,6,25,31,1.1935483870967742,0.07213122508063836,673,"I have a feeling you could win the lottery if
you'd only play."
788,2833,1,4,26,31,1.1935483870967742,0.08575226682742745,673,Be sure to chew on the bottle after you're done with the medicine.
864,2833,1,4,26,31,1.1935483870967742,0.08575226682742745,673,Take two cheese cubes and call me in the morning.
943,2833,1,4,26,31,1.1935483870967742,0.08575226682742745,673,"All right, you hound, just this once I'll prescribe these on the sly."
1372,2833,0,6,25,31,1.1935483870967742,0.07213122508063836,673,Take two a day with cheese
1390,2833,1,4,26,31,1.1935483870967742,0.08575226682742745,673,I am sorry but your insurance plan is not valid in this office.
3139,2861,0,5,21,26,1.1923076923076923,0.07882269819968923,673,Here is a prescription for pizza. It cures everything.
3236,2861,1,3,22,26,1.1923076923076923,0.09638433912416669,673,"Warfarin? Thank you Doc, but I think I'll get a second opinion."
3489,2861,0,5,21,26,1.1923076923076923,0.07882269819968923,673,"Oh, come on—who wouldn't want an ear grown on their back?"
3183,2861,0,5,21,26,1.1923076923076923,0.07882269819968923,673,Hallucinations are normal.  Here's a discount card for my favorite costume shop.
3260,2861,0,5,21,26,1.1923076923076923,0.07882269819968923,673,Is that your cheese?
3086,2861,0,5,21,26,1.1923076923076923,0.07882269819968923,673,Take this twice a day and your head will be back to normal in a week.
2729,2861,1,3,22,26,1.1923076923076923,0.09638433912416669,673,Don't be scared. I just don't want  to identified in the lineup.
3024,2861,0,5,21,26,1.1923076923076923,0.07882269819968923,673,"Unfortunately, there is no cure for personification syndrome, but it is treatable."
2993,2861,1,3,22,26,1.1923076923076923,0.09638433912416669,673,What are you glaring at me for?  Does my moustache scare you?
2926,2861,0,5,21,26,1.1923076923076923,0.07882269819968923,673,"Here's your prescription.  And again, there are no known side effects or adverse reactions."
2730,2861,0,5,21,26,1.1923076923076923,0.07882269819968923,673,This is a prescription for rat poison. Just kidding. It is for your musophobia.
3554,2861,1,3,22,26,1.1923076923076923,0.09638433912416669,673,"Remember, only one pill a day or it will turn you into a Rat."
2692,2861,0,5,21,26,1.1923076923076923,0.07882269819968923,673,Take this down the street to the Snake Pharmacy.
2657,2861,0,5,21,26,1.1923076923076923,0.07882269819968923,673,"This and only this prescription will cure your problem – obviously, 
 it worked for me."
3057,2861,1,3,22,26,1.1923076923076923,0.09638433912416669,673,Nibble one of these cheese pills every 15 minutes and your rat delusions will improve.
3567,2861,0,5,21,26,1.1923076923076923,0.07882269819968923,673,"A larger shoe size will ease your pain, now you owe $5,000 in cash and will need a follow-up appointment next week."
3912,2861,0,5,21,26,1.1923076923076923,0.07882269819968923,673,I generally prescribe rat poison for everything
4557,2861,0,5,21,26,1.1923076923076923,0.07882269819968923,673,Take all of them. My nurse will give you a little water.
4381,2861,0,5,21,26,1.1923076923076923,0.07882269819968923,673,If you see a large rodent wearing a Medical White Coat take 15 tabs of this high potent LSD . If  they start crawling on your body dip yourself in a vat of Benadryl while listening to the Grateful Dead at high pitch. If  you are still alive kill Bill
4380,2861,2,1,23,26,1.1923076923076923,0.1112064022676997,673,"I’m prescribing Rodentia.  It’s still in trials, but it works. I haven’t had a migraine in months."
4480,2861,0,5,21,26,1.1923076923076923,0.07882269819968923,673,This new medication has been tested on my kids with positive results.
2548,2861,0,5,21,26,1.1923076923076923,0.07882269819968923,673,They kicked me out of vet school.  I kept eating the patients.
4313,2861,0,5,21,26,1.1923076923076923,0.07882269819968923,673,"Here's a script your insurance is sure not to honor, but the only one that will work."
4304,2861,0,5,21,26,1.1923076923076923,0.07882269819968923,673,"Don't worry about getting addicted, they're far too lethal."
3615,2861,1,3,22,26,1.1923076923076923,0.09638433912416669,673,This prescription I'm writing out for you will cure you of your notion that I'm a rat.
4278,2861,0,5,21,26,1.1923076923076923,0.07882269819968923,673,You’re fine. This is my favorite cheese fondue recipe.
4006,2861,1,3,22,26,1.1923076923076923,0.09638433912416669,673,I recommend this poison. It was very effective against my father.
3950,2861,0,5,21,26,1.1923076923076923,0.07882269819968923,673,I guess I will see you soon...after you have seen your copay.
3917,2861,0,5,21,26,1.1923076923076923,0.07882269819968923,673,"Here, download this app."
3843,2861,0,5,21,26,1.1923076923076923,0.07882269819968923,673,"So, why are all the veterinarians human?"
3678,2861,0,5,21,26,1.1923076923076923,0.07882269819968923,673,All you ever need is a good fox.
3641,2861,0,5,21,26,1.1923076923076923,0.07882269819968923,673,This cheese is my favorite
4046,2861,2,1,23,26,1.1923076923076923,0.1112064022676997,673,"Listen Herbert, your last 3 maze runs were pathetic, but for the next we expect great results since you are now on gluten-free pellets!"
2486,2861,1,3,22,26,1.1923076923076923,0.09638433912416669,673,"Here's a script for a pile of ants - does the trick for me, every time."
1205,2861,1,3,22,26,1.1923076923076923,0.09638433912416669,673,This visit is on the mouse.
2475,2861,0,5,21,26,1.1923076923076923,0.07882269819968923,673,Trust me - I was a doctor long before I turned into a rat.
2479,2861,0,5,21,26,1.1923076923076923,0.07882269819968923,673,"Start taking these, and it wouldn't hurt to get rid of your cat."
117,2861,1,3,22,26,1.1923076923076923,0.09638433912416669,673,"This may help, but your ability to smell will never reach normal levels."
461,2861,0,5,21,26,1.1923076923076923,0.07882269819968923,673,"I've been taking these smart pills since I was a lab rat in a maze, however, possible side effects include growing to 100 times normal size."
487,2861,0,5,21,26,1.1923076923076923,0.07882269819968923,673,What's with the look? My PhD is just as good as an MD.
557,2861,1,3,22,26,1.1923076923076923,0.09638433912416669,673,This will help you forget I ate your mother and daughter
830,2861,0,5,21,26,1.1923076923076923,0.07882269819968923,673,Give this to the Lab in the Basement for your texts.
856,2861,0,5,21,26,1.1923076923076923,0.07882269819968923,673,Take two of these before bed and you will never be troubled by those headaches again.
866,2861,0,5,21,26,1.1923076923076923,0.07882269819968923,673,stop eating cheese and that protrusion will return to normal.
992,2861,0,5,21,26,1.1923076923076923,0.07882269819968923,673,"Sleep later, and let your hens roam freely."
1089,2861,1,3,22,26,1.1923076923076923,0.09638433912416669,673,I am afraid you'll have to come through proper channel for mutation
1110,2861,0,5,21,26,1.1923076923076923,0.07882269819968923,673,"I can almost guarantee that this prescription will work. In tests, it worked on all kinds of rats."
1190,2861,1,3,22,26,1.1923076923076923,0.09638433912416669,673,"No, I don't have that boat anymore. That's why your next appointment is on a Wednesday."
1298,2861,0,5,21,26,1.1923076923076923,0.07882269819968923,673,Here—this will cure the condition that causes you to see the world through anti-Semitic tropes.
1327,2861,0,5,21,26,1.1923076923076923,0.07882269819968923,673,This is the generic for Milk Bone. It’ll save you a few bucks.
1345,2861,0,5,21,26,1.1923076923076923,0.07882269819968923,673,See checkout my license! It’s Dr. Rat to you
1458,2861,0,5,21,26,1.1923076923076923,0.07882269819968923,673,This is the attorney for the opiate class action you want.
1638,2861,0,5,21,26,1.1923076923076923,0.07882269819968923,673,"hickory dickory dock, your results may come as a shock."
1689,2861,1,3,22,26,1.1923076923076923,0.09638433912416669,673,"You’ve been testing meds on us for years, now it’s your turn."
1737,2861,0,5,21,26,1.1923076923076923,0.07882269819968923,673,No reason to be concerned. I take this drug myself.
1752,2861,0,5,21,26,1.1923076923076923,0.07882269819968923,673,"These pills are fine. I've been taking them for years, and there's nothing wrong with me."
1896,2861,0,5,21,26,1.1923076923076923,0.07882269819968923,673,You smell a rat?!? I'm not the one who experienced an allergic reaction to cheese.
1968,2861,1,3,22,26,1.1923076923076923,0.09638433912416669,673,Does it work?  I won the maze and it got me through med school.
1973,2861,0,5,21,26,1.1923076923076923,0.07882269819968923,673,Trust me. I take them.
1987,2861,1,3,22,26,1.1923076923076923,0.09638433912416669,673,We're skipping the middlemen to cut costs.
2013,2861,0,5,21,26,1.1923076923076923,0.07882269819968923,673,Never trust a hen with an MD- no one can read their chicken scratch anyways
2131,2861,1,3,22,26,1.1923076923076923,0.09638433912416669,673,Down the hall on the left and they'll give you a food pellet
2134,2861,1,3,22,26,1.1923076923076923,0.09638433912416669,673,"I have the equivalent of 77 years experience sitting, fetching, heeling, and diagnostic osteopathy."
2263,2861,0,5,21,26,1.1923076923076923,0.07882269819968923,673,Another appointment or two and we'll ferret out your problem.
2445,2861,0,5,21,26,1.1923076923076923,0.07882269819968923,673,I take 2 of these before music festivals and dinners with my in-laws. They are very effective.
1680,2926,0,7,30,37,1.1891891891891893,0.06527647182968217,673,Who in their right mind would prescribe Rat poison??
1462,2926,1,5,31,37,1.1891891891891893,0.07591125921780505,673,Give this a try. It cured all my relatives.
979,2926,0,7,30,37,1.1891891891891893,0.06527647182968217,673,"It's your wife,again."
4014,2929,0,6,26,32,1.1875,0.07010217197868432,673,"Take these pills, and you'll stop seeing rats everywhere."
3911,2929,1,4,27,32,1.1875,0.08324928557283298,673,Now who's the rat?
3344,2929,1,4,27,32,1.1875,0.08324928557283298,673,"Thank you, come again."
3314,2929,1,4,27,32,1.1875,0.08324928557283298,673,"Really.... thousands of us have tried this without apparent any side effects .  Um, so far"
3129,2929,1,4,27,32,1.1875,0.08324928557283298,673,Here's your prescription.  Take one pill in the morning and one at night and you won't remember how much pain you were in all day.
2622,2929,1,4,27,32,1.1875,0.08324928557283298,673,I can't help you if don't have an open mind.
2371,2929,1,4,27,32,1.1875,0.08324928557283298,673,Don't be so dogmatic. I can fix bug eyes too.
1064,2929,1,4,27,32,1.1875,0.08324928557283298,673,"Don't worry, your skin disease is benevolent."
2572,2929,1,4,27,32,1.1875,0.08324928557283298,673,What so now you just 'huffed' and 'puffed' and blew my health insurance away?
877,2929,0,6,26,32,1.1875,0.07010217197868432,673,"This'll help, it's called ratatouli."
641,2929,0,6,26,32,1.1875,0.07010217197868432,673,I smell a rat...
166,2929,0,6,26,32,1.1875,0.07010217197868432,673,Try these and you should stop seeing rats everywhere.
985,2929,0,6,26,32,1.1875,0.07010217197868432,673,"And, no, I did not eat the guy who was sitting here."
3332,2942,1,6,36,43,1.186046511627907,0.06865109076336154,673,"This prescription for Warfarin will help you with your heart problems. Believe me,I know it works!!"
2995,2943,0,5,22,27,1.1851851851851851,0.07618086585254098,673,Take this with five gulps of water.
2591,2943,0,5,22,27,1.1851851851851851,0.07618086585254098,673,Here’s a script for Sheep’s Clothing.
2582,2943,0,5,22,27,1.1851851851851851,0.07618086585254098,673,"Get this prescription filled. They come in tablet form.  Of course, you’ll have to run through a maze first."
2543,2943,1,3,23,27,1.1851851851851851,0.09301896135221943,673,"Nah, dude, you gotta get on my level. Take this piece of paper, find like 100,000 more, build that nest in some rando’s garage near a water source, that shit is the jaaaaammmm"
2493,2943,1,3,23,27,1.1851851851851851,0.09301896135221943,673,I prescribed a week's rest at the Wolf Head Inn.  This will cover your first 2 nights.
2773,2943,0,5,22,27,1.1851851851851851,0.07618086585254098,673,Perfectly normal side effect. Here's the prescription for more!
2777,2943,0,5,22,27,1.1851851851851851,0.07618086585254098,673,These got me through the plague. I’m sure they can handle E.D.
2899,2943,0,5,22,27,1.1851851851851851,0.07618086585254098,673,I would gopher the procedure.
2915,2943,1,3,23,27,1.1851851851851851,0.09301896135221943,673,"Take one every morning. I've been on it for years. It has some minor side effects, but my appetite picked right up."
3159,2943,1,3,23,27,1.1851851851851851,0.09301896135221943,673,"Trust me, this stuff makes you feel a lot better than the ones who got the placebo."
4260,2943,0,5,22,27,1.1851851851851851,0.07618086585254098,673,Here's your prescription for rat-filtering glasses.
3259,2943,0,5,22,27,1.1851851851851851,0.07618086585254098,673,Take these at night and you'll snap right out of it!
3270,2943,0,5,22,27,1.1851851851851851,0.07618086585254098,673,Here's my card and feel free to get a second opinion but I'm the only one in the world who can fix your problem.
3759,2943,0,5,22,27,1.1851851851851851,0.07618086585254098,673,"Please tell Little Red Riding Hood to call me, I'm trying not to be such a fox."
4216,2943,0,5,22,27,1.1851851851851851,0.07618086585254098,673,This'll cure your alurophobia. Did mine.
4405,2943,1,3,23,27,1.1851851851851851,0.09301896135221943,673,What? Absolutely not! Using CBD oil for your aches and pains won't turn you into a Ratafarian.
4251,2943,1,3,23,27,1.1851851851851851,0.09301896135221943,673,This should help with your hallucinations.  You'll drink a lot of water and you might explode.
1850,2943,1,3,23,27,1.1851851851851851,0.09301896135221943,673,I'm prescribing extract of aardvark twice a day for your eye condition. Burp!  I'm you're rat doctor!
4559,2943,0,5,22,27,1.1851851851851851,0.07618086585254098,673,Here. This prescription will help to determine which unnecessary procedure we'll do first.
2447,2943,0,5,22,27,1.1851851851851851,0.07618086585254098,673,Your former mole has been removed.
3219,2943,0,5,22,27,1.1851851851851851,0.07618086585254098,673,I warned you there would be side-effects. Try to think of the hallucinations as a free face filter.
2402,2943,0,5,22,27,1.1851851851851851,0.07618086585254098,673,Results from clinical trials on this have been mixed.
1911,2943,1,3,23,27,1.1851851851851851,0.09301896135221943,673,I recognize that abandon ship look.
2177,2943,1,3,23,27,1.1851851851851851,0.09301896135221943,673,"Take these 3 times a day and get out of the rat race, as you can see we've already won."
2280,2943,1,3,23,27,1.1851851851851851,0.09301896135221943,673,We need to biopsy your credit card.
53,2943,1,3,23,27,1.1851851851851851,0.09301896135221943,673,This will help cure the big eyes you have.
69,2943,0,5,22,27,1.1851851851851851,0.07618086585254098,673,Its an Rx for cheese. 10 million rodents can't be wrong....
270,2943,1,3,23,27,1.1851851851851851,0.09301896135221943,673,Recommend you wrap these capsules in a slice of ham to disguise the taste
289,2943,0,5,22,27,1.1851851851851851,0.07618086585254098,673,"So you took these pills, and now you think I'm a dirty 'what?', Mr. Cagney?"
363,2943,1,3,23,27,1.1851851851851851,0.09301896135221943,673,"It's pronounced ""ver-mine."" Here's my card so you won't make that mistake in the future."
534,2943,0,5,22,27,1.1851851851851851,0.07618086585254098,673,"Yes, that diploma says John's Hopkins. Yes, it's in Baltimore."
177,2943,0,5,22,27,1.1851851851851851,0.07618086585254098,673,"Just call me, I may be a rat but I’m not ratty. Darn, that catchphrase is horrid."
1004,2943,1,3,23,27,1.1851851851851851,0.09301896135221943,673,"Yes, the transition was difficult - why do you ask?”"
1261,2943,0,5,22,27,1.1851851851851851,0.07618086585254098,673,Take two and find my den in the morning.
1482,2943,1,3,23,27,1.1851851851851851,0.09301896135221943,673,"Don’t be so suspicious. You’re puckered on both ends.”
Don Dechman —- Austin, T"
1726,2943,1,3,23,27,1.1851851851851851,0.09301896135221943,673,"Pussy spread, anyone?"
1888,2943,1,3,23,27,1.1851851851851851,0.09301896135221943,673,"If you think your meds are too expensive complain to the the vermin who set the prices, not to me."
1914,2943,0,5,22,27,1.1851851851851851,0.07618086585254098,673,"Rub this on your penis and it will increase your sperm count. Also, I ate your wife's eggs."
894,2943,0,5,22,27,1.1851851851851851,0.07618086585254098,673,"Look at me, the side effects are minimal"
2779,2982,0,6,27,33,1.1818181818181819,0.06818181818181816,673,"I know, I know, everyone says they would rather swallow rat poison than this stuff!"
2833,2982,0,8,36,44,1.1818181818181819,0.05881787629278459,673,This prescription should make the hallucinations go away
3065,2982,0,6,27,33,1.1818181818181819,0.06818181818181816,673,We don!t  accept this card. Let's see the one that's been surgically implanted in your skull.
3351,2982,1,4,28,33,1.1818181818181819,0.08088695645478265,673,"This is a good one, I’ve tested it myself."
4288,2982,2,2,29,33,1.1818181818181819,0.09185117918925863,673,"It's only my gut reaction, but try eating live chickens for one month."
3755,2982,1,4,28,33,1.1818181818181819,0.08088695645478265,673,"C'mon, take it...there's nothing to be afraid of....I promise"
4359,2982,0,6,27,33,1.1818181818181819,0.06818181818181816,673,"This drug is still experimental, but some very close friends tell me it works great."
4390,2982,0,6,27,33,1.1818181818181819,0.06818181818181816,673,Are you sure you're not my grandma?
2684,2982,1,2,19,22,1.1818181818181819,0.10683084570781876,673,"All the humans were sick of the healthcare system, so that left a bunch of job openings"
3523,2982,1,4,28,33,1.1818181818181819,0.08088695645478265,673,Take this to the lab. It’s a simple maze test. You’ll be out in no time.
2562,2982,0,6,27,33,1.1818181818181819,0.06818181818181816,673,I'm gonna prescribe you some cheese.
2822,2982,0,6,27,33,1.1818181818181819,0.06818181818181816,673,Here's a prescription.  But many people nowadays live full lives with lychanthropy.
1140,2982,0,6,27,33,1.1818181818181819,0.06818181818181816,673,Let me know if this helps the next time you’re in Baltimore
862,2982,1,4,28,33,1.1818181818181819,0.08088695645478265,673,"Yes, there are a few side effects, but they go away quickly.......most of the time."
454,2982,1,4,28,33,1.1818181818181819,0.08088695645478265,673,It's effective!   It's been proven in animal studies.
345,2982,1,4,28,33,1.1818181818181819,0.08088695645478265,673,"This is from a rat, never trust a mole"
253,2982,2,2,29,33,1.1818181818181819,0.09185117918925863,673,"Don’t worry, I tested these myself."
79,2982,1,4,28,33,1.1818181818181819,0.08088695645478265,673,Here's a script for warfarin. It does have side effects.
1958,2982,1,4,28,33,1.1818181818181819,0.08088695645478265,673,Here take these. They should grow back within a week.
4525,3001,0,9,41,50,1.18,0.054883922035138685,673,Next time try to avoid sour grapes.
766,3002,1,5,33,39,1.1794871794871795,0.07228481371574673,673,"Your copay is $280 in canine collars, sir."
3594,3003,1,3,24,28,1.1785714285714286,0.08987898137227081,673,What? It's not poison.
3318,3003,0,5,23,28,1.1785714285714286,0.07370704611510596,673,It will help with life feeling like one big human race
3245,3003,0,5,23,28,1.1785714285714286,0.07370704611510596,673,"OK, you've got the job, but I will expect a pound of cheese from you every Friday morning."
4504,3003,1,3,24,28,1.1785714285714286,0.08987898137227081,673,"I started out running the mazes and gradually moved up the ladder, both literally and figuratively."
3138,3003,0,5,23,28,1.1785714285714286,0.07370704611510596,673,Try these pellets. They did wonders for me.
3612,3003,1,3,24,28,1.1785714285714286,0.08987898137227081,673,Don't be alarmed; I'm wearing a mask because of my cold.
3102,3003,1,3,24,28,1.1785714285714286,0.08987898137227081,673,There's no escaping the rat race for me.
3043,3003,1,3,24,28,1.1785714285714286,0.08987898137227081,673,"I know this drug works, I tested it on myself""."
2921,3003,0,5,23,28,1.1785714285714286,0.07370704611510596,673,Take this and you'll grow wings on your feet.
3195,3003,1,3,24,28,1.1785714285714286,0.08987898137227081,673,It's perfectly safe.  My cousin passed the clinical trials with flying colors.
3618,3003,1,3,24,28,1.1785714285714286,0.08987898137227081,673,This hasn't been tested on humans yet.
3797,3003,0,5,23,28,1.1785714285714286,0.07370704611510596,673,"This is what my doct
or gives me."
3704,3003,1,3,24,28,1.1785714285714286,0.08987898137227081,673,You may become a physician.
3719,3003,0,5,23,28,1.1785714285714286,0.07370704611510596,673,"Pizza Rat,"" was in my broke med student days"
4069,3003,1,3,24,28,1.1785714285714286,0.08987898137227081,673,"Yes, this is a very expensive medicine, but without you would die: Your money or your life!"
4112,3003,1,3,24,28,1.1785714285714286,0.08987898137227081,673,It's for bubonic plague.
4141,3003,0,5,23,28,1.1785714285714286,0.07370704611510596,673,Rat poison is a highly effective blood thinner - and your insurance will pay for it.
2754,3003,1,3,24,28,1.1785714285714286,0.08987898137227081,673,Just because I have sheepskins on my wall doesn't make me a wolf.
4299,3003,0,5,23,28,1.1785714285714286,0.07370704611510596,673,You will want to take this on a full stomach of cheese.
4457,3003,1,3,24,28,1.1785714285714286,0.08987898137227081,673,"Take 2 pills a day for the hallucinations, but call us next week if you still think talking Apes are the dominant species."
4464,3003,1,3,24,28,1.1785714285714286,0.08987898137227081,673,Your stress test in the maze was a disaster!
4483,3003,0,5,23,28,1.1785714285714286,0.07370704611510596,673,"Best scrip I've seen for energy, but on the competitive maze circuit the darn stuff's illegal"
3687,3003,1,3,24,28,1.1785714285714286,0.08987898137227081,673,"Deposit $10,000 cash in this Swiss account and I will schedule you to go under the knife."
2623,3003,0,5,23,28,1.1785714285714286,0.07370704611510596,673,I’m going to need you to take two of these and then run thru a maze for a food pellet .
955,3003,1,3,24,28,1.1785714285714286,0.08987898137227081,673,"Of course, my inclination would be to wolf them down.  You should take two every four hours."
2176,3003,1,3,24,28,1.1785714285714286,0.08987898137227081,673,Take one daily with a bowl of water.
2057,3003,0,5,23,28,1.1785714285714286,0.07370704611510596,673,I've gotta take this call. It's a rat race out there.
583,3003,0,5,23,28,1.1785714285714286,0.07370704611510596,673,"Here, this should do it.  It cured what ailed my ancestors."
834,3003,0,5,23,28,1.1785714285714286,0.07370704611510596,673,Your a rat in Doctor’s clothing!
1006,3003,1,3,24,28,1.1785714285714286,0.08987898137227081,673,"Take your first pill with cheese. Then take your second pill after running aimlessly on a large wheel. Lastly, take your third pill right before your fifth nap."
1291,3003,1,3,24,28,1.1785714285714286,0.08987898137227081,673,Just take eight to twelve of these a day and be sure to stock your fridge with cheese
1451,3003,2,1,25,28,1.1785714285714286,0.10355546310079275,673,Cheese has natural opiates.
1625,3003,0,5,23,28,1.1785714285714286,0.07370704611510596,673,Here is your v
1643,3003,0,5,23,28,1.1785714285714286,0.07370704611510596,673,"Believe me, this prescription will eliminate your rodent hallucinations."
1610,3003,0,5,23,28,1.1785714285714286,0.07370704611510596,673,"No, this weed doesn't have any bad side effects. Why do you ask?"
1837,3003,1,3,24,28,1.1785714285714286,0.08987898137227081,673,"Definitely not the plague, but either rat fever or rat-bite fever."
1845,3003,0,5,23,28,1.1785714285714286,0.07370704611510596,673,"Take this to the pharmacy across the room, it's a hole in the wall but it's a good place."
1869,3003,1,3,24,28,1.1785714285714286,0.08987898137227081,673,"Just don't rat me out, ok?"
1894,3003,0,5,23,28,1.1785714285714286,0.07370704611510596,673,"Now that your hiccups are gone,here is a prescription for tranquilizers."
1942,3003,0,5,23,28,1.1785714285714286,0.07370704611510596,673,"Sprinkle this FAO approved Warfarin on your cereal. The food guide says it has only a few side effects including the ""get even"" syndrome."
2092,3003,0,5,23,28,1.1785714285714286,0.07370704611510596,673,"You are suffering from delusions.  I’m a meta physician, so all i can give you is a meta prescription"
2112,3003,0,5,23,28,1.1785714285714286,0.07370704611510596,673,Human medical providers are not part of you health plan.
2123,3003,1,3,24,28,1.1785714285714286,0.08987898137227081,673,I only wear this mask when I discuss fees
1824,3003,0,5,23,28,1.1785714285714286,0.07370704611510596,673,this prescription will give you a fast painless metamorphosis
2385,3003,1,3,24,28,1.1785714285714286,0.08987898137227081,673,"If this antidepressant doesn’t work, you could try howling at the moon."
874,3048,0,6,28,34,1.1764705882352942,0.0663618911550313,673,If we don’t hear from you within 2 weeks I will huff and puff and bill you double.”
4369,3048,1,4,29,34,1.1764705882352942,0.0786538733437084,673,"This will ease your pain for now. But for the long-term, give up the junk food."
3255,3048,1,4,29,34,1.1764705882352942,0.0786538733437084,673,Here’s a packet of atray oisonpay. You can take it full strength.
2873,3048,0,6,28,34,1.1764705882352942,0.0663618911550313,673,HaVe yOU evEr EAteN raT mEaT?
1337,3048,0,6,28,34,1.1764705882352942,0.0663618911550313,673,Here’s the great white shark repellent for your Bahamas dives.
162,3048,1,4,29,34,1.1764705882352942,0.0786538733437084,673,"Please don't freak out, It's not rat poison"
4107,3054,1,2,20,23,1.173913043478261,0.10238603831611556,673,Call me if you want some real problems.
2398,3054,0,4,19,23,1.173913043478261,0.08081046758996392,673,Take two of cheese every day for a week and let me know what happens.
2508,3054,1,2,20,23,1.173913043478261,0.10238603831611556,673,Try this medication instead. It tends to have fewer side effects.
2592,3054,0,4,19,23,1.173913043478261,0.08081046758996392,673,"Get your eyes back in their sockets, buddy ... this is a $1 bill not a $1,000 bill"
2621,3054,0,4,19,23,1.173913043478261,0.08081046758996392,673,You think I take the Hipporatic oath lightly?
2786,3054,0,4,19,23,1.173913043478261,0.08081046758996392,673,Here's an Oxycontin scrip.  I'll never tell anyone.
2842,3054,0,4,19,23,1.173913043478261,0.08081046758996392,673,I went back to school when Michelangelo got hitched.
3163,3054,0,4,19,23,1.173913043478261,0.08081046758996392,673,"For some of us, the rat race was the only way out."
3240,3054,0,4,19,23,1.173913043478261,0.08081046758996392,673,Take two with a wedge of cheese every four hours.
3464,3054,1,2,20,23,1.173913043478261,0.10238603831611556,673,"I take this drug myself.  The only side effects are excessive hair growth, an elongated tail that some find repulsive, an attraction to certain kinds of cheese, and a desire to scurry about which can be fatal."
4078,3054,0,4,19,23,1.173913043478261,0.08081046758996392,673,"I should warn you, the proprietary form can also cause hallucinations."
3515,3054,0,4,19,23,1.173913043478261,0.08081046758996392,673,"In addition to  a squeaky clean reputation, I validate parking."
3581,3054,0,4,19,23,1.173913043478261,0.08081046758996392,673,Take two concentrated cheese tablets daily and you will be aMAZEd at how good you will feel.
3646,3054,0,4,19,23,1.173913043478261,0.08081046758996392,673,Take two a day.  Call me in a week and let me know if you are still seeing rats everywhere you look.
3707,3054,0,4,19,23,1.173913043478261,0.08081046758996392,673,This will help you believe again in humanity's natural supremacy.
3708,3054,1,2,20,23,1.173913043478261,0.10238603831611556,673,I don’t give this to just anyone. How
3739,3054,0,4,19,23,1.173913043478261,0.08081046758996392,673,It worked for me.  It'll work for you.
3883,3054,0,4,19,23,1.173913043478261,0.08081046758996392,673,I know a cheap plastic surgeon that can take care of your chin.
1707,3054,0,4,19,23,1.173913043478261,0.08081046758996392,673,"Don’t worry, this is been tested on several of my relatives. Only three of them died."
4527,3054,0,4,19,23,1.173913043478261,0.08081046758996392,673,"To get rid of your cat allergy, I prescribe a euthanization for your cat."
4325,3054,0,8,38,46,1.173913043478261,0.056503155622080956,673,You'll need to find and follow me soon enough!
3534,3054,0,4,19,23,1.173913043478261,0.08081046758996392,673,"Take two a day of these pills, and your seeing things will pass!"
2362,3054,1,2,20,23,1.173913043478261,0.10238603831611556,673,Three cubes of cheddar four times a day. Lay off the peanut butter.
2156,3054,0,4,19,23,1.173913043478261,0.08081046758996392,673,"This will help with the hallucinations, but I'm still a rat."
2126,3054,1,2,20,23,1.173913043478261,0.10238603831611556,673,Try a little gambling.  You've been outfoxed again by your crappy insurance company.
2169,3054,0,4,19,23,1.173913043478261,0.08081046758996392,673,It’s stronger than Viagra.
134,3054,0,4,19,23,1.173913043478261,0.08081046758996392,673,"Just some quick advice from your friendly HR rep for your first day on the job: When they take the picture for your employee ID, be sure to say ""cheese."""
484,3054,0,4,19,23,1.173913043478261,0.08081046758996392,673,"Take this twice a day for a week, or until the urge to eat garbage subsides."
994,3054,0,4,19,23,1.173913043478261,0.08081046758996392,673,"I assure you, all the lab rats who took this have done quite well."
1245,3054,0,4,19,23,1.173913043478261,0.08081046758996392,673,"Trust me, it's safe. Plus you'll earn some good cheddar."
1314,3054,0,4,19,23,1.173913043478261,0.08081046758996392,673,Get out of the race and call me in the morning.
1332,3054,0,4,19,23,1.173913043478261,0.08081046758996392,673,In case you decide for that professional human extermination
1493,3054,0,4,19,23,1.173913043478261,0.08081046758996392,673,Make sure it is Swiss Cheese. Swiss!
797,3054,0,4,19,23,1.173913043478261,0.08081046758996392,673,"Trust me, this will do wonders for your felinophobia"
1586,3054,0,4,19,23,1.173913043478261,0.08081046758996392,673,Your next appointment is in the woods. Be sure to bring raw meat.
1611,3054,0,4,19,23,1.173913043478261,0.08081046758996392,673,If you're not feeling cheddar by the end of the week I want you to come back in
1751,3054,0,4,19,23,1.173913043478261,0.08081046758996392,673,This isn't meant to trap you.
1760,3054,0,4,19,23,1.173913043478261,0.08081046758996392,673,Trust me. I've tried them all.
1811,3054,0,4,19,23,1.173913043478261,0.08081046758996392,673,"Sorry, we don't take Obamacare."
1953,3054,0,4,19,23,1.173913043478261,0.08081046758996392,673,"If I could promise you a spot in the control group, I would."
1504,3054,0,4,19,23,1.173913043478261,0.08081046758996392,673,"This place can fill your prescription, but more importantly they have best cheese selection in the city."
2018,3054,0,4,19,23,1.173913043478261,0.08081046758996392,673,It’s been shown to be very successful in trials on humans
3040,3096,1,3,25,29,1.1724137931034482,0.08694267288040786,673,"Kill two sheep, and call me in the morning."
3020,3096,1,3,25,29,1.1724137931034482,0.08694267288040786,673,I may need to refer you to a specialist outside of Baltimore.
2866,3096,0,5,24,29,1.1724137931034482,0.07138609234576081,673,Take two and you’ll forget you saw the tiny mouse on my desk.
2811,3096,1,3,25,29,1.1724137931034482,0.08694267288040786,673,THIS WILL HELP YOU GET THROUGH THE MAZE.
2492,3096,1,3,25,29,1.1724137931034482,0.08694267288040786,673,Take two every four hours and come sniff me in the morning.
2115,3096,1,3,25,29,1.1724137931034482,0.08694267288040786,673,Eat three bags of garbage and call me in the morning.
2288,3096,0,5,24,29,1.1724137931034482,0.07138609234576081,673,Take this to the hardware store.
1967,3096,1,3,25,29,1.1724137931034482,0.08694267288040786,673,"This should help with the huffing and puffing, but you're not gonna want to blow a house in for at least a week or two."
1881,3096,0,5,24,29,1.1724137931034482,0.07138609234576081,673,Take this fortune to the Chinese restaurant and fill it.
3152,3096,0,5,24,29,1.1724137931034482,0.07138609234576081,673,Don't worry.  I wrote the damn bill!
2339,3096,2,1,26,29,1.1724137931034482,0.10011035188621467,673,I’m writing you a prescription for a gay rat wedding
3190,3096,0,5,24,29,1.1724137931034482,0.07138609234576081,673,My insurance does not cover rat poison without obtaining a prior authorization first.
4165,3096,1,3,25,29,1.1724137931034482,0.08694267288040786,673,"Here, this  new prescription won't have vivid hallucinations as a possible side effect"
3386,3096,1,3,25,29,1.1724137931034482,0.08694267288040786,673,Gnaw through the plastic and take two
1858,3096,0,5,24,29,1.1724137931034482,0.07138609234576081,673,Take this prescription down to the deli and bring me back some Swiss cheese.
3420,3096,1,3,25,29,1.1724137931034482,0.08694267288040786,673,I'm going to give you this prescription for some cheese to help you out.
3685,3096,1,3,25,29,1.1724137931034482,0.08694267288040786,673,"I didn't say, 'control group'.  I said, 'my control.'"
3732,3096,1,3,25,29,1.1724137931034482,0.08694267288040786,673,I take this prescription myself. I haven’t noticed any side effects yet.
3943,3096,1,3,25,29,1.1724137931034482,0.08694267288040786,673,Here's a prescription for rat pills.
4088,3096,1,3,25,29,1.1724137931034482,0.08694267288040786,673,Take this once a day with food. Preferably a block of cheese.
4249,3096,1,3,25,29,1.1724137931034482,0.08694267288040786,673,Don't feel bad about it. You need the money and no one ever called a cat man's best friend. Clinical trials will begin next month.
4363,3096,0,5,24,29,1.1724137931034482,0.07138609234576081,673,Tic Tac? Great for dog breath.
4408,3096,1,3,25,29,1.1724137931034482,0.08694267288040786,673,"You didn't expect that I would be British, did you, George?"
4499,3096,0,5,24,29,1.1724137931034482,0.07138609234576081,673,"Use it with your computer"""
4507,3096,1,3,25,29,1.1724137931034482,0.08694267288040786,673,Forest therapy? You want me to hug a tree and make daisy chains?
3242,3096,1,3,25,29,1.1724137931034482,0.08694267288040786,673,Fill this prescription and you will be beautiful and happy like the people on TV.  I promise.
1831,3096,0,5,24,29,1.1724137931034482,0.07138609234576081,673,The studies on the possible side effects have been inconclusive.
3413,3096,1,3,25,29,1.1724137931034482,0.08694267288040786,673,"Yes, studies have shown that cheese really is effective in treating sciatica."
1740,3096,0,5,24,29,1.1724137931034482,0.07138609234576081,673,Don’t give me that look—.it’s not enough arsenic to kill you.
1825,3096,0,5,24,29,1.1724137931034482,0.07138609234576081,673,Take two Mini Babybels and call me in the morning.
36,3096,1,3,25,29,1.1724137931034482,0.08694267288040786,673,"If this doesn't kill you, nothing will."
237,3096,1,3,25,29,1.1724137931034482,0.08694267288040786,673,"Don’t worry, it’s not contagious."
297,3096,1,3,25,29,1.1724137931034482,0.08694267288040786,673,It all began when I developed an opposable thumb.
424,3096,1,3,25,29,1.1724137931034482,0.08694267288040786,673,"Sorry for biting you, here is your prescription for your rabies shots."
544,3096,0,5,24,29,1.1724137931034482,0.07138609234576081,673,"Trust me, they're not addictive."
644,3096,1,3,25,29,1.1724137931034482,0.08694267288040786,673,Here's a prescription for warfarin.
696,3096,1,3,25,29,1.1724137931034482,0.08694267288040786,673,This cured my side eye with only minot sideeffects.f
778,3096,0,5,24,29,1.1724137931034482,0.07138609234576081,673,Take two of these cheesy pellets and spread them on your living room floor and call me in the morning.
911,3096,1,3,25,29,1.1724137931034482,0.08694267288040786,673,"Here’s a prescription for Half a pound of tuppenny rice 
Half a pound of treacle. Take it and stand back."
928,3096,0,5,24,29,1.1724137931034482,0.07138609234576081,673,I say if you can't beat them join them
211,3096,2,1,26,29,1.1724137931034482,0.10011035188621467,673,Here's the number of my pig guy.
1058,3096,0,5,24,29,1.1724137931034482,0.07138609234576081,673,"Trust me, I used to be in R&D."
1095,3096,1,3,25,29,1.1724137931034482,0.08694267288040786,673,"Listen you Schmuck! This is a rat race and you either take the pills, or you'll be running the maze for the rest of your life!"
1211,3096,0,5,24,29,1.1724137931034482,0.07138609234576081,673,Don't ask. It's a bad hair day.
1278,3096,1,3,25,29,1.1724137931034482,0.08694267288040786,673,"this is my uncle, Mr. Sniffles, an immigrant who ran mazes for crumbs. now i’m a fucken doctor and society grants me absurd deference because i know shit that may as well be witchcraft to you. so, what do you say we stick these fingers in your butt?"
1368,3096,0,5,24,29,1.1724137931034482,0.07138609234576081,673,"I don't take insurance, but I do accept live, wild turkeys."
1387,3096,1,3,25,29,1.1724137931034482,0.08694267288040786,673,Microdosing doesn't work if you lack self-control. Take these instead.
1489,3096,1,3,25,29,1.1724137931034482,0.08694267288040786,673,"It's rat poison, yes, but, Mr Skiles, you are not a rat."
1500,3096,0,5,24,29,1.1724137931034482,0.07138609234576081,673,It was tested on some of my ancestors with great success.
1623,3096,1,3,25,29,1.1724137931034482,0.08694267288040786,673,Don't worry. Nothing happened to me when I started taking these.
1684,3096,0,5,24,29,1.1724137931034482,0.07138609234576081,673,"Here is your prescription chit, dollars will be next."
1017,3096,0,5,24,29,1.1724137931034482,0.07138609234576081,673,"I'm sorry sir, but your cat didn't survive her check-up."
3985,3148,0,6,29,35,1.1714285714285715,0.0646349059597627,673,"I understand that you're skeptical, but no, it's not for rat poison."
2113,3148,1,4,30,35,1.1714285714285715,0.07653981537301309,673,Money shall buy you help and anything else.
1705,3150,0,7,34,41,1.170731707317073,0.05949419959829497,673,If  I still look like a hedgehog next week we
2030,3150,0,7,34,41,1.170731707317073,0.05949419959829497,673,It was like the Pixar movie Ratatouille except I was in a surgeon's scrub cap
2227,3152,0,6,30,36,1.1666666666666667,0.06299407883487121,673,Very affective on Canadian rats
3519,3152,0,4,20,24,1.1666666666666667,0.07770873402002618,673,"If things with Little Red Riding Hood don’t work out...please, send her my way."
3516,3152,0,5,25,30,1.1666666666666667,0.06920456654478328,673,"Don't look at me like a rat, this will devour up to 80% of your generic prescription bill"
3367,3152,0,4,20,24,1.1666666666666667,0.07770873402002618,673,"I know it looks like rat poison, but it's really just a blood thinner."
3360,3152,0,4,20,24,1.1666666666666667,0.07770873402002618,673,Every patient who fills this prescription gets me another block of cheese from the sales rep.
3154,3152,0,4,20,24,1.1666666666666667,0.07770873402002618,673,If its good enough for lab mice its good enough for you.
3148,3152,0,4,20,24,1.1666666666666667,0.07770873402002618,673,Medicare for all
2982,3152,1,2,21,24,1.1666666666666667,0.09829463743659811,673,"We accept Blue Cross, Blue Shield, or cheese."
2924,3152,0,4,20,24,1.1666666666666667,0.07770873402002618,673,"So, whose clothes are YOU wearing?"
2835,3152,0,4,20,24,1.1666666666666667,0.07770873402002618,673,Of course it was tested on humans
2553,3152,0,4,20,24,1.1666666666666667,0.07770873402002618,673,"The side effects aren't bad -  trust me, I've taken lots of it"
2535,3152,0,4,20,24,1.1666666666666667,0.07770873402002618,673,"Come on, Mr. Thompson, this is at the top of the Rx prescription list. Seven out of ten rodents recommend it."
3525,3152,0,5,25,30,1.1666666666666667,0.06920456654478328,673,Take two of these tonight and give me a howl in the morning.
2178,3152,1,2,21,24,1.1666666666666667,0.09829463743659811,673,Trust me....this prescription has been tested on many of my family.
3535,3152,0,4,20,24,1.1666666666666667,0.07770873402002618,673,"You’ve put on some weight Joe. Now if I were you, I’d spend less time at the dumpster and a little more time on the exercise wheel."
4491,3152,0,5,25,30,1.1666666666666667,0.06920456654478328,673,Rest assured this prescription is safe - it was tested on me.
3743,3152,1,3,26,30,1.1666666666666667,0.08419098886082751,673,"Take two of these at the full moon, and you'll be back to normal in no time."
4533,3152,0,4,20,24,1.1666666666666667,0.07770873402002618,673,"We are going to give this pill only because you are invasive"""
4523,3152,1,2,21,24,1.1666666666666667,0.09829463743659811,673,It's been thoroughly tested.
2010,3152,0,4,20,24,1.1666666666666667,0.07770873402002618,673,"There's no reported side effects, in fact I take them myself."
4463,3152,0,4,20,24,1.1666666666666667,0.07770873402002618,673,"Two pills a day - and never use the ""ratface"" option on Snapchat again!"
4437,3152,0,4,20,24,1.1666666666666667,0.07770873402002618,673,Here’s your script for your hallucinations. Take three per day with cheese
4296,3152,1,2,21,24,1.1666666666666667,0.09829463743659811,673,Just so you know who you're dealing with ...
3701,3152,0,4,20,24,1.1666666666666667,0.07770873402002618,673,"Yes, cheese pills  -  but very potent!"
4291,3152,0,4,20,24,1.1666666666666667,0.07770873402002618,673,This prescription should help  get you back in the race. Look what it’s done for me.
4203,3152,1,2,21,24,1.1666666666666667,0.09829463743659811,673,This should help abate your hallucinations
4122,3152,0,4,20,24,1.1666666666666667,0.07770873402002618,673,Now don't worry Mr. Willard. Take one of these every morning and you'll be your old rat-bastard self again in no time.
4110,3152,1,2,21,24,1.1666666666666667,0.09829463743659811,673,I'm referring you to Dr. Lion to get another opinion concerning your anthropomorphic delusions.
4019,3152,0,4,20,24,1.1666666666666667,0.07770873402002618,673,This should help control your rodent phobia.
3920,3152,0,4,20,24,1.1666666666666667,0.07770873402002618,673,"Oh, I'll still be a rat, but at this higher dose, having a rodent for a doctor will seem normal."
3761,3152,1,2,21,24,1.1666666666666667,0.09829463743659811,673,"Don't worry, we've tested it on humans."
4287,3152,0,4,20,24,1.1666666666666667,0.07770873402002618,673,"Take this with mice or rabbit twice a day,and you'll be feeling clever again in no time."
1951,3152,0,4,20,24,1.1666666666666667,0.07770873402002618,673,"Opiods shmopiods, this is a prescription for weasel gene therapy, it's the latest new treatment & I get a trip to Hawaii if I sell 10 more prescriptions this month"
3010,3152,0,4,20,24,1.1666666666666667,0.07770873402002618,673,Please don't be taken aback: I prescribe getting out of the medical-industrial rat race.
1903,3152,0,4,20,24,1.1666666666666667,0.07770873402002618,673,Not addictive...
662,3152,0,4,20,24,1.1666666666666667,0.07770873402002618,673,"Side effects may include dumpster feeding, maze running, and an allergy to cats."
559,3152,0,4,20,24,1.1666666666666667,0.07770873402002618,673,Your bug eye is making me hungry.
558,3152,0,4,20,24,1.1666666666666667,0.07770873402002618,673,Don’t worry; I tested it on myself first.
482,3152,0,4,20,24,1.1666666666666667,0.07770873402002618,673,"I wouldn't worry about it so much. The effects of LSD usually wears off in a few hours"" -Amir Khafagy, New York-"
434,3152,0,5,25,30,1.1666666666666667,0.06920456654478328,673,Make sure to take two before the maze
385,3152,1,2,21,24,1.1666666666666667,0.09829463743659811,673,Why are you so concerned about going to the lab?
683,3152,0,4,20,24,1.1666666666666667,0.07770873402002618,673,"Don't worry...you don't get to keep your doctor"""
374,3152,1,2,21,24,1.1666666666666667,0.09829463743659811,673,"No, we don't accept plastic, we only take Swiss cheese"
133,3152,0,4,20,24,1.1666666666666667,0.07770873402002618,673,Balance this on my nose; I'll bet I can catch it!
119,3152,0,4,20,24,1.1666666666666667,0.07770873402002618,673,Take two of these and I'll call on you in the morning.
94,3152,0,4,20,24,1.1666666666666667,0.07770873402002618,673,"If this comes back on you, I will deny everything."
40,3152,0,4,20,24,1.1666666666666667,0.07770873402002618,673,Are you my half-brother by any chance?
1520,3152,1,3,26,30,1.1666666666666667,0.08419098886082751,673,The hallucinogenic side effects are no additional charge.
1936,3152,1,2,21,24,1.1666666666666667,0.09829463743659811,673,Don't worry. I wouldn't prescribe anything I haven't tested on myself.
356,3152,0,4,20,24,1.1666666666666667,0.07770873402002618,673,"I’ll feel better and you , too, if this helps stop you from catting around."
703,3152,0,4,20,24,1.1666666666666667,0.07770873402002618,673,Your choice if you want to stay that way.
504,3152,0,4,20,24,1.1666666666666667,0.07770873402002618,673,I learned about this cure in the lab.
808,3152,0,4,20,24,1.1666666666666667,0.07770873402002618,673,"Sorry I am being paged,one of the patients needs more cheese."
1898,3152,1,2,21,24,1.1666666666666667,0.09829463743659811,673,Of course it's safe.  I use it mysey!
1841,3152,0,4,20,24,1.1666666666666667,0.07770873402002618,673,I'm referring you to a specialist for further tests.  Dr. Katz can see you on Tuesday the 21st.
717,3152,0,4,20,24,1.1666666666666667,0.07770873402002618,673,Would you mind if I put a little extra on your bill for a wedge of cheese?
1587,3152,0,4,20,24,1.1666666666666667,0.07770873402002618,673,"Take two of these by the light of a full moon, and howl me in the morning."
1525,3152,1,4,31,36,1.1666666666666667,0.07453559924999299,673,Say’s here you’re musophobic. What kind of person is afraid of music?
1478,3152,1,2,21,24,1.1666666666666667,0.09829463743659811,673,Here is a sample for an experimental drug that I have been testing.
1447,3152,0,4,20,24,1.1666666666666667,0.07770873402002618,673,"As I personally discovered, there are side effects."
1280,3152,1,2,21,24,1.1666666666666667,0.09829463743659811,673,The bad news is: your claim was denied. The good news is: you have three months to live.
3168,3152,2,1,27,30,1.1666666666666667,0.09688639316269662,673,"Yes, it's for warfarin.  No, I wouldn't take it myself."
1216,3152,1,3,26,30,1.1666666666666667,0.08419098886082751,673,Just don’t put mouse traps up buddy
1188,3152,1,2,21,24,1.1666666666666667,0.09829463743659811,673,Take it from an old  barn rat. It's healthy pharm to table.
1153,3152,1,2,21,24,1.1666666666666667,0.09829463743659811,673,"Don't worry, these are the same hands that just performed your physical."
1105,3152,0,4,20,24,1.1666666666666667,0.07770873402002618,673,Start with 3 little pigs.
169,3152,0,5,25,30,1.1666666666666667,0.06920456654478328,673,"Trust me, I know a disease when I see one."
879,3152,0,4,20,24,1.1666666666666667,0.07770873402002618,673,"Try this new drug, I was involved with the testing program myself."
1946,3220,0,6,31,37,1.162162162162162,0.06143325088732366,673,"Sir,my middle school Spelling Bee award on the wall doesn't cover your pre-existing condition either."
4371,3220,0,6,31,37,1.162162162162162,0.06143325088732366,673,Would you look at me like that if I was a mouse?
2722,3222,0,5,26,31,1.1612903225806452,0.06715051611181075,673,"About this problem of your starting to look like me, I’ll prescribe something for your transference."
3156,3222,1,3,27,31,1.1612903225806452,0.08160716542370013,673,Sorry. We only treat gymnasts
3165,3222,0,5,26,31,1.1612903225806452,0.06715051611181075,673,Here is a prescription which will keep you from growing a fox mask.
3505,3222,1,3,27,31,1.1612903225806452,0.08160716542370013,673,You should get a ahead too and feel different about yourself.
3614,3222,1,3,27,31,1.1612903225806452,0.08160716542370013,673,Take this and you'll never complain again.
4189,3222,1,3,27,31,1.1612903225806452,0.08160716542370013,673,Take three pellets and call me in the morning.
4079,3222,0,5,26,31,1.1612903225806452,0.06715051611181075,673,"Yes, Master Splinter is my cousin."
4378,3222,1,3,27,31,1.1612903225806452,0.08160716542370013,673,"Sorry, I don’t take American Express. Only roadkill or Visa."
4388,3222,0,5,26,31,1.1612903225806452,0.06715051611181075,673,"'Rejected'... does this resonate, Mr. Jones ?"
2666,3222,1,3,27,31,1.1612903225806452,0.08160716542370013,673,"Yes, this is an especially bad plague season."
3740,3222,1,3,27,31,1.1612903225806452,0.08160716542370013,673,Don’t worry it’s safe. It’s been tested on rodents.
2434,3222,1,3,27,31,1.1612903225806452,0.08160716542370013,673,"I assure you Mr. Banks, I tested it myself"
655,3222,1,3,27,31,1.1612903225806452,0.08160716542370013,673,It’s the plague.
2158,3222,0,5,26,31,1.1612903225806452,0.06715051611181075,673,Take two and call me in the morning...
1683,3222,0,5,26,31,1.1612903225806452,0.06715051611181075,673,Take 2 cheese balls and call me in the morning.
1507,3222,0,5,26,31,1.1612903225806452,0.06715051611181075,673,"Take 2  a day and if your hallucinations don't go away,I will refer you to Dr.Wolf"
1359,3222,1,3,27,31,1.1612903225806452,0.08160716542370013,673,Dozens of offspring in lab tests around the country are raving about this stuff.
978,3222,0,5,26,31,1.1612903225806452,0.06715051611181075,673,"You can keep waving the card if you want, but I still a cat."
973,3222,1,3,27,31,1.1612903225806452,0.08160716542370013,673,"...so he say's, ""Listen here, see! I'm not gonna take any more crap from a rat doctor like you!"" and that was the end of him."
580,3222,1,3,27,31,1.1612903225806452,0.08160716542370013,673,Take 2 of these and call me in the morning. They will control your hallucinations.
278,3222,0,5,26,31,1.1612903225806452,0.06715051611181075,673,This prescription was a big hit back in my lab days.
2159,3222,1,3,27,31,1.1612903225806452,0.08160716542370013,673,"Doctor said "" Take this medicine and maybe it will works with you or I guess you will recover soon"""
3220,3244,1,2,22,25,1.16,0.09451631252505216,673,Do I seem like a wolf in cheap clothing?
2745,3244,1,2,22,25,1.16,0.09451631252505216,673,Trust me. I tested this one myself.
2723,3244,0,4,21,25,1.16,0.07483314773547882,673,"Squeak, squeak, squeak, squeak (Q.I.D.)....
or squeak, squeak, squeak (T.I.D.)...
and squeak, squeak, squeak (Q.A.M.)"
2455,3244,0,4,21,25,1.16,0.07483314773547882,673,Quit smoking or you’ll never be able to blow the house down.
2524,3244,1,2,22,25,1.16,0.09451631252505216,673,"Yes, it's a new drug, but I tested it myself."
2511,3244,0,4,21,25,1.16,0.07483314773547882,673,"Here, take these for pain as often as you like and don't hesitate to ask for more."
3262,3244,0,4,21,25,1.16,0.07483314773547882,673,"Yes, I did grow up in Baltimore."
2267,3244,0,4,21,25,1.16,0.07483314773547882,673,During his company medical it dawns on a whistleblower that the boss might be on to him.
2709,3244,0,4,21,25,1.16,0.07483314773547882,673,"I was assigned by your insurer, but all I'm doing a anyway is renewing your Rx."
3396,3244,0,4,21,25,1.16,0.07483314773547882,673,I only validate parking for my own species.
3841,3244,1,2,22,25,1.16,0.09451631252505216,673,Don't get this filled at any old hole in the wall.
2259,3244,1,2,22,25,1.16,0.09451631252505216,673,"Fill this prescription now,
then take one every time you eat,
and don’t forget to say “Eek-Eek.”"
3735,3244,0,4,21,25,1.16,0.07483314773547882,673,"Here, test this with your friends and let me know if it works."
3795,3244,0,4,21,25,1.16,0.07483314773547882,673,"Promise you won't me me out, ok?"
3988,3244,0,4,21,25,1.16,0.07483314773547882,673,"Yes, it's for rat poison - what else did you expect I'd have access to?"
4030,3244,0,4,21,25,1.16,0.07483314773547882,673,Excuse me? Exactly what is wrong with “weaseling” money out of you?
4126,3244,1,2,22,25,1.16,0.09451631252505216,673,Take two of these at bedtime then come back tomorrow morning and tell me if you still think I look like a Russian Wolfhound.
4320,3244,0,4,21,25,1.16,0.07483314773547882,673,Does this meet your fantasy?
4335,3244,0,4,21,25,1.16,0.07483314773547882,673,"Take two of these for anxiety, and don't eat any food you find just lying in your usual pathway."
4535,3244,0,4,21,25,1.16,0.07483314773547882,673,I specialise in mouse to mouth resuscitation.
4321,3244,0,4,21,25,1.16,0.07483314773547882,673,I may look like a rat but believe me you need to trust me.
3667,3244,0,4,21,25,1.16,0.07483314773547882,673,We do most of our testing on rats.
2168,3244,0,4,21,25,1.16,0.07483314773547882,673,"Take two in your dumpster, with sewer water, before bedtime."
477,3244,1,2,22,25,1.16,0.09451631252505216,673,"Squeak, squeak.....Squeak, squeak....Squeak?"
1877,3244,0,4,21,25,1.16,0.07483314773547882,673,"One piece of cheese, three times a day, for the rest of your life."
1925,3244,1,2,22,25,1.16,0.09451631252505216,673,These pills are medication therapy for your murophobia.  I'm an expert in cures using desensitization therapy.
14,3244,0,4,21,25,1.16,0.07483314773547882,673,I've prescribed you some alternative protein.
64,3244,0,4,21,25,1.16,0.07483314773547882,673,I reviewed the literature on this drug and hallucinations are not a side effect.
77,3244,1,2,22,25,1.16,0.09451631252505216,673,"This dose comes in large or small pellets, your pick."
315,3244,1,2,22,25,1.16,0.09451631252505216,673,I’d like to see you again in a week but also... I feel there’s something you need to say but haven’t. I think I can guess but why don’t you tell me?
330,3244,1,2,22,25,1.16,0.09451631252505216,673,I’m referring you to a specialist. He works at 14th street station.
412,3244,0,4,21,25,1.16,0.07483314773547882,673,Trust me.  It’s tested.
472,3244,1,2,22,25,1.16,0.09451631252505216,673,"What do you expect? I'm a dog, not a drug vending machine."
631,3244,0,4,21,25,1.16,0.07483314773547882,673,"Don't worry, this medication has been thoroughly tested."
620,3244,0,4,21,25,1.16,0.07483314773547882,673,"dont look so shocked, its a side effect from working at a drug company"
661,3244,1,2,22,25,1.16,0.09451631252505216,673,"Here Mr. Mark, just start taking these. Just because you can now discern the predators from the prey doesn't mean you can do anything about it. Best just to keep yourself sedated."
698,3244,0,4,21,25,1.16,0.07483314773547882,673,Now this should help that lupus condition you have.
818,3244,0,4,21,25,1.16,0.07483314773547882,673,"Believe me, this would be better with a  public option."
991,3244,0,4,21,25,1.16,0.07483314773547882,673,Take my card. No need to flinch; I've already infected you with bubonic plague.
1343,3244,0,4,21,25,1.16,0.07483314773547882,673,"Here is the prescription, use with caution."
1473,3244,0,4,21,25,1.16,0.07483314773547882,673,Make sure to lick the wound constantly and eat plenty of pizza.
1492,3244,1,2,22,25,1.16,0.09451631252505216,673,"I really don't like your eyes, so, get back your credit card!"
1498,3244,0,4,21,25,1.16,0.07483314773547882,673,This prescription should work for you. We use it all the time.
1808,3244,1,2,22,25,1.16,0.09451631252505216,673,"Listen to your inner voice, listen to your inner voice..."
650,3244,1,2,22,25,1.16,0.09451631252505216,673,"what do you MEAN you won’t participate in animal trials. 
take the script!"
2764,3289,1,3,28,32,1.15625,0.07917639300749574,673,"Here's your viagra prescription, you dirty rat."
4250,3289,1,3,28,32,1.15625,0.07917639300749574,673,What?  It's your ticket to emulate!
2857,3289,1,3,28,32,1.15625,0.07917639300749574,673,I'm sure you can tell that I'm not a quack.....
2853,3289,0,5,27,32,1.15625,0.06521328221627366,673,Cheese! Lots of cheese. Then more cheese.
2071,3289,0,5,27,32,1.15625,0.06521328221627366,673,Eat three cheese squares and call me in the morning.
459,3289,1,3,28,32,1.15625,0.07917639300749574,673,Don't look alarmed. I won. I am the rat race winner.
1052,3289,1,3,28,32,1.15625,0.07917639300749574,673,"The plague was long ago, but I ask my patients to take these anyway."
54,3289,1,3,28,32,1.15625,0.07917639300749574,673,"Take two of these everyday, and hopefully you won't turn out like me."
1438,3289,1,3,28,32,1.15625,0.07917639300749574,673,A sheep in fox clothing?
2494,3298,0,4,22,26,1.1538461538461537,0.07216024245882201,673,I'm going to refer you to a more qualified rat fink
2607,3298,0,4,22,26,1.1538461538461537,0.07216024245882201,673,You might want to try my astrologer.
2750,3298,0,4,22,26,1.1538461538461537,0.07216024245882201,673,Take two slices of Muenster and call me in the morning.
2768,3298,1,4,34,39,1.1538461538461537,0.06910319629955256,673,"Don’t listen to those ads
It’s a trap I should know."
2785,3298,0,4,22,26,1.1538461538461537,0.07216024245882201,673,Oh come on.... you ...you....you dirty rat “
3031,3298,1,2,23,26,1.1538461538461537,0.09101661204768642,673,A buy out on your trappings.
4555,3298,1,2,23,26,1.1538461538461537,0.09101661204768642,673,Here’s my card.
3300,3298,0,4,22,26,1.1538461538461537,0.07216024245882201,673,The research shows it works on mice and humans.
3666,3298,1,2,23,26,1.1538461538461537,0.09101661204768642,673,I can huff and puff but you'll need more than that for your fever.
4012,3298,0,4,22,26,1.1538461538461537,0.07216024245882201,673,"These will tide you over  until your prescription is filled  or you hit the lottery, whichever occurs first."
4074,3298,0,4,22,26,1.1538461538461537,0.07216024245882201,673,Take two slices of Cheddar and call me in the morning.
4159,3298,0,4,22,26,1.1538461538461537,0.07216024245882201,673,I also consented to the experimental drug testing. You have nothing to worry about!
4193,3298,1,2,23,26,1.1538461538461537,0.09101661204768642,673,"This will surely help u.
Jack irack@aol.com"
4353,3298,0,4,22,26,1.1538461538461537,0.07216024245882201,673,A few drops of this in your water dispenser and you'll be back on the wheel in no time.
4534,3298,1,2,23,26,1.1538461538461537,0.09101661204768642,673,"Trust me, Dr. Skinner will cure that smoking habit in no time."
4411,3298,0,4,22,26,1.1538461538461537,0.07216024245882201,673,"Relax, even I take it twice a day."
2468,3298,1,2,23,26,1.1538461538461537,0.09101661204768642,673,"No, really - take it."
3389,3298,0,4,22,26,1.1538461538461537,0.07216024245882201,673,"What have you done with my doctor? And no, I won't sign-up for your network!"
2390,3298,0,4,22,26,1.1538461538461537,0.07216024245882201,673,"This is a referral to my brother at Disney.""




""This is a referral to my brother at Disney."""
3256,3298,0,4,22,26,1.1538461538461537,0.07216024245882201,673,Don't worry.  I tried it myself.
2163,3298,0,4,22,26,1.1538461538461537,0.07216024245882201,673,I've increased the dosage so your trap feels more like a maze.
3640,3298,0,4,22,26,1.1538461538461537,0.07216024245882201,673,I've seen this before... I'm afraid you'll have to lay off the pizza.
2279,3298,0,4,22,26,1.1538461538461537,0.07216024245882201,673,"Take two aspirin and refrain from hanging your dry cleaning on your eyeballs.





Bobby Gregory Plainfield, NJ"
59,3298,0,4,22,26,1.1538461538461537,0.07216024245882201,673,Take two of these and crawl me in the morning.
100,3298,1,2,23,26,1.1538461538461537,0.09101661204768642,673,"Yes, “Flowers for Algernon” was based on my life, and no, I didn’t see a penny. Where’s a good lawyer when you need one?"
206,3298,1,2,23,26,1.1538461538461537,0.09101661204768642,673,"The Black Plague? Yeah, this one's on us."
512,3298,1,2,23,26,1.1538461538461537,0.09101661204768642,673,I’ve taken it myself.
529,3298,0,4,22,26,1.1538461538461537,0.07216024245882201,673,Let’s not make a mountain out of a mole hill. Take two and call me in the morning
573,3298,0,4,22,26,1.1538461538461537,0.07216024245882201,673,"I guarantee, this will make you feel foxier."
470,3298,0,4,22,26,1.1538461538461537,0.07216024245882201,673,"Take this prescription down the hall, turn right, and then left."
946,3298,0,4,22,26,1.1538461538461537,0.07216024245882201,673,"I know this works, I tested it on all my children."
947,3298,0,4,22,26,1.1538461538461537,0.07216024245882201,673,"This will help your face grow-into your eyes. It works great, see?"
1038,3298,1,2,23,26,1.1538461538461537,0.09101661204768642,673,It might be but a mouse on the table but I'm the rat that runs this business
1113,3298,0,4,22,26,1.1538461538461537,0.07216024245882201,673,I know the news coming from fox may be hard to swallow
1179,3298,0,4,22,26,1.1538461538461537,0.07216024245882201,673,"Dude! I don’t give a rat's ass about “conflicting prescriptions!”

Well, in that case, allow me to prescribe you some “rat's ass.”"
1322,3298,1,2,23,26,1.1538461538461537,0.09101661204768642,673,"After you take the thorn out, these are for the pain."
1366,3298,1,2,23,26,1.1538461538461537,0.09101661204768642,673,"Here is your invoice...sorry, I got nibbley."
615,3298,0,4,22,26,1.1538461538461537,0.07216024245882201,673,"Monday, 9am for intelligence lab tests."
2174,3336,0,5,28,33,1.1515151515151516,0.06338333534349057,673,It’s perfectly safe—we’ve tested it extensively on Baltimore Rats.
2496,3336,0,5,28,33,1.1515151515151516,0.06338333534349057,673,"I,m covered but your not, sorry"
3638,3336,0,5,28,33,1.1515151515151516,0.06338333534349057,673,"Yes, of course. It's called the doctor-patient confidentiality agreement. Why does everyone keep asking me that?"
2701,3339,0,3,17,20,1.15,0.08191780219091255,673,"You can stop the experiment any time you want, just by inserting this in the right slot. But we dissect you in any case."
2287,3339,0,3,17,20,1.15,0.08191780219091255,673,"This is a 30 day prescription. And don't try to weasel a bigger supply out of Me again."""
2395,3339,0,3,17,20,1.15,0.08191780219091255,673,"No, I've taken it myself with no noticeable side effects."
2453,3339,0,3,17,20,1.15,0.08191780219091255,673,These worked for me and will give you that extra giddy-up in your step.
2710,3339,1,1,18,20,1.15,0.10942433098048311,673,"I think this should help with your fear. However, I'd like to remind you that I chose this tiny trackball for its outstanding ergonomic properties."
4101,3339,0,3,17,20,1.15,0.08191780219091255,673,Take three puffs and you'll be able to blow the house down.
3338,3339,0,3,17,20,1.15,0.08191780219091255,673,Please read careful for risks and side-effects
3586,3339,0,3,17,20,1.15,0.08191780219091255,673,"It's actually not true, but to ease your concerns, patient confidentiality prohibits me from telling on you."
3880,3339,0,3,17,20,1.15,0.08191780219091255,673,"Don't trap the mouse-enger,
it's the claims department that has the rats."
3960,3339,0,3,17,20,1.15,0.08191780219091255,673,I'm allergic to cats too.
1988,3339,1,1,18,20,1.15,0.10942433098048311,673,Take 2 of these daily. And avoid taking them with cheese.
4229,3339,0,3,17,20,1.15,0.08191780219091255,673,"Early trial, off label? I personally guarantee results."
3145,3339,0,3,17,20,1.15,0.08191780219091255,673,It takes one to know one. Take two of these and don't come back.
1750,3339,1,1,18,20,1.15,0.10942433098048311,673,This is not your grandmother's cure-all.
1305,3339,0,3,17,20,1.15,0.08191780219091255,673,Here's your prescription. Eat more squirrels.
1476,3339,0,3,17,20,1.15,0.08191780219091255,673,I want you to drag a couple of pizzas home by your teeth and call me in the morning.
1545,3339,0,3,17,20,1.15,0.08191780219091255,673,"Here, this'll fatten you up."
1826,3339,0,3,17,20,1.15,0.08191780219091255,673,"I would take them wrapped them in cheese, but that's just me."
9,3339,0,3,17,20,1.15,0.08191780219091255,673,"So, you say you smell a rat; get me some cheese!"
73,3339,0,3,17,20,1.15,0.08191780219091255,673,Scavange two of these and call me in the morning.
313,3339,0,3,17,20,1.15,0.08191780219091255,673,I was once in your position. No more!
464,3339,0,3,17,20,1.15,0.08191780219091255,673,Fear of doctor-rodents is a common phobia - this should help.
226,3339,1,4,35,40,1.15,0.0674631903431942,673,"Here's the cheese receipt--it might be expensive, but in the future you shouldn't rat on others!"
769,3339,0,3,17,20,1.15,0.08191780219091255,673,Four our of five rat doctors swear by it. Trust me.
1193,3339,0,3,17,20,1.15,0.08191780219091255,673,"Here's the number of the guy I was talking about, in the event you 'Do"" need stitches."
1253,3339,0,3,17,20,1.15,0.08191780219091255,673,That'll be $200 in cheese blocks (American and Cheddar preferred).
1266,3339,0,3,17,20,1.15,0.08191780219091255,673,Your co-pay on your way out will be three wheels of cheese.
1436,3339,0,3,17,20,1.15,0.08191780219091255,673,"It’s safe, I promise. It’s been tested on mice."
612,3339,1,1,18,20,1.15,0.10942433098048311,673,Take two of these new drugs and call me in the morning.
3574,3368,1,2,24,27,1.1481481481481481,0.08776593618660604,673,2 a day and you should be back to your old self in no time.
2613,3368,1,2,24,27,1.1481481481481481,0.08776593618660604,673,They've moved from my ears to my nose.
2938,3368,1,2,24,27,1.1481481481481481,0.08776593618660604,673,"Take these, Mr. Hood, they’ll help you forget about your mother."
3266,3368,1,2,24,27,1.1481481481481481,0.08776593618660604,673,Take two of these and call me in the full moon.
3570,3368,1,2,24,27,1.1481481481481481,0.08776593618660604,673,Exchange these skeeball tickets for opioids.
3597,3368,1,2,24,27,1.1481481481481481,0.08776593618660604,673,Better to have a few rats than to be one
4569,3368,1,2,24,27,1.1481481481481481,0.08776593618660604,673,"Of course you can trust me, I got a 98 on my M-RAT"
3882,3368,0,4,23,27,1.1481481481481481,0.06966962541673778,673,"I'm lactose intolerant too, but they make great vegan cheese these days."
4056,3368,0,4,23,27,1.1481481481481481,0.06966962541673778,673,You are the 5th maze cleaner I have hired this week.
4106,3368,0,4,23,27,1.1481481481481481,0.06966962541673778,673,"This is Coumadin, and  believe me it can be fatal in high doses."
4208,3368,0,4,23,27,1.1481481481481481,0.06966962541673778,673,Here's your prescription - it works fine; and I know from personal experience that there are no bad side effects.
4443,3368,1,2,24,27,1.1481481481481481,0.08776593618660604,673,Just take the deal
2563,3368,0,4,23,27,1.1481481481481481,0.06966962541673778,673,"Give this to your pharmacist. 
And please, no rat’s ass jokes!"
3814,3368,1,2,24,27,1.1481481481481481,0.08776593618660604,673,"Sometimes I don't feel like myself, either."
2379,3368,0,4,23,27,1.1481481481481481,0.06966962541673778,673,"Don't worry, all these drugs were tested on me first."
4120,3368,0,4,23,27,1.1481481481481481,0.06966962541673778,673,Three times a day should cure hallucinations.
1979,3368,1,2,24,27,1.1481481481481481,0.08776593618660604,673,"Before we start, would you care for a slice of cheese?"
202,3368,0,4,23,27,1.1481481481481481,0.06966962541673778,673,"Take two and remember, don't Fennec."
284,3368,1,2,24,27,1.1481481481481481,0.08776593618660604,673,I just need one more punch for free cheese.
311,3368,1,2,24,27,1.1481481481481481,0.08776593618660604,673,"Sir, this card needs to be renewed. It says you're a 25 year old anteater."
495,3368,0,4,23,27,1.1481481481481481,0.06966962541673778,673,Seriously.  You need to stop with the Baltimore talk.  It's affecting everything you do.
499,3368,1,2,24,27,1.1481481481481481,0.08776593618660604,673,"Don't worry, everything I prescribe I've already tried on myself."
747,3368,0,4,23,27,1.1481481481481481,0.06966962541673778,673,I know I look like a wolf but I'm not.
704,3368,0,4,23,27,1.1481481481481481,0.06966962541673778,673,"Yes, it is true that 99% of us didn't survive the tobacco testing. But people are reluctant to discuss the 1% of us who thrived on it."
980,3368,1,2,24,27,1.1481481481481481,0.08776593618660604,673,"Every time you start to feel anxious, I want you to take two doses of the domestic Swiss I've prescribed. My colleagues swear by it."
1287,3368,0,4,23,27,1.1481481481481481,0.06966962541673778,673,This is less a cure for you and more of f a completion of human testing for me.
1439,3368,0,4,23,27,1.1481481481481481,0.06966962541673778,673,The dose makes the medicine...
1527,3368,0,4,23,27,1.1481481481481481,0.06966962541673778,673,Get this prescription filled immediately and take 6 of them when you get home and you may stop hallucinating until your next office visit.
1709,3368,0,4,23,27,1.1481481481481481,0.06966962541673778,673,"Sir, I will prescribe you this medication, but be careful. It is known to make people hallucinate.""

""Don't worry doc, I have had it before"
1833,3368,1,2,24,27,1.1481481481481481,0.08776593618660604,673,Have this filled fast before the next full moon.
921,3368,1,2,24,27,1.1481481481481481,0.08776593618660604,673,"Don't worry, this prescription worked for me."
2105,3368,0,4,23,27,1.1481481481481481,0.06966962541673778,673,This is for your hallucinations. However if you start seeing people call me immediately.
2661,3400,0,5,29,34,1.1470588235294117,0.06165213406602946,673,It’s for a new drug that guarantees you stop imagining rodents ruling the world.
1255,3401,0,6,35,41,1.146341463414634,0.05588506945068099,673,"I assure you, the howls will clear up your identity disorder."
3353,3402,0,3,18,21,1.1428571428571428,0.07824607964359519,673,Welcome to Baltimore.
3001,3402,0,4,24,28,1.1428571428571428,0.0673435029701474,673,"It is a prescription for Rodentia, a replacement for the generic placebo that worked too well."
3887,3402,0,4,24,28,1.1428571428571428,0.0673435029701474,673,Take these for a squeak.
3681,3402,0,4,24,28,1.1428571428571428,0.0673435029701474,673,This will make all your pain go away. Trust me!
3875,3402,1,2,25,28,1.1428571428571428,0.0847387162859628,673,I prefer that you pay me in Bitcoin.
2843,3402,1,2,25,28,1.1428571428571428,0.0847387162859628,673,"Before treating your disease, you will testing from  the foot to  head  and then starting treatment."
3652,3402,0,4,24,28,1.1428571428571428,0.0673435029701474,673,"Hallucinations and paranoia are rare side effects of your medication, but there's always that unlucky patient. I've adjusted the dose, here's a new Rx, and no, I'm not trying to poison you."
2775,3402,0,4,24,28,1.1428571428571428,0.0673435029701474,673,Sorry. I'm a weasel. You'll need to see the guys in the maze to get this ratified.
24,3402,0,4,24,28,1.1428571428571428,0.0673435029701474,673,"Take 1 weekly dose of CBT and preform regular exercise .
Don't watch cable New
Billing code    Service      *Insurance Type  Insurance Pays  Balance 
 64656   radical concepts     Medicaid     100%      -$52.97"
2139,3402,0,3,18,21,1.1428571428571428,0.07824607964359519,673,The only side effects are an allergic reaction to cats and a greater appreciation for cheese.
1374,3402,0,4,24,28,1.1428571428571428,0.0673435029701474,673,I started off in a lab but worked hard and made something of myself.
1356,3402,0,3,18,21,1.1428571428571428,0.07824607964359519,673,Tell them Dr. At sent you
1189,3402,1,2,25,28,1.1428571428571428,0.0847387162859628,673,It was just a nerdy doctor's visit. Now I'm getting asked out.
905,3402,1,2,25,28,1.1428571428571428,0.0847387162859628,673,"Next appointment, let's see how you do on the maze challenge."
712,3402,0,3,18,21,1.1428571428571428,0.07824607964359519,673,Take it from me. Follow these directions implicitly.
324,3402,1,2,25,28,1.1428571428571428,0.0847387162859628,673,can you believe it's 2019 and people still discriminates me Because of my race
3895,3402,0,3,18,21,1.1428571428571428,0.07824607964359519,673,They've been tested on me.
2942,3402,0,4,24,28,1.1428571428571428,0.0673435029701474,673,For the generic blood thinner d-Con. Throw away the bait station.
2277,3402,0,3,18,21,1.1428571428571428,0.07824607964359519,673,"squeak, squeak, squeak!"
4542,3402,0,3,18,21,1.1428571428571428,0.07824607964359519,673,You’re next
1392,3422,0,4,25,29,1.1379310344827587,0.06516628844986679,673,"Here's a refill on that rat poi- I mean, sedative."
4451,3423,0,3,19,22,1.1363636363636365,0.0748867700952649,673,Here’s your prescription. You should start seeing people as humans again in two to four weeks.
3235,3423,1,1,20,22,1.1363636363636365,0.09968466614432427,673,"Little do people realize, the best way to trap a rat is 8 years of crippling medical school debt"
3200,3423,0,3,19,22,1.1363636363636365,0.0748867700952649,673,Try it for a while.  I think it'll do wonders for you.  I use it myself.
3197,3423,0,3,19,22,1.1363636363636365,0.0748867700952649,673,"I know appointment cards are obsolete these days, but they keep printing them so I keep handing them out."
3108,3423,0,3,19,22,1.1363636363636365,0.0748867700952649,673,I'd like you to take part in an experiment....
3088,3423,0,3,19,22,1.1363636363636365,0.0748867700952649,673,This should do the trick. I tested it myself.
3045,3423,0,3,19,22,1.1363636363636365,0.0748867700952649,673,"It all began after Trump's tweet about Baltimore! They found out we outnumbered the residents by so much, we were given the right to vote and our lot improved exponentially since then. I was able to go to medical school and moved to the burbs."
2988,3423,0,3,19,22,1.1363636363636365,0.0748867700952649,673,"The streptomycin will help with the symptoms, but we really need to examine where you think you might have been exposed."
3289,3423,0,3,19,22,1.1363636363636365,0.0748867700952649,673,God news I can fit you in for a sleep study tomorrow
2890,3423,0,3,19,22,1.1363636363636365,0.0748867700952649,673,"This your referral to see an extermina . . . um, I mean, specialist."
2721,3423,0,3,19,22,1.1363636363636365,0.0748867700952649,673,Do you ever experience hallucinations?
2720,3423,0,3,19,22,1.1363636363636365,0.0748867700952649,673,"Thanks again for leaving your cat at home today Bill. I know how attached you are to ""Fluffy""  and take her everywhere but for some strange reason she just gives me the creeps."
2708,3423,0,3,19,22,1.1363636363636365,0.0748867700952649,673,I’ll have you know I was first in my class at RAT.
2702,3423,0,3,19,22,1.1363636363636365,0.0748867700952649,673,Take this every full moon. It worked for me.
2655,3423,0,3,19,22,1.1363636363636365,0.0748867700952649,673,Here's the name of a specialist I know in Baltimore.
2626,3423,1,1,20,22,1.1363636363636365,0.09968466614432427,673,It's a very safe drug. I take it myself.
2538,3423,0,3,19,22,1.1363636363636365,0.0748867700952649,673,I want you to take this medication three times a day.  I think you'll be pleasantly surprised....a lot of patients say it tastes like cheese!
2736,3423,0,3,19,22,1.1363636363636365,0.0748867700952649,673,"Don't worry about the side effects. Trust me, I've been taking it myself for years."
4466,3423,0,3,19,22,1.1363636363636365,0.0748867700952649,673,It's time to return the favor--it's an experimental drug.
3375,3423,0,3,19,22,1.1363636363636365,0.0748867700952649,673,"Compare this new Rodent All Inclusive Prescription Card to Medicare's Plan! It's inexpensive and accepted World-Wide!
Bon Voyage!!!"
3623,3423,0,3,19,22,1.1363636363636365,0.0748867700952649,673,"Trust me, there are no side effects"
4409,3423,0,3,19,22,1.1363636363636365,0.0748867700952649,673,You said this costs how much above ground?
4355,3423,0,3,19,22,1.1363636363636365,0.0748867700952649,673,This will only take away the rats that aren't real.
4301,3423,0,3,19,22,1.1363636363636365,0.0748867700952649,673,"It may work wherever you want to be 
but not at the Vet."
4290,3423,1,1,20,22,1.1363636363636365,0.09968466614432427,673,I DON'T GIVE A RATS ASS ABOUT YOUR ATTITUDE
4255,3423,0,3,19,22,1.1363636363636365,0.0748867700952649,673,"This prescription should fix your pop-eye. Be aware that there are some unusual side-effects, as I myself  can attest to."
4195,3423,0,3,19,22,1.1363636363636365,0.0748867700952649,673,"Don't take too much, it can cause ulcers"
4116,3423,0,3,19,22,1.1363636363636365,0.0748867700952649,673,"Please don´t call it a ""mouse"". We prefer ""pointer""."
3384,3423,0,3,19,22,1.1363636363636365,0.0748867700952649,673,Credit or debit?
4104,3423,0,3,19,22,1.1363636363636365,0.0748867700952649,673,This is your doctor's note recommending you tell the Senate you cannot vote on any gun control legislation until your shoulder heals.
2516,3423,0,3,19,22,1.1363636363636365,0.0748867700952649,673,"Excuse me, the pipes are calling."
3982,3423,0,3,19,22,1.1363636363636365,0.0748867700952649,673,"Now this prescription is for an anticoagulant that will prevent more blood clots. However, never take more than I have prescribed.  I have seen too many of my friends and family die from overdosing on this drug!"
3870,3423,0,3,19,22,1.1363636363636365,0.0748867700952649,673,"To be honest, my real dream was to be a veterinarian with a small animal practice on Old McDonald’s farm."
3863,3423,0,3,19,22,1.1363636363636365,0.0748867700952649,673,I call your condition 'beady eye syndrome.' This should make things right.
3741,3423,0,3,19,22,1.1363636363636365,0.0748867700952649,673,Take this down to Maze 4.
3711,3423,0,3,19,22,1.1363636363636365,0.0748867700952649,673,"You must avoid cheese, so bring me any you have left."
3690,3423,0,3,19,22,1.1363636363636365,0.0748867700952649,673,I'm prescribing a placebo.
4001,3423,1,1,20,22,1.1363636363636365,0.09968466614432427,673,Follow the directions or else...
2300,3423,0,3,19,22,1.1363636363636365,0.0748867700952649,673,Forget about you co-pay. What I really need to know is do you have any pizza?
775,3423,1,1,20,22,1.1363636363636365,0.09968466614432427,673,Baltimore. Why do you ask?
2269,3423,0,3,19,22,1.1363636363636365,0.0748867700952649,673,I'm not a rat!
1079,3423,0,3,19,22,1.1363636363636365,0.0748867700952649,673,You forgot to say cheese?
1074,3423,0,3,19,22,1.1363636363636365,0.0748867700952649,673,These medications have been tested on real teddy bears.
995,3423,0,3,19,22,1.1363636363636365,0.0748867700952649,673,"I'm almost certain this will do the trick. If not, too bad."
974,3423,0,3,19,22,1.1363636363636365,0.0748867700952649,673,Take two of these. Your bark should be back in the morning.
917,3423,0,3,19,22,1.1363636363636365,0.0748867700952649,673,"No, Dr. Weasel was not metaphorical."
810,3423,0,3,19,22,1.1363636363636365,0.0748867700952649,673,Your species tends to have anxiety problems. Take one of these daily with a bowl of milk.
796,3423,0,3,19,22,1.1363636363636365,0.0748867700952649,673,"Well, it worked just fine on one of my brothers."
1087,3423,0,3,19,22,1.1363636363636365,0.0748867700952649,673,"Sorry, but me being a giant ferret and you suffering from hallucinations are not mutually exclusive."
763,3423,0,3,19,22,1.1363636363636365,0.0748867700952649,673,Here is a referral. My insurance does not cover that.
709,3423,0,3,19,22,1.1363636363636365,0.0748867700952649,673,This script is for cheese. Always works for me
705,3423,0,3,19,22,1.1363636363636365,0.0748867700952649,673,"It's your ass, not mine."
298,3423,1,1,20,22,1.1363636363636365,0.09968466614432427,673,I tested it in the lab myself.
184,3423,0,3,19,22,1.1363636363636365,0.0748867700952649,673,You're clearly not eating enough cheese.
95,3423,0,3,19,22,1.1363636363636365,0.0748867700952649,673,Here's my reference. I was a lab rat - now I'm a genius.
85,3423,0,3,19,22,1.1363636363636365,0.0748867700952649,673,"Don't worry, this cheese diet is quite safe.  I've tested it myself."
2278,3423,0,3,19,22,1.1363636363636365,0.0748867700952649,673,"I took it when it was experimental, so you should be fine."
745,3423,0,3,19,22,1.1363636363636365,0.0748867700952649,673,"Of course, I'm a real doctor.  I finished #1 in veterinary medicine."
1121,3423,1,1,20,22,1.1363636363636365,0.09968466614432427,673,Give my office a call if you experience anything unusual.
320,3423,0,3,19,22,1.1363636363636365,0.0748867700952649,673,"This experimental medication still has a few kinks to work out, but take it from me that it will solve your indigestion."
1321,3423,1,1,20,22,1.1363636363636365,0.09968466614432427,673,"Believe me I know all about cat allergies, here get this filled."""
1133,3423,0,3,19,22,1.1363636363636365,0.0748867700952649,673,Don't worry. I've tested it personally.
2268,3423,1,1,20,22,1.1363636363636365,0.09968466614432427,673,"Yeah, I know Warfarin is rat poison, but trust me, you need it."
2264,3423,0,3,19,22,1.1363636363636365,0.0748867700952649,673,Side affects may include increased cravings of cheese and insulation.
2214,3423,0,3,19,22,1.1363636363636365,0.0748867700952649,673,No Humans were harmed when testing this Medication...
2200,3423,0,3,19,22,1.1363636363636365,0.0748867700952649,673,You may find side effects to be particularly pronounced during a full moon.
2063,3423,0,3,19,22,1.1363636363636365,0.0748867700952649,673,"If you see anymore 'sheep,' call me immediately."
2031,3423,0,3,19,22,1.1363636363636365,0.0748867700952649,673,If these pills don't work I strongly suggest getting out of this rat race.
1675,3423,0,3,19,22,1.1363636363636365,0.0748867700952649,673,This medication is a-maze-ing!
2218,3423,0,3,19,22,1.1363636363636365,0.0748867700952649,673,"If you're seeing what you say you're seeing, you DO need anti-psychotics."
1598,3423,0,3,19,22,1.1363636363636365,0.0748867700952649,673,This note is for your ophthalmologist to prescribe new glasses for you.
1566,3423,0,3,19,22,1.1363636363636365,0.0748867700952649,673,"This should do the trick, as long as you’re OK with prolonged close confinement."
1564,3423,0,3,19,22,1.1363636363636365,0.0748867700952649,673,Move to Canada or I call your HMO
1510,3423,0,3,19,22,1.1363636363636365,0.0748867700952649,673,"Don't believe the orange guy, we do good work here in Baltimore."
1463,3423,1,1,20,22,1.1363636363636365,0.09968466614432427,673,I know you're anxious right now but I can assure you that the hen house is fine.
1376,3423,0,3,19,22,1.1363636363636365,0.0748867700952649,673,"Look at my phone and count backwards from 100. Soon, you'll become more and more uninteresting..."
1616,3423,0,3,19,22,1.1363636363636365,0.0748867700952649,673,"W never use less than 100 humans in our control group."""
1349,3423,0,3,19,22,1.1363636363636365,0.0748867700952649,673,"My Dr. Fink, what a big nose you have!"
574,3501,1,2,27,30,1.1333333333333333,0.0792686880439847,673,"Actually, that would be good card trick for a human or a rat”"
3381,3502,0,3,20,23,1.1304347826086956,0.07180198468215397,673,Word to the wise. No cracks about the cheese in break room fridge.
3192,3502,0,3,20,23,1.1304347826086956,0.07180198468215397,673,"Ok, get this filled and pay on your way out, we take cash, credit, or a nice firm chunk of  Irish chedder."
3133,3502,0,3,20,23,1.1304347826086956,0.07180198468215397,673,Take two of these with cheese  and call me in the morning
3097,3502,0,3,20,23,1.1304347826086956,0.07180198468215397,673,Here is the guy who grooms my facial hair.
2828,3502,0,3,20,23,1.1304347826086956,0.07180198468215397,673,"I know it's experimental, but I wouldn't be where I am today without it."
2596,3502,0,3,20,23,1.1304347826086956,0.07180198468215397,673,Take this. In six months you should look like the rest of us.
2715,3502,0,3,20,23,1.1304347826086956,0.07180198468215397,673,"I think this should help with your fear. However, I'd like to remind you that I chose this particular trackball due to its outstanding ergonomic properties."
2558,3502,0,3,20,23,1.1304347826086956,0.07180198468215397,673,‘You could enter a study. Know anything about mazes?”
3418,3502,0,3,20,23,1.1304347826086956,0.07180198468215397,673,Here's the number of an optometrist friend of mine.
2448,3502,1,1,21,23,1.1304347826086956,0.09543633571264536,673,"And as it turned out, running around that wheel was more like climbing a ladder."
2751,3502,1,1,21,23,1.1304347826086956,0.09543633571264536,673,Just 'cause the Cat's away...doesn't mean I'm not a real Doctor!
3445,3502,0,3,20,23,1.1304347826086956,0.07180198468215397,673,"This is supposed to work, but it’s plagued with side effects...."
4047,3502,0,3,20,23,1.1304347826086956,0.07180198468215397,673,"Too much paperwork, not enough walks."
3529,3502,0,3,20,23,1.1304347826086956,0.07180198468215397,673,Take two of these and meet me at your grandmother’s house.1564859879.24a15c50-dde0-490c-9201-ae56d8234
3552,3502,0,3,20,23,1.1304347826086956,0.07180198468215397,673,My cousins back at the lab all swear by this stuff.
3569,3502,0,3,20,23,1.1304347826086956,0.07180198468215397,673,Are you seriously bribing me with Cheese of the Month?
3655,3502,0,3,20,23,1.1304347826086956,0.07180198468215397,673,"Here's your perscription, and don't worry so much I had the bubonic plague once and look at me know.

If you don't take this fast you'll be stuck as a filthy human forever."
3703,3502,0,3,20,23,1.1304347826086956,0.07180198468215397,673,"My professional advice is to stop eating garbage, it hasn't done me any favors."
3716,3502,0,3,20,23,1.1304347826086956,0.07180198468215397,673,"So the guy says, ""A horse walks into a bar and asks for a drink"" and at that point I'm already lost. I mean, a talking horse? Anyways, I'm blabbering. Here's your prescription. Call me in a week, if the hallucinations persist."
3757,3502,0,3,20,23,1.1304347826086956,0.07180198468215397,673,"Don't worry, I've done plenty of open chests."
3809,3502,0,3,20,23,1.1304347826086956,0.07180198468215397,673,"Have these drugs been tested?!""  Yes! Do you want to hear about testing"
4446,3502,0,3,20,23,1.1304347826086956,0.07180198468215397,673,I use it myself
4449,3502,0,3,20,23,1.1304347826086956,0.07180198468215397,673,Take these three times a day and you’ll be looking like your old rat self again in no time.
3394,3502,1,1,21,23,1.1304347826086956,0.09543633571264536,673,Buy and hold the better mousetrap.
2440,3502,0,3,20,23,1.1304347826086956,0.07180198468215397,673,Thanks for seeing a cheese specialist... here are the supplements you can take to deal with your lactose intolerance.
3527,3502,0,3,20,23,1.1304347826086956,0.07180198468215397,673,Here’s my business card. And also a reminder to pay the co-pay before you leave the office.
2308,3502,0,3,20,23,1.1304347826086956,0.07180198468215397,673,We don’t treat too many human beings here in Baltimore
1759,3502,0,3,20,23,1.1304347826086956,0.07180198468215397,673,"Ok, so we'll cut back to 6 milligrams a day, but if you have another episode I want you to call me immediately."
2226,3502,0,3,20,23,1.1304347826086956,0.07180198468215397,673,Blood thinners are rat poison
116,3502,0,3,20,23,1.1304347826086956,0.07180198468215397,673,Just take it already! I finally got 200 year old cheddar and it’s about to get moldy!
153,3502,0,3,20,23,1.1304347826086956,0.07180198468215397,673,It's a new medication derived from cheddar. Don't make the mistake I did and take it with alcohol.
185,3502,0,3,20,23,1.1304347826086956,0.07180198468215397,673,Here's your prescription. Works great. I use it myself but it has one unfortunate side effect.
225,3502,0,3,20,23,1.1304347826086956,0.07180198468215397,673,Side effects? Nothing to worry about.
2247,3502,0,3,20,23,1.1304347826086956,0.07180198468215397,673,It pains me to have to give you this.”
427,3502,1,1,21,23,1.1304347826086956,0.09543633571264536,673,It’s ‘Dr. Pizza Rat’ to you.
927,3502,0,3,20,23,1.1304347826086956,0.07180198468215397,673,I'm from Baltimore.
954,3502,1,1,21,23,1.1304347826086956,0.09543633571264536,673,We’ve been seeing a lot of these cases lately.”
1279,3502,1,1,21,23,1.1304347826086956,0.09543633571264536,673,"I'm sorry Mr. Jones, but your pet insurance won't cover your CAT scan!"
1324,3502,0,3,20,23,1.1304347826086956,0.07180198468215397,673,"These are safe, I tried them on myself."
1354,3502,1,1,21,23,1.1304347826086956,0.09543633571264536,673,"Take this medication three times a day, and you'll be 
able to get away with anything."
1483,3502,0,3,20,23,1.1304347826086956,0.07180198468215397,673,"Hey Donnie, I don't want your dirty money."
248,3502,0,3,20,23,1.1304347826086956,0.07180198468215397,673,"Fill this, and the hallucinations should subside within the week."
1583,3502,0,3,20,23,1.1304347826086956,0.07180198468215397,673,Here's your poison
1577,3502,0,3,20,23,1.1304347826086956,0.07180198468215397,673,Have this filled. I know it works on rats.
2175,3502,0,3,20,23,1.1304347826086956,0.07180198468215397,673,"With whiskers? Really? Tell you what, here is a second prescription to help with the occasional hallucinations."
2102,3502,0,3,20,23,1.1304347826086956,0.07180198468215397,673,I'll see you again in three weeks. In the meantime take this twice a day. It will make you juicier.
2100,3502,0,3,20,23,1.1304347826086956,0.07180198468215397,673,"Here'  your script renewal.  Let me know if you get dry mouth, bug eyed, or have rodent hallucinations."
1965,3502,1,1,21,23,1.1304347826086956,0.09543633571264536,673,"Rest assured, I was first in my maze."
2135,3502,0,3,20,23,1.1304347826086956,0.07180198468215397,673,It’s for your cat.
1891,3502,0,3,20,23,1.1304347826086956,0.07180198468215397,673,"Look man, alls I'm sayin' is, if you change your mind, rat Viagra works just as good."
1810,3502,0,3,20,23,1.1304347826086956,0.07180198468215397,673,Your pharmacist should be able to translate this.
1646,3502,0,3,20,23,1.1304347826086956,0.07180198468215397,673,I've taken this for years without any side effects.
1627,3502,0,3,20,23,1.1304347826086956,0.07180198468215397,673,I'm prescribing a five day course of sharp cheddar.
1923,3502,0,3,20,23,1.1304347826086956,0.07180198468215397,673,"Don't worry, I have lots of firsthand experience testing this medicine."
640,3556,0,4,27,31,1.1290322580645162,0.06120537406777509,673,"Take 4000 of these pills between now and noon tomorrow, then call and let me know how you're feeling."
105,3556,0,4,27,31,1.1290322580645162,0.06120537406777509,673,This isn't a laughing matter.
2962,3558,0,3,21,24,1.125,0.06895966054592131,673,I don't give a rat's a__ if you don't use this prescription. If you want bug eyes that's your decision.
3593,3558,0,4,28,32,1.125,0.05939887041393643,673,"Here, take my card. Otherwise, I'll huff and I'll puff, and I'll blow your house down."
3179,3558,0,3,21,24,1.125,0.06895966054592131,673,"I'll trade you this prescription for medical marijuana
 for a pound of cheese."
3431,3558,0,3,21,24,1.125,0.06895966054592131,673,You'll come around.
3456,3558,0,3,21,24,1.125,0.06895966054592131,673,This should help you kick ayahuasca.
3460,3558,0,3,21,24,1.125,0.06895966054592131,673,It's rat poison.   Great for preventing blood clots.
3626,3558,0,3,21,24,1.125,0.06895966054592131,673,"Cheese, twice daily? Really?"
4560,3558,0,3,21,24,1.125,0.06895966054592131,673,"If  your symptoms are shortness of breath, take this, but stop if your house blows down."
3748,3558,0,3,21,24,1.125,0.06895966054592131,673,I'm on their side and on your side.
3801,3558,0,3,21,24,1.125,0.06895966054592131,673,I won't rat you out dude.
3827,3558,0,3,21,24,1.125,0.06895966054592131,673,This prescription will take care of those nasty nose hairs
4114,3558,0,3,21,24,1.125,0.06895966054592131,673,There's no poison in it. Honest. I swear. Zero poison.
4247,3558,0,3,21,24,1.125,0.06895966054592131,673,You can pick up your prescription at Rat-Aid
2909,3558,1,1,22,24,1.125,0.0915348195410129,673,"I discovered that very few investors want their money managed by a kindly, old grandmother."
3697,3558,0,3,21,24,1.125,0.06895966054592131,673,"You can get this filled  at the supermarket across the street, oh and  they have  free cheese displayed next to the pharmacy in the dairy section."
2659,3558,0,3,21,24,1.125,0.06895966054592131,673,"Don’t worry, I’m 73% sure this is the right prescription."
3498,3558,0,3,21,24,1.125,0.06895966054592131,673,This should handle your hallucinating.
2344,3558,0,3,21,24,1.125,0.06895966054592131,673,"Yes, this IS normal in Baltimore!"
2547,3558,0,3,21,24,1.125,0.06895966054592131,673,Take two before the next lunar zenith.
160,3558,0,3,21,24,1.125,0.06895966054592131,673,"Marijuana is still illegal, so I'm giving you a ton of opioids."
387,3558,1,1,22,24,1.125,0.0915348195410129,673,I'm going to bite your face if you don't take this opioid prescription.
449,3558,1,1,22,24,1.125,0.0915348195410129,673,"I'm not saying plastic surgery doesn't work, just that there are no guarantees."
593,3558,0,3,21,24,1.125,0.06895966054592131,673,This is a very special brie eat two ounces and call me in the morning.
1187,3558,0,3,21,24,1.125,0.06895966054592131,673,Your credit card has been flagged...I need to turn you in.
1267,3558,0,3,21,24,1.125,0.06895966054592131,673,The Hickory Dickory Dock Pharmaceutical Company has a new drug that should help with your hallucinations
400,3558,0,3,21,24,1.125,0.06895966054592131,673,Tested on me. Foisted on you.
1521,3558,0,3,21,24,1.125,0.06895966054592131,673,"Take the number. I promise you, he’s not from Baltimore."
1435,3558,0,3,21,24,1.125,0.06895966054592131,673,Welcome to Fox and Kushner  Inc. Here's your employee access card to the hen house. Don't lose it! There's a $50 re-keying charge.
2165,3558,0,3,21,24,1.125,0.06895966054592131,673,A prescription to live in Baltimore “
2161,3558,1,1,22,24,1.125,0.0915348195410129,673,Try him. He did wonders for me when I struggled with my sexual identity.
2203,3558,0,3,21,24,1.125,0.06895966054592131,673,I know you feel that life is just an endless treadmill.  We all do.  But these meds should help.
2042,3558,0,4,28,32,1.125,0.05939887041393643,673,There’s  something about you that stirs my confidence in you.
1762,3558,1,1,22,24,1.125,0.0915348195410129,673,"Why, yes, those are my first prize certificates for hot dog/hamburger competitions. But in medical school I had to stop wolfing down that stuff -- stress raises cholesterol, you know."
46,3558,0,3,21,24,1.125,0.06895966054592131,673,No killing chickens while your taking these.
4431,3592,1,2,30,33,1.121212121212121,0.07226812131946558,673,Take two of these and don’t cull me in the morning
4536,3592,0,4,29,33,1.121212121212121,0.05769525080199931,673,This prescription would cost way more under Medicare for All.
4425,3594,1,1,23,25,1.12,0.0879393730551528,673,hey are you holding?
4061,3594,0,3,22,25,1.12,0.06633249580710801,673,Training ninja turtles is just my side hustle.
3511,3594,0,3,22,25,1.12,0.06633249580710801,673,"Cheese, I often prescribe it for myself"
3454,3594,0,3,22,25,1.12,0.06633249580710801,673,This is a new drug which should be great for your problem but we need you to keep track of the side effects.
3077,3594,0,3,22,25,1.12,0.06633249580710801,673,Let's try this pan-species medication.
2712,3594,0,3,22,25,1.12,0.06633249580710801,673,Don’t worry. It’s proven effective when tested on lawyers.
2495,3594,0,3,22,25,1.12,0.06633249580710801,673,"Don’t worry,  the side effects of vaccines are unlikely."
2460,3594,0,3,22,25,1.12,0.06633249580710801,673,"First we help you through the maze of healthcare, then we go for the cheese."
2426,3594,0,3,22,25,1.12,0.06633249580710801,673,"They're pellets, but they're good."
3919,3594,0,3,22,25,1.12,0.06633249580710801,673,"Sorry, I no longer make house calls."
2386,3594,0,3,22,25,1.12,0.06633249580710801,673,I tested this medicine and it didn't kill me.
1863,3594,0,3,22,25,1.12,0.06633249580710801,673,I forgot to give this to your daughter for her birth control pills; it's our new Placebo-brand product.
1589,3594,1,1,23,25,1.12,0.0879393730551528,673,"The thing is that you have cancer...
 The good news is we can ""cure"" it  if you wire 200 grand to this account!"
1419,3594,0,3,22,25,1.12,0.06633249580710801,673,You need to get this to your pharmacy as fast as you can. It's not that you have a life-threatening condition. It's that you're scaring away my staff and patients.
938,3594,0,3,22,25,1.12,0.06633249580710801,673,Here's your prescription and don't try to weasel out on your co-pay
835,3594,0,3,22,25,1.12,0.06633249580710801,673,"Here, take this business card. He's a brilliant costumier and with a nice rat mask like mine, you'll have a better chance of winning the race."
50,3594,0,3,22,25,1.12,0.06633249580710801,673,Stop writing nonsense letters on the floor
833,3594,1,1,23,25,1.12,0.0879393730551528,673,And I tell all my patients to get tested for bubonic plague.
96,3594,0,3,22,25,1.12,0.06633249580710801,673,"I'm not getting ratty with you, Mr Smith. But I do have other patients and your 101 symptoms are all in your head."""
2422,3594,0,3,22,25,1.12,0.06633249580710801,673,"Here is a prescription for a digital visual adjustment.  You seem to have an obsession with your ""mouse"""
1876,3614,0,4,30,34,1.1176470588235294,0.05608603466150544,673,This antibiotic should take care of that infection. Shall we follow-up in… oh… about a month?
4393,3615,0,3,23,26,1.1153846153846154,0.06389710663783134,673,"Look-
I went from lab rat to md.
I think I know what I’m talking about."
4269,3615,0,3,23,26,1.1153846153846154,0.06389710663783134,673,I'm required to disclose that I get a cheddar for recommending Ameropioidcrisis.
3583,3615,1,1,24,26,1.1153846153846154,0.0846153846153846,673,It’s very safe. It was tested on guinea pigs.
3301,3615,0,3,23,26,1.1153846153846154,0.06389710663783134,673,Wait - did you say you were allergic to cheese?
2913,3615,0,3,23,26,1.1153846153846154,0.06389710663783134,673,You may experience a strong desire to roam around subway stops.
4027,3615,1,1,24,26,1.1153846153846154,0.0846153846153846,673,"Here's your prescription for the erectile dysfunction."""
2155,3615,0,3,23,26,1.1153846153846154,0.06389710663783134,673,You're actually looking at the smallest prescription rat.
1694,3615,0,3,23,26,1.1153846153846154,0.06389710663783134,673,This is a clinical trial with some side effects like perceptions of deceit. You feeling anything at all should go away after a dose or two.
1639,3615,0,3,23,26,1.1153846153846154,0.06389710663783134,673,"If I were you, I wouldn't worry so much about the side-effects."
840,3615,0,3,23,26,1.1153846153846154,0.06389710663783134,673,That's very derogatory. I'll have you know I've never once violated HIPAA.
503,3615,0,3,23,26,1.1153846153846154,0.06389710663783134,673,"Take two of these a day, I take them myself and have seen a real change in my outlook."
496,3615,0,3,23,26,1.1153846153846154,0.06389710663783134,673,You need a cheese free diet
2185,3615,0,3,23,26,1.1153846153846154,0.06389710663783134,673,You aren't covered!
1342,3628,0,4,31,35,1.1142857142857143,0.054563640607556065,673,I'm getting cancelled for this one
1940,3628,0,4,31,35,1.1142857142857143,0.054563640607556065,673,It's just to maintain my anonymity while I soak you.
2839,3630,0,3,24,27,1.1111111111111112,0.06163335513613654,673,It's only been tested on humans.
2943,3630,1,1,25,27,1.1111111111111112,0.0815332650783714,673,Take this and see me in the burrow.
2947,3630,0,3,24,27,1.1111111111111112,0.06163335513613654,673,The only side effects that lab tests have shown is an increase in the growth of nose hair.
2979,3630,0,3,24,27,1.1111111111111112,0.06163335513613654,673,I’m not taking them. You’re the experimental animal!
3463,3630,0,3,24,27,1.1111111111111112,0.06163335513613654,673,This should temper the hallucinations.
3737,3630,0,3,24,27,1.1111111111111112,0.06163335513613654,673,"Sir, life on the subways just isn’t healthy anymore."
2788,3630,0,3,24,27,1.1111111111111112,0.06163335513613654,673,This new clinical study will require you to solve a maze.
4011,3630,0,3,24,27,1.1111111111111112,0.06163335513613654,673,This prescription has been tested on subjects in my species.
3963,3630,0,3,24,27,1.1111111111111112,0.06163335513613654,673,"Don't worry, it was tested on people."
3995,3630,1,1,25,27,1.1111111111111112,0.0815332650783714,673,In my experience you take it three times a day for two years and then we will decide if it works or if it will kill you.
4050,3630,0,3,24,27,1.1111111111111112,0.06163335513613654,673,"I’d prescribe the generic, but I’ve found the side effects make you iratsible."
4117,3630,0,3,24,27,1.1111111111111112,0.06163335513613654,673,I'm not a quack. I'm a squeak.
4310,3630,0,3,24,27,1.1111111111111112,0.06163335513613654,673,Take these for the hallucinations and then call us if you’re still dilated.
4376,3630,0,3,24,27,1.1111111111111112,0.06163335513613654,673,I won the rat race.
3838,3630,1,1,25,27,1.1111111111111112,0.0815332650783714,673,Put the prescription pad back before I bring out the broom
2748,3630,1,1,25,27,1.1111111111111112,0.0815332650783714,673,..don't mean to cry wolf but you really need to take these...
1235,3630,0,3,24,27,1.1111111111111112,0.06163335513613654,673,Here's a prescription for something I always take.
2450,3630,0,3,24,27,1.1111111111111112,0.06163335513613654,673,"Tust me. It's Baltimore, we're everywhere."
55,3630,0,3,24,27,1.1111111111111112,0.06163335513613654,673,Think about it.Intra-species transplantation makes logical sense.
90,3630,0,3,24,27,1.1111111111111112,0.06163335513613654,673,"Trust me, it works in humans also"
295,3630,1,1,25,27,1.1111111111111112,0.0815332650783714,673,"Wolf down 10 of these every evening with raw caribou meat, and call me in a month."
370,3630,0,3,24,27,1.1111111111111112,0.06163335513613654,673,Relax- take it. Just don’t tell anyone you got it from me!
510,3630,1,1,25,27,1.1111111111111112,0.0815332650783714,673,"Write your answer to this question ... *Which is better ... to be infested by rats, or to be one?*  """
733,3630,1,1,25,27,1.1111111111111112,0.0815332650783714,673,"I know this isn't Doctor Patient  appropriate, but I may have won the Asian Super lotto. Now to complete the dream I would like to marry you and recommend an opthamologist to work on that protruding eye."
2678,3630,1,1,25,27,1.1111111111111112,0.0815332650783714,673,"Sigh...one minute you’re teaching martial arts to mutant turtles, the next you’re proliferating the opioid crisis."
829,3630,1,1,25,27,1.1111111111111112,0.0815332650783714,673,You can pay the bill in cheese
1663,3630,1,1,25,27,1.1111111111111112,0.0815332650783714,673,It slides down easiest with some raw elk.
1674,3630,0,3,24,27,1.1111111111111112,0.06163335513613654,673,It's a new federal drug program...  I'm from Baltimore
1676,3630,1,1,25,27,1.1111111111111112,0.0815332650783714,673,"Take one after breakfast, one after your late-night dumpster dive."
1802,3630,0,3,24,27,1.1111111111111112,0.06163335513613654,673,We’ll have no trouble with PETA in getting you enrolled in our study.
2306,3630,0,3,24,27,1.1111111111111112,0.06163335513613654,673,The opioids should suppress your plague symptoms.
2353,3630,1,1,25,27,1.1111111111111112,0.0815332650783714,673,Just take two and kill me in the morning.
2425,3630,0,3,24,27,1.1111111111111112,0.06163335513613654,673,No!  The list of side effects does not include hallucinations.
910,3630,0,3,24,27,1.1111111111111112,0.06163335513613654,673,"...University of Baltimore Medical School, Why?"
944,3664,0,4,33,37,1.1081081081081081,0.05175281663547772,673,Could you run to the deli on the corner and grab me a La Croix? The cat there doesn't like me.
1054,3664,1,2,34,37,1.1081081081081081,0.06465180222706,673,Why did you sell the prescription refill that I gave to you!?
1915,3666,0,3,25,28,1.1071428571428572,0.05952380952380955,673,"You have been exposed to a rodent poison, here's your prescription."
143,3666,0,3,25,28,1.1071428571428572,0.05952380952380955,673,A grandmother a day will keep the doctor away!
1585,3666,1,1,26,28,1.1071428571428572,0.07866756984761514,673,"This is guaranteed to cure your pop-eyes,  but remember the side effect is it gives you nose hairs."
2205,3669,0,2,17,19,1.105263157894737,0.07233518641434494,673,Take these and you never have to worry about bubonic plague.
2341,3669,0,2,17,19,1.105263157894737,0.07233518641434494,673,You will find us everywhere in Baltimore.
2394,3669,0,2,17,19,1.105263157894737,0.07233518641434494,673,It's often said we have paw handwriting.
2462,3669,0,2,17,19,1.105263157894737,0.07233518641434494,673,Cut back on the cheese and send it to me.
2162,3669,0,2,17,19,1.105263157894737,0.07233518641434494,673,"Was this prescription written by a 9-foot, four-fingered rodent!?"
2935,3669,0,2,17,19,1.105263157894737,0.07233518641434494,673,Here's where I got my mask.
2490,3669,0,2,17,19,1.105263157894737,0.07233518641434494,673,"Sorry I couldn't diagnose your shortness of breath, but here's a card for my brother's place that serves that yummy ratatouille I was raving about."
2522,3669,0,2,17,19,1.105263157894737,0.07233518641434494,673,Here's a prescription for a new drug that some say does wonders.
2555,3669,0,2,17,19,1.105263157894737,0.07233518641434494,673,You'll need this if you don't want the plague.
2585,3669,0,2,17,19,1.105263157894737,0.07233518641434494,673,"I know getting a diagnosis can feel like going through an endless maze at times, but if we keep working at it, I'm sure we'll find the cheese."
2667,3669,0,2,17,19,1.105263157894737,0.07233518641434494,673,I wouldn't give you anything I hadn't tried out myself.
2707,3669,0,2,17,19,1.105263157894737,0.07233518641434494,673,Take two and trap me in the morning.
2897,3669,0,2,17,19,1.105263157894737,0.07233518641434494,673,It’s your ticket to become a masked crusader too!
2914,3669,0,2,17,19,1.105263157894737,0.07233518641434494,673,"Your life is in tatters, try gnawing through some of these."
2957,3669,0,2,17,19,1.105263157894737,0.07233518641434494,673,Tell your friends about our free lab tests.
4205,3669,0,2,17,19,1.105263157894737,0.07233518641434494,673,take my card anyway for when you’re nearing death and remember rats have the best survival rates of any mammal
3140,3669,0,2,17,19,1.105263157894737,0.07233518641434494,673,Here’s where to send the cheese if you want the test results
3162,3669,0,2,17,19,1.105263157894737,0.07233518641434494,673,It’s only poisonous to Rats
3177,3669,0,2,17,19,1.105263157894737,0.07233518641434494,673,"Your eyes son't deceive you. I did graduate from John's Hopkins, Baltimore's finest!"
3226,3669,0,2,17,19,1.105263157894737,0.07233518641434494,673,Relax. Just follow the script.
3471,3669,0,2,17,19,1.105263157894737,0.07233518641434494,673,Be sure to floss after gnawing.
3481,3669,0,2,17,19,1.105263157894737,0.07233518641434494,673,"It's quite confrontational, but it might just do the trick with this fear of dogs of yours."
3577,3669,0,2,17,19,1.105263157894737,0.07233518641434494,673,I'm returning your stones...maybe you can have a bracelet made for  your wife!
3675,3669,0,2,17,19,1.105263157894737,0.07233518641434494,673,"Trust me, take this instead, your last doctor was a weasel."
3682,3669,0,2,17,19,1.105263157894737,0.07233518641434494,673,"I’m prescribing you my family’s chosen antidepressant. It’s just eating literal garbage, but it somehow has less side effects than the pills we offer."
4327,3669,0,2,17,19,1.105263157894737,0.07233518641434494,673,They are waiting for you in the lab.
4343,3669,0,2,17,19,1.105263157894737,0.07233518641434494,673,You'll be amazed at what this can do for you!
4407,3669,0,2,17,19,1.105263157894737,0.07233518641434494,673,Trust me.  I work in a lab.
4420,3669,0,2,17,19,1.105263157894737,0.07233518641434494,673,"Trust me, I tested this myself, I'm sure it's ready for human trials"
4479,3669,0,2,17,19,1.105263157894737,0.07233518641434494,673,Take 2 a day until I blow your house down.
3124,3669,0,2,17,19,1.105263157894737,0.07233518641434494,673,It'll put fur on your chest.
2130,3669,0,2,17,19,1.105263157894737,0.07233518641434494,673,This is a prescription for real cheese- better than that over-the-counter stuff.
3499,3669,0,2,17,19,1.105263157894737,0.07233518641434494,673,The only side effects they found in clinical trials was gigantism and an acute ability to feign intelligence.
2116,3669,0,2,17,19,1.105263157894737,0.07233518641434494,673,What does bad handwriting say about you?
23,3669,0,2,17,19,1.105263157894737,0.07233518641434494,673,Not too many side effects if I recall correctly from my test days.
47,3669,0,2,17,19,1.105263157894737,0.07233518641434494,673,"James Cagney pins his famous quote,”You Dirty Rat”."
171,3669,0,2,17,19,1.105263157894737,0.07233518641434494,673,Here's the key card to your cage ...uh...cubicle.
190,3669,0,2,17,19,1.105263157894737,0.07233518641434494,673,"It's poison only to me; to you, it's blood thinner."
294,3669,0,2,17,19,1.105263157894737,0.07233518641434494,673,"To control the infestation, put two of these by each bunk bed
and wash your hands afterward."
380,3669,0,2,17,19,1.105263157894737,0.07233518641434494,673,"Well, after they removed everything that made us sick from the market, what did you expect?"
465,3669,0,2,17,19,1.105263157894737,0.07233518641434494,673,"Really it's the best prescription, I used to work in a lab."
479,3669,0,2,17,19,1.105263157894737,0.07233518641434494,673,"Take two mice a day, and call me if  you start running around in circles"
2120,3669,0,2,17,19,1.105263157894737,0.07233518641434494,673,"Okay,  you try it!"
564,3669,0,2,17,19,1.105263157894737,0.07233518641434494,673,"I know I'm an animal doctor, but the pharmacy will fill this prescription."
626,3669,0,2,17,19,1.105263157894737,0.07233518641434494,673,I'm glad the hallucinations stopped...
637,3669,0,2,17,19,1.105263157894737,0.07233518641434494,673,"Side effects include impaired eyesight, and paranoia"
653,3669,0,2,17,19,1.105263157894737,0.07233518641434494,673,"Yeah, pretty good. Yourself?"
671,3669,0,2,17,19,1.105263157894737,0.07233518641434494,673,Take these. Your face should clear up within the week.
710,3669,0,2,17,19,1.105263157894737,0.07233518641434494,673,Call my cousin he dean. He's turned mice into rats before.
281,3669,0,2,17,19,1.105263157894737,0.07233518641434494,673,Trust me: It's been tested.
1103,3669,0,2,17,19,1.105263157894737,0.07233518641434494,673,It’s the most amazing cure.
1075,3669,0,2,17,19,1.105263157894737,0.07233518641434494,673,"HIPPA laws forbid me from telling anyone anything, Kevin."
2101,3669,0,2,17,19,1.105263157894737,0.07233518641434494,673,Of course you can trust it!  I tested it myself!
2004,3669,0,2,17,19,1.105263157894737,0.07233518641434494,673,"Take two a day to relax.  Trust me, rapid reproduction trumps regulation every time."
1864,3669,0,2,17,19,1.105263157894737,0.07233518641434494,673,"I’m due at the Gong Show ‘19 casting call in 15. See Phil at CVS. Call your girlfriend, take two and the affect on your corpora cavernosa will relieve the optic explosions."
1793,3669,0,2,17,19,1.105263157894737,0.07233518641434494,673,"You have hypertension, here is a prescription for warfarin."
1693,3669,0,2,17,19,1.105263157894737,0.07233518641434494,673,Of course it's safe.  I take it myself.
1874,3669,0,2,17,19,1.105263157894737,0.07233518641434494,673,I've tested this one myself.
1383,3669,0,2,17,19,1.105263157894737,0.07233518641434494,673,"Oh, so now you claim you don't like cheese?"
1379,3669,0,2,17,19,1.105263157894737,0.07233518641434494,673,Remember: What doesn't kill you makes you strong.
1338,3669,0,2,17,19,1.105263157894737,0.07233518641434494,673,Trust me. I was a Rhodents Scholar.
1316,3669,0,2,17,19,1.105263157894737,0.07233518641434494,673,This will eliminate your rodent phobia.
1302,3669,0,2,17,19,1.105263157894737,0.07233518641434494,673,Here you go now Wheres my cheese
1465,3669,0,2,17,19,1.105263157894737,0.07233518641434494,673,Take this until I stop looking like a rat
1184,3669,0,2,17,19,1.105263157894737,0.07233518641434494,673,You need to get rid of your bias.
2498,3734,1,1,27,29,1.103448275862069,0.0759962986233572,673,"In 1965 we were against Medicare, would you believe."
3067,3735,0,2,18,20,1.1,0.06882472016116854,673,I'm prescribing any food you can find anywhere anytime.
3130,3735,0,2,18,20,1.1,0.06882472016116854,673,You’ll need an antidote for that rat poison you’ve been using
3176,3735,0,2,18,20,1.1,0.06882472016116854,673,"It's a remote control  to lock that door. Selma, hold all my calls."
3380,3735,0,2,18,20,1.1,0.06882472016116854,673,"Truth no longer holds water. Like politics, law, religion,

medicine , too, is a matter of where you fall on the
insurance wheel. Here's your diagnosis."
3459,3735,0,2,18,20,1.1,0.06882472016116854,673,This will calm your nerves. It's not unusual to see rats in New York.
3428,3735,0,2,18,20,1.1,0.06882472016116854,673,What? You have a problem with me being a rodent?  I'll let you know that I scurried my way to the top of my medical school class!
2905,3735,0,2,18,20,1.1,0.06882472016116854,673,This medication should help relive your hallucinations that you are living in a world controlled by animals
3503,3735,0,2,18,20,1.1,0.06882472016116854,673,This should stop the huffing and puffing.
3404,3735,0,2,18,20,1.1,0.06882472016116854,673,"No, Splinter's my first cousin. Although, Leonardo did work reception for a summer."
2872,3735,0,2,18,20,1.1,0.06882472016116854,673,Take it. It's ratified.
2726,3735,0,2,18,20,1.1,0.06882472016116854,673,"You shouldn't do this, I won't give you what you want."
2799,3735,0,2,18,20,1.1,0.06882472016116854,673,This formulation should have fewer side effects.
2767,3735,0,2,18,20,1.1,0.06882472016116854,673,This is the best antidote; they even used it during the plague!
2766,3735,0,2,18,20,1.1,0.06882472016116854,673,... And which physician referred you to the Baltimore Neurosurgical Center?
2739,3735,0,2,18,20,1.1,0.06882472016116854,673,All that nonsense about opioids was just fake news
2738,3735,0,2,18,20,1.1,0.06882472016116854,673,Cat phobias are very real. Try this.
2728,3735,0,2,18,20,1.1,0.06882472016116854,673,"Tell me, Frank, do you think I'm a dirty rat?"
2567,3735,0,2,18,20,1.1,0.06882472016116854,673,Take this prescription to the nearest Canadian pharmacy unless you want to sell your house.
2349,3735,0,2,18,20,1.1,0.06882472016116854,673,"This isn't an actual prescription, just some made up words I wrote down to make you feel better about yourself."
2316,3735,0,2,18,20,1.1,0.06882472016116854,673,This is a prescription for snacks. I recommend garbage.
3508,3735,0,2,18,20,1.1,0.06882472016116854,673,Here's a little meds combo I call 'Reincarnation Roulette'.
2850,3735,0,2,18,20,1.1,0.06882472016116854,673,"Sorry, all human specialists are out of network. Here is a referral to a great veterinary neurologist."
3548,3735,0,2,18,20,1.1,0.06882472016116854,673,"It's nothing to be ashamed of, John. Take this, and you’ll be breeding like me in no time."
4191,3735,0,2,18,20,1.1,0.06882472016116854,673,"It's the ace of cheese, right?"
3726,3735,0,2,18,20,1.1,0.06882472016116854,673,"This prescription isn't covered, so just take one pill when your are about to die."
4561,3735,0,2,18,20,1.1,0.06882472016116854,673,I spend a lot of time at the gym.
4532,3735,0,2,18,20,1.1,0.06882472016116854,673,"That was the lab, you're my third patient this month who's contracted the plague."
4520,3735,0,2,18,20,1.1,0.06882472016116854,673,"Look Mortimer, all us rats get something, nothing to be ashamed of, this will help... just take 18 a day, you’ll be fine."
4415,3735,0,2,18,20,1.1,0.06882472016116854,673,This drug will help you cope with the maze.
4319,3735,0,2,18,20,1.1,0.06882472016116854,673,Have some brie and stay out of sewers.
4285,3735,0,2,18,20,1.1,0.06882472016116854,673,I’m prescribing a placebo because you have  cried  wolf once too often
4194,3735,0,2,18,20,1.1,0.06882472016116854,673,"Given the particular itch you've described, I recommend you call my colleague, Dr. Gerbil."
2260,3735,0,2,18,20,1.1,0.06882472016116854,673,"Do not try to get the store brand cheese, it’s just not the same."
4184,3735,0,2,18,20,1.1,0.06882472016116854,673,You need to take this with food...the apartment building next door puts their trash on the curb around 9:30.
4142,3735,0,2,18,20,1.1,0.06882472016116854,673,"Look - crack is no longer wack. Plus, I'm a doctor."
4129,3735,0,2,18,20,1.1,0.06882472016116854,673,Let's get you back in tonight about dinner time!
4123,3735,0,2,18,20,1.1,0.06882472016116854,673,"Yes, I'm your worst nightmare -- a wolf in doctor's clothing..."
4057,3735,0,2,18,20,1.1,0.06882472016116854,673,"Trust me, with enough doses of cheese, you'll feel much better."
3903,3735,0,2,18,20,1.1,0.06882472016116854,673,Here’s your prescription to beat the rat race
3893,3735,0,2,18,20,1.1,0.06882472016116854,673,Now you give me the card for the nest you forage for.
3884,3735,0,2,18,20,1.1,0.06882472016116854,673,Trust me! These pills won't hurt you. I've been taking them for years.
3878,3735,1,0,19,20,1.1,0.1,673,I highly recommend this medication - I take it myself
3857,3735,0,2,18,20,1.1,0.06882472016116854,673,"Here's your script for black plague.  The jet fuel to get a decent price for these meds will melt a few glaciers on the way, but it's totally affordable in Mexico."
3850,3735,0,2,18,20,1.1,0.06882472016116854,673,"Here is a card for an Ear, Nose and Throat Doctor. He should be able to help smell a rat."
3798,3735,0,2,18,20,1.1,0.06882472016116854,673,This prescription is only sold through a cubbyhole in the baseboard at Ducky's Tavern.
3729,3735,0,2,18,20,1.1,0.06882472016116854,673,"I think these will help you.  While in medical school, I helped test them."
3715,3735,0,2,18,20,1.1,0.06882472016116854,673,"Well yes, you might start craving field mice taking this...why do you ask?..."
2114,3735,0,2,18,20,1.1,0.06882472016116854,673,"No, it's not poison. Would you give me something with poison in it?"
2691,3735,0,2,18,20,1.1,0.06882472016116854,673,Take them an hour before gnawing.
2000,3735,0,2,18,20,1.1,0.06882472016116854,673,"I'm not comfortable with the term ""lab rat."" Let's call you the guinea pig instead, shall we?"
853,3735,0,2,18,20,1.1,0.06882472016116854,673,Remember to take it under a full moon.
816,3735,0,2,18,20,1.1,0.06882472016116854,673,"Try this CBD.  No, not Central Business District!"
806,3735,0,3,27,30,1.1,0.05570860145311559,673,Take this as needed whenever you're tempted to place your head in a trap.
756,3735,0,2,18,20,1.1,0.06882472016116854,673,It's proven to work on laboratory rats.
734,3735,0,2,18,20,1.1,0.06882472016116854,673,"Here's your prescription, now take me for a walk."
732,3735,0,2,18,20,1.1,0.06882472016116854,673,...Why yes! - As you can see I am a Fox University's graduate
652,3735,0,2,18,20,1.1,0.06882472016116854,673,"Take one of these at bedtime.  Not a long term solution, but will help you sleep until the indictments come."
509,3735,0,2,18,20,1.1,0.06882472016116854,673,Call this number and ask for Michelangelo.
442,3735,0,2,18,20,1.1,0.06882472016116854,673,Why do you keep asking about side effects?
421,3735,0,2,18,20,1.1,0.06882472016116854,673,I'm the new image repair hire for Baltimore.
375,3735,0,2,18,20,1.1,0.06882472016116854,673,"Since you broke out of your cage, this slip instructs our researchers to put you in a stronger cage and start over."
368,3735,0,2,18,20,1.1,0.06882472016116854,673,"I can't help your appearance, but this foxycodone will make you think you look good."
336,3735,0,2,18,20,1.1,0.06882472016116854,673,Take this with cheese and let me know if the side-effects get worse?
273,3735,0,2,18,20,1.1,0.06882472016116854,673,It's okay. I prescribe it for myself.
269,3735,0,2,18,20,1.1,0.06882472016116854,673,"I don't know who you are or WHAT you are, but your hired!"
196,3735,0,2,18,20,1.1,0.06882472016116854,673,I'm quack doctors' biggest competitor
192,3735,0,2,18,20,1.1,0.06882472016116854,673,"Mr. Sackler,  Are You Questioning My Authority ?"
183,3735,0,2,18,20,1.1,0.06882472016116854,673,"Yes, President Trump literally meant rodents."
2061,3735,0,2,18,20,1.1,0.06882472016116854,673,Maybe you have been sowing too many wild oats.
145,3735,0,2,18,20,1.1,0.06882472016116854,673,"This is a list of items I don't want in the office. 
Number 1 - Big CATS"
140,3735,0,2,18,20,1.1,0.06882472016116854,673,It's not a mole sir
895,3735,0,2,18,20,1.1,0.06882472016116854,673,Either I've over-dilated your pupils or it must be a full moon.
914,3735,0,2,18,20,1.1,0.06882472016116854,673,It’s not easy cutting the cheese. Here’s a lactose intolerance specialist I recommend.
152,3735,0,2,18,20,1.1,0.06882472016116854,673,This should clear up the excessive nasal hair.
960,3735,0,2,18,20,1.1,0.06882472016116854,673,I didn’t spend all that time in mazes just to be a blue collar worker.
953,3735,0,2,18,20,1.1,0.06882472016116854,673,You can get this prescription filled at any Cheesecake Factory.
1932,3735,0,2,18,20,1.1,0.06882472016116854,673,you need to bring  your medical records if you want me to ok you for Medical Marijuana just cash will not do the trick
1882,3735,0,2,18,20,1.1,0.06882472016116854,673,Take 2 D-Con pellets and call me in the morning.
1755,3735,0,2,18,20,1.1,0.06882472016116854,673,Imagine how I feel at the veterinarian.
1749,3735,0,2,18,20,1.1,0.06882472016116854,673,I may be a rat doctor but at least I can get it up.
1688,3735,0,2,18,20,1.1,0.06882472016116854,673,"You asked for a new look. So, here’s your prescription for how to shine a turd ."
1669,3735,0,2,18,20,1.1,0.06882472016116854,673,I’m prescribing a dose of warfarin to be taken twice a day and to see how you like it!
1665,3735,0,2,18,20,1.1,0.06882472016116854,673,You have nothing to worry about. I was not only top of my medical class
1580,3735,0,2,18,20,1.1,0.06882472016116854,673,"If you keep coming to me this often, no one will believe that you're sick."
1547,3735,0,2,18,20,1.1,0.06882472016116854,673,"Ok, this'd just cost you a roll of cheese."
1884,3735,0,2,18,20,1.1,0.06882472016116854,673,And don't even try to weasel out of taking these.
1487,3735,0,2,18,20,1.1,0.06882472016116854,673,What's your problem?  I've tested it myself.
1511,3735,0,2,18,20,1.1,0.06882472016116854,673,I know you'll keep an eye out for any adverse reactions.
1035,3735,0,2,18,20,1.1,0.06882472016116854,673,"Trust me, dude; you can't lose with the stuff I use!"
1085,3735,0,2,18,20,1.1,0.06882472016116854,673,"not a prescription per se, but I urge you to eat more Cheez-Its"""
1139,3735,0,2,18,20,1.1,0.06882472016116854,673,Are you prone to hallucinations?
1025,3735,0,2,18,20,1.1,0.06882472016116854,673,"When you get to the lab, ask for “Algernon”."
1347,3735,0,2,18,20,1.1,0.06882472016116854,673,"Please, Mr. Flanagan, just trust me and take these antipsychotics."
1352,3735,0,2,18,20,1.1,0.06882472016116854,673,Call me when you are ready to transition into the rat race.
1411,3735,0,2,18,20,1.1,0.06882472016116854,673,No more than two nibbles every four hours.
1426,3735,0,2,18,20,1.1,0.06882472016116854,673,The first thing to do is kill all the cats.
1177,3735,1,0,19,20,1.1,0.1,673,The nausea should go away if  you eat some trash before bedtime and chase it down with water.
3453,3832,0,2,19,21,1.0952380952380953,0.06563832739090583,673,This will help you in the manner in which you look at me and others
3251,3832,0,2,19,21,1.0952380952380953,0.06563832739090583,673,"I am telling you, I used to be just like you. What does the card say?"
3365,3832,0,2,19,21,1.0952380952380953,0.06563832739090583,673,"Yes, I'm a real doctor; those are my sheepskins on the wall."
3363,3832,0,2,19,21,1.0952380952380953,0.06563832739090583,673,"Don't worry, I've never prescribed anything I haven't tested on myself."
3324,3832,0,2,19,21,1.0952380952380953,0.06563832739090583,673,Make yourself comfortable in a nice corner.  Take as directed and in a few minutes your pain will be over.
3304,3832,0,2,19,21,1.0952380952380953,0.06563832739090583,673,"""Take 1 kilogram of Roquefort before bed and I'll see you next month"""
3284,3832,0,2,19,21,1.0952380952380953,0.06563832739090583,673,A rat poison Warfarin?  Yes.  Humans call it Coumadin.
3368,3832,0,2,19,21,1.0952380952380953,0.06563832739090583,673,Here's a prescription for some anti-hallucinogens.
2964,3832,0,2,19,21,1.0952380952380953,0.06563832739090583,673,This medication has no side effects.  Trust me I’m a doctor.
3115,3832,1,0,20,21,1.0952380952380953,0.09523809523809525,673,"Rodentine DC is guaranteed free of annoying side effects.  I'm on a mild dose for nasal congestion, myself."
3054,3832,0,2,19,21,1.0952380952380953,0.06563832739090583,673,"You're so terrified of your grandmother whenever you come to see me, so here's a referral for a psych eval by the Grimm Brothers."
2983,3832,0,2,19,21,1.0952380952380953,0.06563832739090583,673,"At least it's not the plague, but take this and the symptoms should clear out in a few days."
2956,3832,0,2,19,21,1.0952380952380953,0.06563832739090583,673,"Sure, I get teased about it. But I monetized it, and that video of me dragging a slice of pizza through the subway paid for my medical school."
2875,3832,0,2,19,21,1.0952380952380953,0.06563832739090583,673,No refills for you.
2812,3832,0,2,19,21,1.0952380952380953,0.06563832739090583,673,This is guaranteed to cure hallucinations.
2743,3832,0,2,19,21,1.0952380952380953,0.06563832739090583,673,"As a lab rat, I know side effects may include anthropomorphizing your drug dealer."
3457,3832,1,0,20,21,1.0952380952380953,0.09523809523809525,673,I need your health insurance card...not your social security card!
2741,3832,0,2,19,21,1.0952380952380953,0.06563832739090583,673,Don't worry.  It's safe.  It's already been tested on me.
3188,3832,1,0,20,21,1.0952380952380953,0.09523809523809525,673,"Here's my card. And yes, I know what the president said, but really I'm the only one of my species in Baltimore with a medical degree."
3458,3832,0,2,19,21,1.0952380952380953,0.06563832739090583,673,"This card gives you access to the employee lounge, but not the Executive Lair."
4008,3832,0,2,19,21,1.0952380952380953,0.06563832739090583,673,"Of course,you will get the corner office."
3512,3832,0,2,19,21,1.0952380952380953,0.06563832739090583,673,"Sir, this is your prescription for bulging eyes."
2733,3832,0,2,19,21,1.0952380952380953,0.06563832739090583,673,Are you sure you want to partake in this drug trial? It's only been tested on humans in the lab.
4481,3832,0,2,19,21,1.0952380952380953,0.06563832739090583,673,"It’s only a clinical trial, but it’s been shown to improve outcomes in rats."
4373,3832,0,2,19,21,1.0952380952380953,0.06563832739090583,673,This is a prescription for musophobia.
4358,3832,0,2,19,21,1.0952380952380953,0.06563832739090583,673,I’m referring you to an ophthalmologist
4346,3832,0,2,19,21,1.0952380952380953,0.06563832739090583,673,"Damn it, I said non-stick."
4326,3832,0,2,19,21,1.0952380952380953,0.06563832739090583,673,Trust me- call  me when you feel trapped !
4263,3832,0,2,19,21,1.0952380952380953,0.06563832739090583,673,Take 5 and call me in the mourning
4231,3832,0,2,19,21,1.0952380952380953,0.06563832739090583,673,"Look, I hardly make anything from the drug company for prescribing these."
4171,3832,0,2,19,21,1.0952380952380953,0.06563832739090583,673,And take these to calm your epiphanies.
4028,3832,0,2,19,21,1.0952380952380953,0.06563832739090583,673,The eyes have it
3914,3832,0,2,19,21,1.0952380952380953,0.06563832739090583,673,Take this to the second dumpster on the right. They can fill it right away.
3909,3832,1,0,20,21,1.0952380952380953,0.09523809523809525,673,"Just follow these rules, it’s how it got done in Baltimore"
4544,3832,0,2,19,21,1.0952380952380953,0.06563832739090583,673,"Trust me, this prescription is not rat poison."
3902,3832,0,2,19,21,1.0952380952380953,0.06563832739090583,673,You should really consider seeing a real doctor.
3818,3832,0,2,19,21,1.0952380952380953,0.06563832739090583,673,this should take care of that reward pathway...
3691,3832,0,2,19,21,1.0952380952380953,0.06563832739090583,673,"And while you're there, can you pick me up a bison?"
3619,3832,0,2,19,21,1.0952380952380953,0.06563832739090583,673,This would have saved my dad. Too bad he was in the control group.
3576,3832,0,2,19,21,1.0952380952380953,0.06563832739090583,673,"Trust me, I invented this in my own lab"
3553,3832,0,2,19,21,1.0952380952380953,0.06563832739090583,673,I am gay.
3473,3832,0,2,19,21,1.0952380952380953,0.06563832739090583,673,"(All this says is ""cheese"")"
2635,3832,0,2,19,21,1.0952380952380953,0.06563832739090583,673,This prescription will prove to your bank manager you need a loan.
646,3832,0,2,19,21,1.0952380952380953,0.06563832739090583,673,"This is for the mammoths.

Gee, and I thought it was just eczema."
2561,3832,0,2,19,21,1.0952380952380953,0.06563832739090583,673,"Not the 23rd. There's a full moon that night, and I have to rest up for it."
983,3832,0,2,19,21,1.0952380952380953,0.06563832739090583,673,Thank you for your participation. We're always looking for good lab humans.
961,3832,0,2,19,21,1.0952380952380953,0.06563832739090583,673,"I'm what you get with Medicare for All, Bernie."
916,3832,0,2,19,21,1.0952380952380953,0.06563832739090583,673,"Here, it’s the latest “Old Town Road” remix."
892,3832,0,2,19,21,1.0952380952380953,0.06563832739090583,673,"I've personally tested 1000x the usual dose, with no side effects yet."
837,3832,0,2,19,21,1.0952380952380953,0.06563832739090583,673,There's nothing wrong with you that a little rat poison won't cure.
777,3832,0,2,19,21,1.0952380952380953,0.06563832739090583,673,"If you need me over the weekend, I’ll be at this address in Baltimore."
507,3832,0,2,19,21,1.0952380952380953,0.06563832739090583,673,I'm sorry you did not read the low option carefully.
498,3832,0,2,19,21,1.0952380952380953,0.06563832739090583,673,"Here's the card of my contemporary in Baltimore."""
1100,3832,0,2,19,21,1.0952380952380953,0.06563832739090583,673,"It works really well. I took it myself. There are a view side effects, though, I should warn you."
494,3832,0,2,19,21,1.0952380952380953,0.06563832739090583,673,The taste is ok but it smells funny.
346,3832,0,2,19,21,1.0952380952380953,0.06563832739090583,673,"No, I experiment on you!"
220,3832,0,2,19,21,1.0952380952380953,0.06563832739090583,673,"The rat race is not good for you health. Believe me, I know."
199,3832,0,2,19,21,1.0952380952380953,0.06563832739090583,673,Take two fleas and call me in the morning.
198,3832,0,2,19,21,1.0952380952380953,0.06563832739090583,673,"I advise inserting capsules in a piece of cheese. The more aromatic, the better."
147,3832,0,2,19,21,1.0952380952380953,0.06563832739090583,673,First task is to prove that you can read my writing.
75,3832,0,2,19,21,1.0952380952380953,0.06563832739090583,673,Take two of these and howl at me in the morning.
42,3832,0,2,19,21,1.0952380952380953,0.06563832739090583,673,„This will make You see white mice instead.“
2587,3832,0,2,19,21,1.0952380952380953,0.06563832739090583,673,"Hey, it's 10% off for no sheep's clothing."
357,3832,0,2,19,21,1.0952380952380953,0.06563832739090583,673,"Be forewarned, the cheese question portion of the job interview is tougher than the maze you scampered through effortlessly."
1320,3832,0,2,19,21,1.0952380952380953,0.06563832739090583,673,"I know you've been taking this for fifty years, but trust me.  I'm your Doctor.  It works."
358,3832,0,2,19,21,1.0952380952380953,0.06563832739090583,673,You'd better go to see an eye doctor.
1541,3832,0,2,19,21,1.0952380952380953,0.06563832739090583,673,I assure you I am a board certified plastic surgeon.
1339,3832,1,0,20,21,1.0952380952380953,0.09523809523809525,673,I worked my up from being a lab rat in Baltimore
2413,3832,0,2,19,21,1.0952380952380953,0.06563832739090583,673,Side effects include seeing colors. Don't let that freak you out.
2411,3832,0,2,19,21,1.0952380952380953,0.06563832739090583,673,Now go slaughter those cute little mousies.
2404,3832,0,2,19,21,1.0952380952380953,0.06563832739090583,673,It works in mice...
2343,3832,0,2,19,21,1.0952380952380953,0.06563832739090583,673,You're in MY lab now Doc.  How does it feel to be the subject for a change?
2253,3832,0,2,19,21,1.0952380952380953,0.06563832739090583,673,"Hey, Bud. Wanna see surgical picture?"
2213,3832,0,2,19,21,1.0952380952380953,0.06563832739090583,673,Doesn't look like rat fever to me.
2118,3832,0,2,19,21,1.0952380952380953,0.06563832739090583,673,"Take my card. It’s a rat race, and I can help you win."
2048,3832,0,2,19,21,1.0952380952380953,0.06563832739090583,673,Here. You can get this filled next time you're in Baltimore.
2332,3832,0,2,19,21,1.0952380952380953,0.06563832739090583,673,"I personally guarantee from personal experience, that this stuff will work."
2526,3832,0,2,19,21,1.0952380952380953,0.06563832739090583,673,"Shave my what?  I'd never tell you that, mustache."
1982,3832,0,2,19,21,1.0952380952380953,0.06563832739090583,673,Tell them Dr. Rizzo sent you.
1873,3832,0,2,19,21,1.0952380952380953,0.06563832739090583,673,I have yet to receive your RSVP to my gay rat wedding.
1852,3832,0,2,19,21,1.0952380952380953,0.06563832739090583,673,"These will take care of the real problem, plus they smell and taste just like peanut butter!"
1624,3832,0,2,19,21,1.0952380952380953,0.06563832739090583,673,"You have to be very careful. These pills have severe side effects. They can make you feel very good, but don’t, take more than prescribed. 
Trust me. I know."
1763,3832,0,2,19,21,1.0952380952380953,0.06563832739090583,673,This is Baltimore and I understand your need for anxiety medications.
1725,3832,0,2,19,21,1.0952380952380953,0.06563832739090583,673,"The medicine works, but nose hair is a regrettable side effect."
1662,3832,0,2,19,21,1.0952380952380953,0.06563832739090583,673,I have personally tested it.
1632,3832,0,2,19,21,1.0952380952380953,0.06563832739090583,673,These are truly amazing. Look what they did for me.
2002,3832,0,2,19,21,1.0952380952380953,0.06563832739090583,673,"No sir,a Cheese-of-the-Month membership will not be accepted in lieu of payment fo services!"
1485,3919,0,3,29,32,1.09375,0.052351460373382196,673,This will cure your nasty habit of saying “I’ll be RIGHT back!”
3546,3920,0,2,20,22,1.0909090909090908,0.06273323266748672,673,Take two subway stairs pizza slices and call me in the morning.
3128,3920,0,2,20,22,1.0909090909090908,0.06273323266748672,673,My specialty is male pattern balding.
3157,3920,0,2,20,22,1.0909090909090908,0.06273323266748672,673,"Since I can't block politics out of your life. take 2 of these when politics comes a knockin'
.'."
3267,3920,0,2,20,22,1.0909090909090908,0.06273323266748672,673,"It worked on me, now let’s see if it works on you."
3295,3920,0,2,20,22,1.0909090909090908,0.06273323266748672,673,My brother was in the beta test.  This stuff works.
3305,3920,0,2,20,22,1.0909090909090908,0.06273323266748672,673,This Dr. shopping is getting out of control!
3429,3920,0,2,20,22,1.0909090909090908,0.06273323266748672,673,I hate to plague you with so many prescriptions
3436,3920,0,2,20,22,1.0909090909090908,0.06273323266748672,673,"Now would your old friend ,Dr.Mongoose, give you something bad for your tummy?"
3046,3920,0,2,20,22,1.0909090909090908,0.06273323266748672,673,"Don't try to weasel out of paying this bill, it didn't even work for my brother."
3004,3920,0,2,20,22,1.0909090909090908,0.06273323266748672,673,My uncle found this very effective in clinical trials.
361,3920,0,2,20,22,1.0909090909090908,0.06273323266748672,673,Trust me -- I’m listed first in the dictionary.”
3625,3920,0,2,20,22,1.0909090909090908,0.06273323266748672,673,Here’s your fentanyl scrip. Please pay me before you OD.
3684,3920,0,2,20,22,1.0909090909090908,0.06273323266748672,673,"Trust me, I'm an expert on diseases."
3777,3920,1,0,21,22,1.0909090909090908,0.0909090909090909,673,Side effects? You could become much bigger and more intelligent.
3898,3920,0,2,20,22,1.0909090909090908,0.06273323266748672,673,None of the other doctors could cure my lactose intolerance so I came to the expert.
4090,3920,0,2,20,22,1.0909090909090908,0.06273323266748672,673,"I send a message, not just advice !"
4279,3920,0,2,20,22,1.0909090909090908,0.06273323266748672,673,This was tested on me personally
4404,3920,0,2,20,22,1.0909090909090908,0.06273323266748672,673,"Trust me, it’s been tested on at least a few dozen of my siblings."
4503,3920,0,2,20,22,1.0909090909090908,0.06273323266748672,673,This worked on me.
4526,3920,0,2,20,22,1.0909090909090908,0.06273323266748672,673,Most of the others survived too
1150,3920,0,2,20,22,1.0909090909090908,0.06273323266748672,673,I can personally recommend this medication despite the side effects.....
2771,3920,0,2,20,22,1.0909090909090908,0.06273323266748672,673,Here try rat poison!   I know it works. That’s all you can ask for.
3588,3920,0,2,20,22,1.0909090909090908,0.06273323266748672,673,"It's the answer to Life, the Universe, and Everything."
2637,3920,0,2,20,22,1.0909090909090908,0.06273323266748672,673,"Side effects are rare, but they can include retroactive hallucinations."
1042,3920,0,2,20,22,1.0909090909090908,0.06273323266748672,673,Now who's the vector for disease?
2238,3920,0,2,20,22,1.0909090909090908,0.06273323266748672,673,The experiment was successful.
48,3920,0,2,20,22,1.0909090909090908,0.06273323266748672,673,"Those are wolf whiskers not nose hairs, and they make great shaving brushes."
371,3920,0,2,20,22,1.0909090909090908,0.06273323266748672,673,I'm trying to get rid of some neighborhood cats.
2252,3920,0,2,20,22,1.0909090909090908,0.06273323266748672,673,"If the drugs and alcohol don't kill ya, the medical bill will."""
550,3920,0,2,20,22,1.0909090909090908,0.06273323266748672,673,You act like you've never been to a doctor in Baltimore before.
561,3920,0,2,20,22,1.0909090909090908,0.06273323266748672,673,"Here’s your prescription for your condition, it should cure your “Baltimore fetish”."
632,3920,0,2,20,22,1.0909090909090908,0.06273323266748672,673,"Here, this prescription will take help care of those bites"
754,3920,0,2,20,22,1.0909090909090908,0.06273323266748672,673,"You can never be sure, but I'm going with musophobia for now, see you in 2 weeks and we'll start treatment. Plus, here you go - my secretary scored a bunch of coupons for a lovely cheddar special they're running at Trader Joe's."
772,3920,0,3,30,33,1.0909090909090908,0.05081972676135885,673,Here is your prescription. Your hatred of rats is destructive.
804,3920,0,2,20,22,1.0909090909090908,0.06273323266748672,673,The blood sample won't hurt a bit.
873,3920,0,2,20,22,1.0909090909090908,0.06273323266748672,673,Today your mind. Tomorrow the World!
975,3920,0,2,20,22,1.0909090909090908,0.06273323266748672,673,"My, what acute metabolic syndrome you have!"
522,3920,1,0,21,22,1.0909090909090908,0.0909090909090909,673,Take this exactly as directed or you may have hallucinations.
1072,3920,0,2,20,22,1.0909090909090908,0.06273323266748672,673,"Yes, just take two and bite a hose while dying painfully."
1135,3920,1,0,21,22,1.0909090909090908,0.0909090909090909,673,"I know I look intimidating, but underneath this facade, I'm rather sheepish."
1144,3920,0,2,20,22,1.0909090909090908,0.06273323266748672,673,"The name's Ratburn, Nigel Ratburn."
1167,3920,0,2,20,22,1.0909090909090908,0.06273323266748672,673,It's the least I can do for giving you the plague.
1692,3920,0,2,20,22,1.0909090909090908,0.06273323266748672,673,Take these three times a day with a glass of sewer water.
1954,3920,0,2,20,22,1.0909090909090908,0.06273323266748672,673,What do you mean you don’t trust me?
2046,3920,0,2,20,22,1.0909090909090908,0.06273323266748672,673,"...and don't worry, I've never divulged any info about my patients, even to the police."
2072,3920,1,0,21,22,1.0909090909090908,0.0909090909090909,673,"These drugs are completely underground, but I'd rather trust my network than the FDA."
2217,3920,0,2,20,22,1.0909090909090908,0.06273323266748672,673,I can assure you that a degree from Halfratman University is just as valid as any Ivy League school.
1065,3920,0,2,20,22,1.0909090909090908,0.06273323266748672,673,"Here's my card. Trust me, we do the best GMO research on the planet."
2231,3920,0,2,20,22,1.0909090909090908,0.06273323266748672,673,Trust me. This rabies prescription works.
2727,3969,0,3,31,34,1.088235294117647,0.04937482703908927,673,I can help with your identity crisis.
2664,3970,0,2,21,23,1.0869565217391304,0.060073850409370196,673,"Take one of these a day, but keep them away from your cat."
2634,3970,0,2,21,23,1.0869565217391304,0.060073850409370196,673,What a racist thing to say.
2989,3970,0,2,21,23,1.0869565217391304,0.060073850409370196,673,"I want you to cut my nose hairs,roll them in this prescription,smoke it,and you'll feel better right away."
2717,3970,0,2,21,23,1.0869565217391304,0.060073850409370196,673,There is no proof that the bubonic plague causes autism.
2846,3970,0,2,21,23,1.0869565217391304,0.060073850409370196,673,Drink 8 ounces of plain water at least half-hour before you ... ‘Howl at the Moon’.
4462,3970,0,2,21,23,1.0869565217391304,0.060073850409370196,673,"Here's my card - call when you think your're ready, and remember - recovery is only six weeks."
3265,3970,0,2,21,23,1.0869565217391304,0.060073850409370196,673,"If you don’t have insurance, I accept cheese."
4145,3970,0,2,21,23,1.0869565217391304,0.060073850409370196,673,Take two of these and run through a maze as quickly as you can.
3293,3970,0,2,21,23,1.0869565217391304,0.060073850409370196,673,"It is an antidote for human poison.  Do not look so disgusted, you used similar stuff on us for years."
3613,3970,0,2,21,23,1.0869565217391304,0.060073850409370196,673,"You know, I originally went to school to be a chef."
3734,3970,0,2,21,23,1.0869565217391304,0.060073850409370196,673,Chew two plastic bins and call me in the morning.
3736,3970,0,2,21,23,1.0869565217391304,0.060073850409370196,673,He's right you know. I tested it all night and 1+1 really is 2.
4186,3970,0,2,21,23,1.0869565217391304,0.060073850409370196,673,No strings attached
4217,3970,0,2,21,23,1.0869565217391304,0.060073850409370196,673,"It's only been tested on humans, but I'd even take it myself."
4228,3970,0,2,21,23,1.0869565217391304,0.060073850409370196,673,I'm not saying I don't give a rat's ass...
2541,3970,0,2,21,23,1.0869565217391304,0.060073850409370196,673,"You need to eat more insects, slugs, spiders, and worms."
2405,3970,0,2,21,23,1.0869565217391304,0.060073850409370196,673,"I’m prescribing this molded chunk of discarded Gouda, works wonders for eradicating the sense of existential void."
1999,3970,0,2,21,23,1.0869565217391304,0.060073850409370196,673,I assure you that I passed the maze test with flying colors.
2095,3970,0,2,21,23,1.0869565217391304,0.060073850409370196,673,This should work for you; the last cheese was too mild.
2291,3970,0,2,21,23,1.0869565217391304,0.060073850409370196,673,"Before I give you your diagnosis, tell me...is this your card?"
62,3970,0,2,21,23,1.0869565217391304,0.060073850409370196,673,If your symptoms improve I get a food pellet.
300,3970,0,2,21,23,1.0869565217391304,0.060073850409370196,673,"This will replace your previous prescription. Hopefully, this should do away with those nasty hallucinations."
328,3970,0,2,21,23,1.0869565217391304,0.060073850409370196,673,"You can get this filled anywhere in Baltimore, or in the District of Columbia."
547,3970,0,2,21,23,1.0869565217391304,0.060073850409370196,673,"Look, it helped me develop swarthy good looks, it can work for you too."
611,3970,0,2,21,23,1.0869565217391304,0.060073850409370196,673,Here's your prescription. Now call me if you start seeing anything unusual.
935,3970,0,2,21,23,1.0869565217391304,0.060073850409370196,673,It's for cheese. You need more cheese in your diet.
444,3970,0,2,21,23,1.0869565217391304,0.060073850409370196,673,"So you'll give me rat poison, but when I offer it to you..."
1185,3970,1,0,22,23,1.0869565217391304,0.08695652173913043,673,"Try this, it’ll put hair on your chest."
1554,3970,0,2,21,23,1.0869565217391304,0.060073850409370196,673,"When you start howling at the moon, you’ll know you’re cured!"
1681,3970,0,2,21,23,1.0869565217391304,0.060073850409370196,673,Ignore the fact that I’m a rat and ask yourself this. Who has more medical experience: WebMD or a rodent with lots of pain pill scrips.
1761,3970,0,2,21,23,1.0869565217391304,0.060073850409370196,673,"Look, here’s my card. But you gotta quit hounding me..."
1901,3970,0,2,21,23,1.0869565217391304,0.060073850409370196,673,You seem a little sheepish about filling this prescription.
2005,3970,0,2,21,23,1.0869565217391304,0.060073850409370196,673,This will have you normal looking in a day or so.
1125,3970,0,2,21,23,1.0869565217391304,0.060073850409370196,673,You will need to take fur of these every morning.
3730,4004,0,3,33,36,1.0833333333333333,0.04671765921511568,673,"“I’ll accept full payment rat now, thank you very much.”"
1011,4004,0,2,22,24,1.0833333333333333,0.0576303395673437,673,I'm proud to say that my recently deceased family and I were in the study that evaluated the effectiveness of this medication.
1037,4004,0,2,22,24,1.0833333333333333,0.0576303395673437,673,I’m writing you a prescription for amphetamines but only take them as needed.
1416,4004,0,2,22,24,1.0833333333333333,0.0576303395673437,673,"I take these and look, I’m as healthy as a jackal."
1569,4004,0,2,22,24,1.0833333333333333,0.0576303395673437,673,Here's your ticket to the rat race . . .
2412,4004,0,2,22,24,1.0833333333333333,0.0576303395673437,673,"Wear a ten-gallon hat, relief  guaranteed by my ranch in  Kentucky."
3052,4004,0,2,22,24,1.0833333333333333,0.0576303395673437,673,"No need to worry, I won't tell anyone about your STD"
3833,4004,0,2,22,24,1.0833333333333333,0.0576303395673437,673,one pill a day should reduce your cravings to go dumpster diving
1889,4012,0,3,34,37,1.0810810810810811,0.045493265488117475,673,iI's a $500 because you talked 2 minutes past your time.
1162,4013,0,2,23,25,1.08,0.055377492419453826,673,I thought my wife said I was going to the Rodin and then the doctor.
1678,4013,0,2,23,25,1.08,0.055377492419453826,673,Take this prescription and if you still hallucinate you are seeing rats....get a cat.
1257,4015,0,2,24,26,1.0769230769230769,0.05329387100211931,673,It’s rejected...
1394,4015,0,2,24,26,1.0769230769230769,0.05329387100211931,673,I am a Were-Rat please take this note to my wife which contains my last will and testament.  Please leave now before my transformation is compl-AAAAAAAAAAAARRRRGGG
1917,4015,0,2,24,26,1.0769230769230769,0.05329387100211931,673,Take this to the nearest Baltimore pharmacy!
2239,4015,0,2,24,26,1.0769230769230769,0.05329387100211931,673,"Look buddy it didnt kill me so relax, youre going to be as good as new in no time."
4244,4015,0,2,24,26,1.0769230769230769,0.05329387100211931,673,See here Mr. Smith ! I
4109,4020,0,2,30,32,1.0625,0.04347552147751577,673,"Excuse my handwriting, I'm left handed."
3385,4021,0,2,32,34,1.0588235294117647,0.0409594484601642,673,"Take one of these and capsules and it should give you the courage to buy one of our masks and keep the big,bad girls away from your door."
3377,4021,0,1,16,17,1.0588235294117647,0.06063390625908324,673,Why ever would you think it's experimental?
3335,4021,0,1,16,17,1.0588235294117647,0.06063390625908324,673,"The better to click you with, my dear!"
3311,4021,0,1,16,17,1.0588235294117647,0.06063390625908324,673,"I don't give a rat's ass if you get this perscription, but better not accuse me of anything if you grt worse!"
3263,4021,0,1,16,17,1.0588235294117647,0.06063390625908324,673,"Take two, one for you and one for your cat.  And don't call me!"
3231,4021,0,1,16,17,1.0588235294117647,0.06063390625908324,673,Take 2 Asiagos and call me in the morning.
3224,4021,0,1,16,17,1.0588235294117647,0.06063390625908324,673,"No, I don't think you're a lunatic, but these and howling at the moon will make you feel better."
2992,4021,0,1,16,17,1.0588235294117647,0.06063390625908324,673,"You have my word, they will not think it strange."
3153,4021,0,1,16,17,1.0588235294117647,0.06063390625908324,673,Dr Ratosky. Just got promoted from clinical trials.
3119,4021,0,1,16,17,1.0588235294117647,0.06063390625908324,673,No need to worry about side effects.  I even take it myself.
3390,4021,0,1,16,17,1.0588235294117647,0.06063390625908324,673,"The prescription will help minimize your hallucinations, and my receptionist will help maximize your payment plan."
2970,4021,0,1,16,17,1.0588235294117647,0.06063390625908324,673,"This should be taken with food, preferably two pizza crusts or some chicken bones."
2880,4021,0,1,16,17,1.0588235294117647,0.06063390625908324,673,"It's coumadin, rat poison..but it's good meds for you."
2824,4021,0,1,16,17,1.0588235294117647,0.06063390625908324,673,"Cheddar, twice daily. Make sure that you take it with crackers if on an empty stomach."
2762,4021,0,1,16,17,1.0588235294117647,0.06063390625908324,673,I’m afraid I need to report your bad behavior.
3222,4021,0,1,16,17,1.0588235294117647,0.06063390625908324,673,"Of course,​ I'm a qualified psychologist, I've worked in psych labs all my life."
3434,4021,0,1,16,17,1.0588235294117647,0.06063390625908324,673,I'm prescribing this experimental drug. I had no side effects
4495,4021,0,1,16,17,1.0588235294117647,0.06063390625908324,673,It's a race and you need a job.
3592,4021,0,1,16,17,1.0588235294117647,0.06063390625908324,673,"What, you think I'd prescribe poison?"
4543,4021,0,1,16,17,1.0588235294117647,0.06063390625908324,673,So YOU think you're a werewolf....? Seriously?!
2586,4021,0,1,16,17,1.0588235294117647,0.06063390625908324,673,"Trust me, you can take blood thinners even if they were first developed as rat poison."
4455,4021,0,1,16,17,1.0588235294117647,0.06063390625908324,673,Take 2 a day with cheese and you'll be back to normal in a few days.
4384,4021,0,1,16,17,1.0588235294117647,0.06063390625908324,673,Street prices!!
4372,4021,0,1,16,17,1.0588235294117647,0.06063390625908324,673,"I've written you a new prescription for micro-dosing.
Macro didn't seem to work so well."
4312,4021,0,1,16,17,1.0588235294117647,0.06063390625908324,673,"I can't accept your check, I only treat foxy ladies."
4124,4021,0,1,16,17,1.0588235294117647,0.06063390625908324,673,These few weeks of observation will go by quickly. Then I can prescribe it to mice.
4084,4021,0,1,16,17,1.0588235294117647,0.06063390625908324,673,Here's a prescription for the hallucinations.
3897,4021,0,1,16,17,1.0588235294117647,0.06063390625908324,673,This should help for your hallucinations.
3890,4021,0,1,16,17,1.0588235294117647,0.06063390625908324,673,Like some rat gum? Our tests show that it’s 93% carcinogenic free.
3858,4021,0,1,16,17,1.0588235294117647,0.06063390625908324,673,"It may seem outlandish, but eating dog poop works every time."
3791,4021,0,1,16,17,1.0588235294117647,0.06063390625908324,673,"Just take these twice a day and that should help you stop seeing me as whatever you are currently seeing me as,"
3718,4021,0,1,16,17,1.0588235294117647,0.06063390625908324,673,"I recommend a strict diet of cider. Should you need it, here is a prescription for chicken."
3645,4021,0,1,16,17,1.0588235294117647,0.06063390625908324,673,Take this medication and you’ll feel like a new mouse; I mean new man.
3596,4021,0,1,16,17,1.0588235294117647,0.06063390625908324,673,"When “Teenage Mutant Ninja Turtles” ended I decided to go to med school. Anyway, do you want the Adderall prescription or not?"
3496,4021,0,1,16,17,1.0588235294117647,0.06063390625908324,673,Take this and stop horsing around
2549,4021,0,1,16,17,1.0588235294117647,0.06063390625908324,673,"Take this to the lab for some tests I’d like you to take. For  your  participation, there will be some cheesy rewards."
3169,4021,0,1,16,17,1.0588235294117647,0.06063390625908324,673,I insist not to give a rat's ass. Call this number if you have complaints.
2305,4021,0,1,16,17,1.0588235294117647,0.06063390625908324,673,"Take it, you don't want to end up like the rats."
795,4021,0,1,16,17,1.0588235294117647,0.06063390625908324,673,Are the symptoms more severe during full-moon?
751,4021,0,1,16,17,1.0588235294117647,0.06063390625908324,673,They call me Dr.Rat thank you.
730,4021,0,1,16,17,1.0588235294117647,0.06063390625908324,673,Don't trust the psychologist. It's a trap.
688,4021,0,1,16,17,1.0588235294117647,0.06063390625908324,673,"Trust me, dog spit will fix you right up, and its way cheaper than Xanax."
679,4021,0,1,16,17,1.0588235294117647,0.06063390625908324,673,Let me prescribe these.  I tested them myself.
658,4021,0,1,16,17,1.0588235294117647,0.06063390625908324,673,"Yes, I am now DOCTOR Ratburn. I quit my acting career on the Arthur show."
540,4021,0,1,16,17,1.0588235294117647,0.06063390625908324,673,Trust me.  I am an excellent veterinarian!
506,4021,0,1,16,17,1.0588235294117647,0.06063390625908324,673,This medicine is guaranteed. It was tested on me and look at me now.
408,4021,0,1,16,17,1.0588235294117647,0.06063390625908324,673,Is this your card? Rats...
367,4021,0,1,16,17,1.0588235294117647,0.06063390625908324,673,"What, you've never seen a doctor my age before?"
339,4021,0,1,16,17,1.0588235294117647,0.06063390625908324,673,"Yes, side affects can include hallucinations, why do you ask?"
257,4021,0,1,16,17,1.0588235294117647,0.06063390625908324,673,I’m kind of hiding from the cyber police. Want to answer for me?
205,4021,0,1,16,17,1.0588235294117647,0.06063390625908324,673,"Okay, but Low T is the least of your worries."
5,4021,0,1,16,17,1.0588235294117647,0.06063390625908324,673,"Hmm, you're having delusions that your wife is a funny looking animal?
Take two of these in the morning."
2382,4021,0,1,16,17,1.0588235294117647,0.06063390625908324,673,Take this once a day. Only once.
807,4021,0,1,16,17,1.0588235294117647,0.06063390625908324,673,And that's why I became a plastic surgeon.
817,4021,0,1,16,17,1.0588235294117647,0.06063390625908324,673,Test Kitchen or Milk Street?
488,4021,0,1,16,17,1.0588235294117647,0.06063390625908324,673,"Your Credit Card seems to be In Order, but I don't like Your Looks."""
1141,4021,0,1,16,17,1.0588235294117647,0.06063390625908324,673,"Nurse, we're going to need some more ants for...uh...medical reasons"
2122,4021,0,1,16,17,1.0588235294117647,0.06063390625908324,673,Get this filled and take them. You will see better in a few days
964,4021,0,1,16,17,1.0588235294117647,0.06063390625908324,673,"Um, Dr Ratnick, a prescription for Opioids?"
2081,4021,0,1,16,17,1.0588235294117647,0.06063390625908324,673,"Here, I want you to fill this prescription for Velveeta Cheese."
2075,4021,0,1,16,17,1.0588235294117647,0.06063390625908324,673,"I believe you’ll fit, as I did, that the benefits of the medication outweigh the side effects."
2020,4021,0,1,16,17,1.0588235294117647,0.06063390625908324,673,"My card, for when you're ready for your nose job"
1970,4021,0,1,16,17,1.0588235294117647,0.06063390625908324,673,Yes the new pharmacist  is in Baltimore.Why do you ask?
1817,4021,0,1,16,17,1.0588235294117647,0.06063390625908324,673,Be careful with this. Has been known to grow hair on your chinny chin chin!
2014,4021,0,1,16,17,1.0588235294117647,0.06063390625908324,673,"Don't worry, I'm not prescribing what I took."
1673,4021,0,1,16,17,1.0588235294117647,0.06063390625908324,673,"Take two capsules a day, with cheese or assorted garbage."
1670,4021,0,1,16,17,1.0588235294117647,0.06063390625908324,673,"Here is your prescription for medicinal cheddar, it should help with you anxiety."
1149,4021,0,1,16,17,1.0588235294117647,0.06063390625908324,673,Good news...you've be infested.
1588,4021,0,1,16,17,1.0588235294117647,0.06063390625908324,673,I'm referring you for a second opinion
1574,4021,0,1,16,17,1.0588235294117647,0.06063390625908324,673,"1 petit 
Quadrant San Andre, room temp.
1  medium chunk of extra sharp Vermont cheddar, also room temp, 
And a few ice cold crumbles of Gorgonzola ought to fix you right up."
1530,4021,0,1,16,17,1.0588235294117647,0.06063390625908324,673,Fill this prescription and you’ll stop imagining that people are rats.
1805,4021,0,1,16,17,1.0588235294117647,0.06063390625908324,673,It's always in the cards!
1192,4021,0,1,16,17,1.0588235294117647,0.06063390625908324,673,Here's my card - you'll note that I can help you with those migranes AND eat your garbage.
3099,4094,0,1,17,18,1.0555555555555556,0.05716619504750295,673,"I was in on the development of these babies. Believe me, take one and you'll feel like a whole different person!"
2753,4094,0,1,17,18,1.0555555555555556,0.05716619504750295,673,"Well, if you change your mind about the rodent wheel therapy, give me a call."
2784,4094,0,1,17,18,1.0555555555555556,0.05716619504750295,673,Try a CAT scan - I hear they're safe.
2825,4094,0,1,17,18,1.0555555555555556,0.05716619504750295,673,Today's Thursday--I'm in sheep's clothing on Friday.
3023,4094,0,1,17,18,1.0555555555555556,0.05716619504750295,673,The charge is an arm and a leg. Where do I to start?
3006,4094,0,1,17,18,1.0555555555555556,0.05716619504750295,673,One of these a day will help calm your rodent hallucinations.
3068,4094,0,1,17,18,1.0555555555555556,0.05716619504750295,673,"Here, you might like this one. it's called Doctor Jackal and Mister Hyde."
2714,4094,0,1,17,18,1.0555555555555556,0.05716619504750295,673,The best thing about this cream is that it has no side effects.
3090,4094,0,1,17,18,1.0555555555555556,0.05716619504750295,673,"It’s still in the experimental phase, but results are promising."
2900,4094,0,1,17,18,1.0555555555555556,0.05716619504750295,673,One slide of cheddar every three hours for a month and you'll soon feel gRATe again.
2703,4094,0,1,17,18,1.0555555555555556,0.05716619504750295,673,"There is no prescription for this. Take my card, if he wins again you are going to need us."
2312,4094,0,1,17,18,1.0555555555555556,0.05716619504750295,673,"What, YOU TOO GOOD FOR RAT PILLS!!??!"
2631,4094,0,1,17,18,1.0555555555555556,0.05716619504750295,673,Relax! You don't have the plague. I do!
2461,4094,0,1,17,18,1.0555555555555556,0.05716619504750295,673,But what they didn’t tell you are the off-uses for d-CON.
2458,4094,0,1,17,18,1.0555555555555556,0.05716619504750295,673,Studies show this doesn't cause cancer in humans.
2446,4094,0,1,17,18,1.0555555555555556,0.05716619504750295,673,I'm recommending you up your exercise.  Here's a script for an exercise wheel.  The cage is just an accessory.
2399,4094,0,1,17,18,1.0555555555555556,0.05716619504750295,673,"What, you'll see a rat doctor but not take a rat's prescription?"
2270,4094,0,1,17,18,1.0555555555555556,0.05716619504750295,673,"What do you mean 'it's only been tested on ""your people""'?"
2170,4094,0,1,17,18,1.0555555555555556,0.05716619504750295,673,"It's rat poison. But don't worry, it won't kill you, only thin your blood."
2145,4094,0,1,17,18,1.0555555555555556,0.05716619504750295,673,You can’t pay me in artificial sweeteners. Do you know what that stuff does to lab mice?
3142,4094,0,1,17,18,1.0555555555555556,0.05716619504750295,673,Chew these slowly -- don't wolf them down.
2140,4094,0,1,17,18,1.0555555555555556,0.05716619504750295,673,Consider it payback.
2675,4094,0,1,17,18,1.0555555555555556,0.05716619504750295,673,"Oh yeah, that's really bad and you haven't even seen the bill yet."
3178,4094,0,1,17,18,1.0555555555555556,0.05716619504750295,673,Here's a prescription for blue cheese - lots of penicillin in it!
4036,4094,0,1,17,18,1.0555555555555556,0.05716619504750295,673,"No side effects! Trust me. I didn't choose the lab life, the lab life chose me."
3292,4094,0,1,17,18,1.0555555555555556,0.05716619504750295,673,Reassignment surgery went great for me.
2110,4094,0,1,17,18,1.0555555555555556,0.05716619504750295,673,Here take this.  It’s your Get Out Of Jail Free card.
4547,4094,0,1,17,18,1.0555555555555556,0.05716619504750295,673,Honestly theirs more to me then meets the eye.
4492,4094,0,1,17,18,1.0555555555555556,0.05716619504750295,673,You can get this filled at the hardware store.
4442,4094,0,1,17,18,1.0555555555555556,0.05716619504750295,673,"Yes, the same cartoonist who drew my whiskers did also draw your hair, what about it?"
4382,4094,0,1,17,18,1.0555555555555556,0.05716619504750295,673,Don't worry -- I never fleece my clients.
4232,4094,0,1,17,18,1.0555555555555556,0.05716619504750295,673,You wanna master gene splicer or what?
4155,4094,0,1,17,18,1.0555555555555556,0.05716619504750295,673,You're my doctor?!?!... How old are you again?
4136,4094,0,1,17,18,1.0555555555555556,0.05716619504750295,673,Take two before gnawing.
4009,4094,0,1,17,18,1.0555555555555556,0.05716619504750295,673,The Lab Rat takeover.
3958,4094,0,1,17,18,1.0555555555555556,0.05716619504750295,673,These are the best.  They were tested on myself.
3936,4094,0,1,17,18,1.0555555555555556,0.05716619504750295,673,"Eat two live chickens, and call me in the morning."
3926,4094,0,1,17,18,1.0555555555555556,0.05716619504750295,673,This is for your lab test.  Check in this afternoon.  Good luck.
3892,4094,0,1,17,18,1.0555555555555556,0.05716619504750295,673,The meds I'm prescribing have been tested by my team in the lab
3869,4094,0,1,17,18,1.0555555555555556,0.05716619504750295,673,I'll take the co-pay in cheese.
3832,4094,0,1,17,18,1.0555555555555556,0.05716619504750295,673,"""It appears you're suffering from hallucinations. I'm not even real. Here, we have a pill for that."""
3696,4094,0,1,17,18,1.0555555555555556,0.05716619504750295,673,"I don't know what you've got, but these pills and $100
will cure it."
3694,4094,0,1,17,18,1.0555555555555556,0.05716619504750295,673,"Take two a day and you'll feel great, even if you know you're a rat."
3622,4094,0,1,17,18,1.0555555555555556,0.05716619504750295,673,"Try these,...counting sheep didn't work for me either."
3507,4094,0,1,17,18,1.0555555555555556,0.05716619504750295,673,This will knock it out of you. It's sharp.
3468,4094,0,1,17,18,1.0555555555555556,0.05716619504750295,673,"Your phobia isn't unusual.  Check out our online therapy guide, and call me tomorrow for special new member financing."
3433,4094,0,1,17,18,1.0555555555555556,0.05716619504750295,673,"No more drugs for me, doc. The ones I'm on are working just fine."
3391,4094,0,1,17,18,1.0555555555555556,0.05716619504750295,673,"This will stop the diarrhea. As for the rest of the shit, you’ll have to stop watching Fox News."
3296,4094,0,1,17,18,1.0555555555555556,0.05716619504750295,673,"With your promotion, you get a key to the executive maze room."
3244,4094,0,1,17,18,1.0555555555555556,0.05716619504750295,673,This should cure your Black Plague.  Trust me...
2093,4094,0,1,17,18,1.0555555555555556,0.05716619504750295,673,One of the side effects is rodent sight syndrome
1292,4094,0,1,17,18,1.0555555555555556,0.05716619504750295,673,We would like you involved in this animal trial.  You game?
1981,4094,0,1,17,18,1.0555555555555556,0.05716619504750295,673,"Here, try this."
699,4094,0,1,17,18,1.0555555555555556,0.05716619504750295,673,this will help with that nose extension...I know you're going to love it!
689,4094,0,1,17,18,1.0555555555555556,0.05716619504750295,673,"I wasn't sure at first either, but it's really been paradigm shifting!"
590,4094,0,1,17,18,1.0555555555555556,0.05716619504750295,673,My ancestors had that same suspicious look about cheese.
577,4094,0,1,17,18,1.0555555555555556,0.05716619504750295,673,My friends the Sacklers tell me this isn't addictive at all.
542,4094,0,1,17,18,1.0555555555555556,0.05716619504750295,673,"My prescription to all anti-Trumpers is to start watching ""Fox & Friends!"
516,4094,0,1,17,18,1.0555555555555556,0.05716619504750295,673,"It's funny, but you didn't seem to have the symptoms of Bubonic plague until AFTER I examined you!"
490,4094,0,1,17,18,1.0555555555555556,0.05716619504750295,673,It's a new drug.  Let's see what happens.
481,4094,0,1,17,18,1.0555555555555556,0.05716619504750295,673,I've had several family members take this.
462,4094,0,1,17,18,1.0555555555555556,0.05716619504750295,673,Take two anti-hallucinogens and call me in the morning
453,4094,0,1,17,18,1.0555555555555556,0.05716619504750295,673,Here is your prescription.  Which dumpster do you use?
452,4094,0,1,17,18,1.0555555555555556,0.05716619504750295,673,I understand the smell but we take patient privacy very seriously.
411,4094,0,1,17,18,1.0555555555555556,0.05716619504750295,673,DRATS
274,4094,0,1,17,18,1.0555555555555556,0.05716619504750295,673,Im giving you an opioid prescription.Don't rat me out.
246,4094,0,1,17,18,1.0555555555555556,0.05716619504750295,673,This should stop the hallucinations.
245,4094,0,1,17,18,1.0555555555555556,0.05716619504750295,673,Well yes it was originally developed as rat poison but no hard feelings.
241,4094,0,1,17,18,1.0555555555555556,0.05716619504750295,673,"Yeah, your eye really shouldn't look like mine."
229,4094,0,1,17,18,1.0555555555555556,0.05716619504750295,673,Take three cubes of cheese three times a day.
109,4094,0,1,17,18,1.0555555555555556,0.05716619504750295,673,"'Don't worry, it's approved by lab rats.'"
97,4094,0,1,17,18,1.0555555555555556,0.05716619504750295,673,"They have a wide selection of heads, but the humans are generally  unattractive."
92,4094,0,1,17,18,1.0555555555555556,0.05716619504750295,673,You're study participant number 26.
70,4094,0,1,17,18,1.0555555555555556,0.05716619504750295,673,"And if this doesn't work, try chewing on a bar of soap."
20,4094,0,1,17,18,1.0555555555555556,0.05716619504750295,673,"Take these and you'll forget you were ever a cast member of the musical ""Cats""."
2003,4094,0,1,17,18,1.0555555555555556,0.05716619504750295,673,Take two of these at bedtime and call me at the next full moon
723,4094,0,1,17,18,1.0555555555555556,0.05716619504750295,673,Your Big Bad Wolf attitude does nothing for me.
726,4094,0,1,17,18,1.0555555555555556,0.05716619504750295,673,"Oh, don't be alarmed.  I don't bite!"
262,4094,0,1,17,18,1.0555555555555556,0.05716619504750295,673,I did experiment on myself - why do you ask?
880,4094,0,1,17,18,1.0555555555555556,0.05716619504750295,673,This will make your skin as smooth as mine.
1943,4094,0,1,17,18,1.0555555555555556,0.05716619504750295,673,It’s very safe. It doesn’t cause cancer in rats.
791,4094,0,1,17,18,1.0555555555555556,0.05716619504750295,673,Take these twice a day. And avoid cheese for a while.
1906,4094,0,1,17,18,1.0555555555555556,0.05716619504750295,673,"Yes I only prescribe cheeses, why?"
1868,4094,0,1,17,18,1.0555555555555556,0.05716619504750295,673,"The prescription is well tested, don’t worry, I would know."
1854,4094,0,1,17,18,1.0555555555555556,0.05716619504750295,673,Fentanyl with cheese. Twice a day.
1780,4094,0,1,17,18,1.0555555555555556,0.05716619504750295,673,Take one of these on September 14 and the other on October 13.
1649,4094,0,1,17,18,1.0555555555555556,0.05716619504750295,673,"Trust me, Mr. Johnson. My referrals are in your plan."
1618,4094,0,1,17,18,1.0555555555555556,0.05716619504750295,673,Let’s try this Rx for 90 days.  Some minor contraindications but nothing serious.
1567,4094,0,1,17,18,1.0555555555555556,0.05716619504750295,673,I've written a recommendation for a test group
1563,4094,0,1,17,18,1.0555555555555556,0.05716619504750295,673,"No matter how hard you try, there are some things that even rats won't do."
1557,4094,0,1,17,18,1.0555555555555556,0.05716619504750295,673,"Trust me, you need rat poison antidote!"
1687,4094,0,1,17,18,1.0555555555555556,0.05716619504750295,673,Try this to increase the size of your nose hairs.
1450,4094,0,1,17,18,1.0555555555555556,0.05716619504750295,673,The results of this study have thus far shown to be only effective on mice.
972,4094,0,1,17,18,1.0555555555555556,0.05716619504750295,673,Go ahead and take one. I promise I won't shock you again.
1425,4094,0,1,17,18,1.0555555555555556,0.05716619504750295,673,"For your illness of being unpopular, eat a slice of pizza a day in the subway to gain attention. A side effect is becoming a meme."
1424,4094,0,1,17,18,1.0555555555555556,0.05716619504750295,673,"I promise, when we finish treatment, you will really see me as I really am!"
1365,4094,0,1,17,18,1.0555555555555556,0.05716619504750295,673,You are lucky I was there to give you a mouse-to-mouth resuscitation
1341,4094,0,1,17,18,1.0555555555555556,0.05716619504750295,673,"Take this prescription twice a day, and the rodent hallucinations should go away in a week or so."
1312,4094,0,1,17,18,1.0555555555555556,0.05716619504750295,673,This will help with your exhaustion from running around on the wheel all day.
963,4094,0,1,17,18,1.0555555555555556,0.05716619504750295,673,The tests were only on humans...but you're a human.
1200,4094,0,1,17,18,1.0555555555555556,0.05716619504750295,673,I'm prescribing you a healthy dose of rat poison.
1041,4094,0,1,17,18,1.0555555555555556,0.05716619504750295,673,"My what big eyes you have, all the better to see the little red writing, swallow whole on an empty stomach."
1496,4094,0,1,17,18,1.0555555555555556,0.05716619504750295,673,This Rx will help you with you fantasies.
2781,4197,0,1,18,19,1.0526315789473684,0.05407380704358751,673,"Take two of these and call me in the morning.   Not too early, since I walk the sewers all night, okay?"
2752,4197,0,1,18,19,1.0526315789473684,0.05407380704358751,673,Trust me. It’s not warfarin.
2656,4197,0,1,18,19,1.0526315789473684,0.05407380704358751,673,Trust me.  They give me this stuff every day and it hasn't killed me yet.
2644,4197,0,1,18,19,1.0526315789473684,0.05407380704358751,673,"Take one tablet daily, just before your master takes you out for a walk."
2765,4197,0,1,18,19,1.0526315789473684,0.05407380704358751,673,"I am prescribing ""Take two rabbits and go to bed"
2802,4197,0,1,18,19,1.0526315789473684,0.05407380704358751,673,"I've increased your dosage, but let me know if people begin to look like rodents."
2906,4197,0,1,18,19,1.0526315789473684,0.05407380704358751,673,"Here's your prescription.
Next time you come in could you bring a little garbage with you?"
2893,4197,0,1,18,19,1.0526315789473684,0.05407380704358751,673,Drink the Porridge twice a day for 2 weeks and come visit my house when finished.
2895,4197,0,1,18,19,1.0526315789473684,0.05407380704358751,673,"If symptoms persist, call back and we'll see about resealing the tomb"
2941,4197,0,1,18,19,1.0526315789473684,0.05407380704358751,673,Trust me. I’m with the government and  I’m here to help.
3039,4197,0,1,18,19,1.0526315789473684,0.05407380704358751,673,"no worries, we have done this for decades."
2630,4197,0,1,18,19,1.0526315789473684,0.05407380704358751,673,Last refill - don't try to weasel your way into getting another one.
2952,4197,0,1,18,19,1.0526315789473684,0.05407380704358751,673,"Take this before meals, avoid cats, and if you must eat cheese from traps, do it carefully."
2854,4197,0,1,18,19,1.0526315789473684,0.05407380704358751,673,"As your aardvark, I advise you to eat more insects and sleep during the day."
4571,4197,0,1,18,19,1.0526315789473684,0.05407380704358751,673,You'll feel much better once the whiskers grow in completely.
2378,4197,0,1,18,19,1.0526315789473684,0.05407380704358751,673,"If you can't tell what animal I am, take these pills."
2600,4197,0,1,18,19,1.0526315789473684,0.05407380704358751,673,"Take these, three times a day, with a fresh carcass."
2557,4197,0,1,18,19,1.0526315789473684,0.05407380704358751,673,What?! You'd rather stay lactose intolerant?
2523,4197,0,1,18,19,1.0526315789473684,0.05407380704358751,673,Here' s a get out of jail card for the next time you get stuck in the maze.
2484,4197,0,1,18,19,1.0526315789473684,0.05407380704358751,673,"It's not a prescription, 
it's an invitation to our next Furry convention"
2469,4197,0,1,18,19,1.0526315789473684,0.05407380704358751,673,I helped out a bit with the FDA testing on it.
2444,4197,0,1,18,19,1.0526315789473684,0.05407380704358751,673,Take 2 aspirin and howl at me in the morning.
2439,4197,0,1,18,19,1.0526315789473684,0.05407380704358751,673,The testing in Humans shows that they are safe!
2437,4197,0,1,18,19,1.0526315789473684,0.05407380704358751,673,"Oh yeah, this should clear it up eventually. But I should warn you, I'm not so good with keeping secrets."
2429,4197,0,1,18,19,1.0526315789473684,0.05407380704358751,673,Meet me in the sewer under 7th Ave and you'll get your prescription.  If you get lost call me.
2230,4197,0,1,18,19,1.0526315789473684,0.05407380704358751,673,"This will make you lazy and slovenly, so take 2, and  my friends and I will be there in the morning to eat the mess."
2157,4197,0,1,18,19,1.0526315789473684,0.05407380704358751,673,Here's a prescription for cheese. Eat two slices every four hours.
2153,4197,0,1,18,19,1.0526315789473684,0.05407380704358751,673,Take a card . . .
3048,4197,0,1,18,19,1.0526315789473684,0.05407380704358751,673,"Have this piece of cheese, you'll feel better."
2141,4197,0,1,18,19,1.0526315789473684,0.05407380704358751,673,Do you really want to end up like me?
2612,4197,0,1,18,19,1.0526315789473684,0.05407380704358751,673,And who's guarding the hen house?
3085,4197,0,1,18,19,1.0526315789473684,0.05407380704358751,673,Don't worry. This drug is safe. My cousin tested it out.
4354,4197,0,1,18,19,1.0526315789473684,0.05407380704358751,673,Take this twice a day for a week and if the cats are still bothering you...I have alternate methods.
3227,4197,0,1,18,19,1.0526315789473684,0.05407380704358751,673,Take one pill twice a day and have someone rub your throat.  It will go down easier.
2099,4197,0,1,18,19,1.0526315789473684,0.05407380704358751,673,That’s not even funny. I never suspected you’d rat me out.
4565,4197,0,1,18,19,1.0526315789473684,0.05407380704358751,673,"You said a moment ago that everybody you look at seems to be a rat. This prescription will help with that, Mr. Sprague."
4553,4197,0,1,18,19,1.0526315789473684,0.05407380704358751,673,Here. Call me if you notice any unusual side effects.
4530,4197,0,1,18,19,1.0526315789473684,0.05407380704358751,673,"Side effects, um no, why!?"
4496,4197,0,1,18,19,1.0526315789473684,0.05407380704358751,673,You'll be a-mazed by what this stuff  will do for your hallucinations.
4448,4197,0,1,18,19,1.0526315789473684,0.05407380704358751,673,Aren't everyone's business cards made of cheese?
4438,4197,0,1,18,19,1.0526315789473684,0.05407380704358751,673,"Call the office immediately if this makes you nauseous, jittery, or want to crawl into the walls and die."
4417,4197,0,1,18,19,1.0526315789473684,0.05407380704358751,673,Here’s a prescription for a new drug. It’s very safe. As a matter of fact I use it myself
4351,4197,0,1,18,19,1.0526315789473684,0.05407380704358751,673,Take two of these at bedtime with a cheese of your choice other than Roquefort.
4309,4197,0,1,18,19,1.0526315789473684,0.05407380704358751,673,"Yes, it will cure your erectile disfunction but the major side effect is you end up with very small hands."
4179,4197,0,1,18,19,1.0526315789473684,0.05407380704358751,673,"This is blotter acid 
Wilber !"
4128,4197,0,1,18,19,1.0526315789473684,0.05407380704358751,673,"Get bit by a radioactive rat, they said. It'll give you superpowers, they said."
4085,4197,0,1,18,19,1.0526315789473684,0.05407380704358751,673,"These should clear your erectile dysfunction right up. One possible side effect, though, is hallucinations."
4065,4197,0,1,18,19,1.0526315789473684,0.05407380704358751,673,I was part of the research trial and it worked.
4059,4197,0,1,18,19,1.0526315789473684,0.05407380704358751,673,Of course it works. I tested it on myself.
4054,4197,0,1,18,19,1.0526315789473684,0.05407380704358751,673,"Before I write your prescriptions, tell me, are you hallucinating right now?"
4039,4197,0,1,18,19,1.0526315789473684,0.05407380704358751,673,You can try this but I was in the placebo group and look what happened.
3285,4197,0,1,18,19,1.0526315789473684,0.05407380704358751,673,Take two of these and call an exterminator.
3475,4197,0,1,18,19,1.0526315789473684,0.05407380704358751,673,Here's a prescription for 'Ratgrow'
3502,4197,0,1,18,19,1.0526315789473684,0.05407380704358751,673,"Don't worry, you can afford this prescription if you work three more jobs and never sleep again!"
3530,4197,0,1,18,19,1.0526315789473684,0.05407380704358751,673,Just relax. I'm what you get when you buy a cheap insurance policy!
3537,4197,0,1,18,19,1.0526315789473684,0.05407380704358751,673,This drug saved my sister’s life and it just might work for you.
3635,4197,0,1,18,19,1.0526315789473684,0.05407380704358751,673,It’s been thoroughly tested on rats.
3091,4197,0,1,18,19,1.0526315789473684,0.05407380704358751,673,Here's a prescription for some Gouda cheese.  You'll feel better in the morning.
3647,4197,0,1,18,19,1.0526315789473684,0.05407380704358751,673,You think you've got problems? Even I don't know whether I'm an aardvark or an anteater.
3793,4197,0,1,18,19,1.0526315789473684,0.05407380704358751,673,Face it!  Soo you'll look as good as me
3826,4197,0,1,18,19,1.0526315789473684,0.05407380704358751,673,"No, Mr. Burns, it's simply a Rat-inol dysfunction. Use these drops twice a day for two weeks and you'll be fine. Oh, and be sure to stay away from cats."
3873,4197,0,1,18,19,1.0526315789473684,0.05407380704358751,673,Take two of these per day -- and avoid cats and Irish bars!
3891,4197,0,1,18,19,1.0526315789473684,0.05407380704358751,673,"If the hallucinations continue, we'll up the dosage."
3957,4197,0,1,18,19,1.0526315789473684,0.05407380704358751,673,Your operating table is ready
3971,4197,0,1,18,19,1.0526315789473684,0.05407380704358751,673,"Go back to your cube, hit the lever two times and call me in the morning."
3782,4197,0,1,18,19,1.0526315789473684,0.05407380704358751,673,"Trust me … all you need is to relocate to an urban dwelling and surround yourself with dark, dusty corners and candy wrappers."
2084,4197,0,1,18,19,1.0526315789473684,0.05407380704358751,673,"Yes, bacon is good for you."
1418,4197,0,1,18,19,1.0526315789473684,0.05407380704358751,673,My wife!  Tell her I went to get cigarettes.  I am doing magic with the butt.
1933,4197,0,1,18,19,1.0526315789473684,0.05407380704358751,673,This prescription helped me. It'll make a different person out of you.
885,4197,0,1,18,19,1.0526315789473684,0.05407380704358751,673,One of the side effects is a craving for cheese.
865,4197,0,1,18,19,1.0526315789473684,0.05407380704358751,673,I'm referring you to this lab.  You'll be in good hands.
858,4197,0,1,18,19,1.0526315789473684,0.05407380704358751,673,I've been trained to navigate your health insurance claims.
792,4197,0,1,18,19,1.0526315789473684,0.05407380704358751,673,"So you think children should be in cages? Okay, buddy, I don't do this often, but I'm gonna write you a prescription for a brain."
789,4197,0,1,18,19,1.0526315789473684,0.05407380704358751,673,You'll take it for only half a dog-year.
685,4197,0,1,18,19,1.0526315789473684,0.05407380704358751,673,What a coincidence that we’re both vets!
674,4197,0,1,18,19,1.0526315789473684,0.05407380704358751,673,You're diagnosis is complete. As are you.
668,4197,0,1,18,19,1.0526315789473684,0.05407380704358751,673,I recommend my brother. Here’s his number in Baltimore.
634,4197,0,1,18,19,1.0526315789473684,0.05407380704358751,673,You have head lice. At least it’s better than head mice.
623,4197,0,1,18,19,1.0526315789473684,0.05407380704358751,673,This prescription will take care of the hallucinations or my name isn't Dr. Fink!
597,4197,0,1,18,19,1.0526315789473684,0.05407380704358751,673,You can pick these up in any storm drain.
562,4197,0,1,18,19,1.0526315789473684,0.05407380704358751,673,"I'me giving you a prescription for some special cheese you get only at the Crosstown Deli. Take two, small pieces tonight and drop back her to my office in the morning..... bring the cheese."
463,4197,0,1,18,19,1.0526315789473684,0.05407380704358751,673,"hold on dr rat, don't YOU carry the plague???!!!!"
413,4197,0,1,18,19,1.0526315789473684,0.05407380704358751,673,"Now, all of a sudden, you have a conscience?"
906,4197,0,1,18,19,1.0526315789473684,0.05407380704358751,673,Arsenic?
409,4197,0,1,18,19,1.0526315789473684,0.05407380704358751,673,"Come on, just take it--you think I'd bite you?"
379,4197,0,1,18,19,1.0526315789473684,0.05407380704358751,673,You may be in the control group which has no risk of sterilization.
364,4197,0,1,18,19,1.0526315789473684,0.05407380704358751,673,You can get this filled at the pharmacy downstairs. It's for flea powder and a plastic cone.
344,4197,0,1,18,19,1.0526315789473684,0.05407380704358751,673,What am I prescribing you? Stitches
291,4197,0,1,18,19,1.0526315789473684,0.05407380704358751,673,"This experimental drug worked wonders on my prostate."""
249,4197,0,1,18,19,1.0526315789473684,0.05407380704358751,673,Take one dumpster dive and call me in the morning.
234,4197,0,1,18,19,1.0526315789473684,0.05407380704358751,673,It worked for me.
217,4197,0,1,18,19,1.0526315789473684,0.05407380704358751,673,"Trust me, soon everyone in Baltimore will be wearing them."
174,4197,0,1,18,19,1.0526315789473684,0.05407380704358751,673,"We just can't seem to figure out why your eyes are popping out of your head like that, but my sponsors suggest Xanax may be the remedy."""
168,4197,0,1,18,19,1.0526315789473684,0.05407380704358751,673,"If I can work my way out of Baltimore, anyone can!"
156,4197,0,1,18,19,1.0526315789473684,0.05407380704358751,673,The couch costs extra
138,4197,0,1,18,19,1.0526315789473684,0.05407380704358751,673,The surgery changed me but my prescriptions are still illegible.
15,4197,0,1,18,19,1.0526315789473684,0.05407380704358751,673,I can tell you that this place is not some hole in the wall.
8,4197,0,1,18,19,1.0526315789473684,0.05407380704358751,673,"I must inform you, the radiation comes with some risk of mutation."
1941,4197,0,1,18,19,1.0526315789473684,0.05407380704358751,673,"I worked my way through med school, all while raising four teenage mutant ninja turtles."
382,4197,0,1,18,19,1.0526315789473684,0.05407380704358751,673,"If these don't work, I'll send you to Dr. Zebra for more tests."
942,4197,0,1,18,19,1.0526315789473684,0.05407380704358751,673,Here is my Rat Race Card. Now get out of my office!
589,4197,0,1,18,19,1.0526315789473684,0.05407380704358751,673,"I SAID, go to the maze room."
956,4197,0,1,18,19,1.0526315789473684,0.05407380704358751,673,Don’t forget to this after you finish your spin!
1895,4197,0,1,18,19,1.0526315789473684,0.05407380704358751,673,Don't worry about the pot--your stool samples float directly past my apartment.
1855,4197,0,1,18,19,1.0526315789473684,0.05407380704358751,673,I didn’t realize Rodentists could prescribe
945,4197,0,1,18,19,1.0526315789473684,0.05407380704358751,673,"Sure, you may find lower prices of this elsewhere, but those won't give the patient a baritone whiny or enable her to accept the bridle as easily."
1836,4197,0,1,18,19,1.0526315789473684,0.05407380704358751,673,"A man to a man wolf.
Excuse me , Dr Wolf ."
1832,4197,0,1,18,19,1.0526315789473684,0.05407380704358751,673,Call the rat catcher and I'll kill you !
1807,4197,0,1,18,19,1.0526315789473684,0.05407380704358751,673,"Another refill? You're not trying to out-shrewd Doc Shrew, are you?"
1806,4197,0,1,18,19,1.0526315789473684,0.05407380704358751,673,I myself have used this hair regrowth treatment for years.
1745,4197,0,1,18,19,1.0526315789473684,0.05407380704358751,673,"Call me crazy, but street drugs are probably cheaper"
1713,4197,0,1,18,19,1.0526315789473684,0.05407380704358751,673,These pills are guaranteed to make you bright-eyed and bushy-tailed.
1612,4197,0,1,18,19,1.0526315789473684,0.05407380704358751,673,"Give Mr. Dean a call, he has been through this before."
1602,4197,0,1,18,19,1.0526315789473684,0.05407380704358751,673,Psst! Here... Don't tell them I'm from Baltimore!
1591,4197,0,1,18,19,1.0526315789473684,0.05407380704358751,673,"Take two, and cry for me in the morning."
1556,4197,0,1,18,19,1.0526315789473684,0.05407380704358751,673,Red Riding Hood didn’t believe me either.
1544,4197,0,1,18,19,1.0526315789473684,0.05407380704358751,673,"That's how homeopathy works, pal. If you want this recalcitrant case of murophobia cured once and for all, you need to take the poison."
1475,4197,0,1,18,19,1.0526315789473684,0.05407380704358751,673,"I snorted ""Hair Grow for Noses"".  You want prescription?"
1853,4197,0,1,18,19,1.0526315789473684,0.05407380704358751,673,Take two and don't call me because I won't answer your calls.
1325,4197,0,1,18,19,1.0526315789473684,0.05407380704358751,673,Give it a try. It tested pretty well with my folks at the lab.
1351,4197,0,1,18,19,1.0526315789473684,0.05407380704358751,673,Take two of these with cheese every morning.
1003,4197,0,1,18,19,1.0526315789473684,0.05407380704358751,673,Yes of course it's safe - they tested it on my family.
1039,4197,0,1,18,19,1.0526315789473684,0.05407380704358751,673,"I can't help you I'm afraid. But's here's the card of my colleague.
His eyes aren't quite so beady."
1040,4197,0,1,18,19,1.0526315789473684,0.05407380704358751,673,Take a block of yellow cheese with your meal every day and you'll be fine in no time. Trust me I used to work in a lab.
1077,4197,0,1,18,19,1.0526315789473684,0.05407380704358751,673,"If you think you're hallucinating now, wait til you take this stuff."
1127,4197,0,1,18,19,1.0526315789473684,0.05407380704358751,673,You may bark louder than me - but this’ll put some bite in it!
1136,4197,0,1,18,19,1.0526315789473684,0.05407380704358751,673,I recommend this prescription from experience. I used to work a blue collar job.
1026,4197,0,1,18,19,1.0526315789473684,0.05407380704358751,673,No side effects. Why?
1183,4197,0,1,18,19,1.0526315789473684,0.05407380704358751,673,"Man: This is just a prescription for a divorce.
Rat: You know, I never gave a rat's ass about you, but I certainly gave one to your wife."
1195,4197,0,1,18,19,1.0526315789473684,0.05407380704358751,673,"Here, you try it. I am done experimenting."
1243,4197,0,1,18,19,1.0526315789473684,0.05407380704358751,673,"I've got just the thing. Revert back to your infant years, and see the world wide-eyed and compassionately.
But... how?"
1250,4197,0,1,18,19,1.0526315789473684,0.05407380704358751,673,This will make you feel more a part of the rat race.
1151,4197,0,1,18,19,1.0526315789473684,0.05407380704358751,673,"I swear I didn´t tell anyone about your cancer!
Guess we have a rat in here..."
1271,4197,0,1,18,19,1.0526315789473684,0.05407380704358751,673,Take two of these and stay away from cheese!
3055,4331,0,1,19,20,1.05,0.051298917604257706,673,This should help with the huffing and puffing
3044,4331,0,1,19,20,1.05,0.051298917604257706,673,"Since the mask didn’t make you laugh, try taking this."
3032,4331,0,1,19,20,1.05,0.051298917604257706,673,"She’s a snake, but she’s the best in her field."
3008,4331,0,1,19,20,1.05,0.051298917604257706,673,you should take these to control those outrageous hallucinations...I'm actually a hippopotamus.
2869,4331,0,1,19,20,1.05,0.051298917604257706,673,"Here are the tablets for your delirium.
Nicholas Wilcken, Sydney."
2975,4331,0,1,19,20,1.05,0.051298917604257706,673,To avoid nasty side effects don’t eat any cheese.
2805,4331,0,1,19,20,1.05,0.051298917604257706,673,Burning Man is terrible this year.
2803,4331,0,1,19,20,1.05,0.051298917604257706,673,Root thru 2 bags of garbage and scurry back tomorrow morning.
3095,4331,0,1,19,20,1.05,0.051298917604257706,673,Here's a prescription to help cure your hallucinations.
2700,4331,0,1,19,20,1.05,0.051298917604257706,673,"That'll be $6,000, or a slice of cheese."
3007,4331,0,1,19,20,1.05,0.051298917604257706,673,I hope that your hallucinations can be ratified by taking these once a day.
3204,4331,0,1,19,20,1.05,0.051298917604257706,673,"Take two pills a day, get plenty of rest, and come back when you're edible."
3948,4331,0,1,19,20,1.05,0.051298917604257706,673,Don't worry it has been tested on humans.
3604,4331,0,1,19,20,1.05,0.051298917604257706,673,"They're experimental, but they've definitely helped me."
3650,4331,0,1,19,20,1.05,0.051298917604257706,673,Your eyes mom's face an curly fries.
3744,4331,0,1,19,20,1.05,0.051298917604257706,673,Take three slices of cheese and call me in the morning.
3812,4331,0,1,19,20,1.05,0.051298917604257706,673,Here is a prescription for Zofran to treat your vertigo.  In the future I suggest leaving maze-running to the experts.
3819,4331,0,1,19,20,1.05,0.051298917604257706,673,Would you mind picking this up for me?
3944,4331,0,1,19,20,1.05,0.051298917604257706,673,I'm giving you this prescription. Tell me when you top seeing elephants.
4156,4331,0,1,19,20,1.05,0.051298917604257706,673,"I took this back when I was in the lab, and I feel a lot more human now"
4253,4331,0,1,19,20,1.05,0.051298917604257706,673,This Prescription is renewable 3 times for string cheese .
4268,4331,0,1,19,20,1.05,0.051298917604257706,673,"Hopefully, with these new pills, you will not see rats everywhere."
4516,4331,0,1,19,20,1.05,0.051298917604257706,673,I know you've had bad previous experiences with doctors before but trust me.
1486,4331,0,1,19,20,1.05,0.051298917604257706,673,Just because it worked on your cousin doesn’t mean it will work on me.
2514,4331,0,1,19,20,1.05,0.051298917604257706,673,Take two cheese and calm in the morning.
3526,4331,0,1,19,20,1.05,0.051298917604257706,673,Take these with your water dish and give me two barks in the morning
2407,4331,0,1,19,20,1.05,0.051298917604257706,673,Take three times a day with pizza.
74,4331,0,1,19,20,1.05,0.051298917604257706,673,...At least I'm not a chiropractor...
2251,4331,0,1,19,20,1.05,0.051298917604257706,673,It works on my friends; it should work for you.
182,4331,0,1,19,20,1.05,0.051298917604257706,673,"Take 2 blocks of cheddar every morning, and hop on the wheel every now and then to get some exercise in."
189,4331,0,1,19,20,1.05,0.051298917604257706,673,This helped change me; I suggest you take it.
228,4331,0,1,19,20,1.05,0.051298917604257706,673,Pick a card. Any card.
310,4331,0,1,19,20,1.05,0.051298917604257706,673,"Take two JT Eaton 166004 709-PN Bait Block Rodenticide Anticoagulant Bait, Peanut Butter Flavor, and call me in the morning."
366,4331,0,1,19,20,1.05,0.051298917604257706,673,"HOWL,   MAY I HELP YOU?"
2360,4331,0,1,19,20,1.05,0.051298917604257706,673,"It's your decision, but isn't keeping your blood pressure in check worth enduring side effects such as hallucinating that the people around you are rats?"
670,4331,0,1,19,20,1.05,0.051298917604257706,673,"Don't worry, we bulk bill."
701,4331,0,1,19,20,1.05,0.051298917604257706,673,"Seriously, arsenic has a long and well tested history as a cure for syphillis. Why do you ask?"
707,4331,0,1,19,20,1.05,0.051298917604257706,673,Take two of these pills and start a food RATion.
1129,4331,0,1,19,20,1.05,0.051298917604257706,673,you can either get it treated now or wait until things are really bad for more sympathy
1176,4331,0,1,19,20,1.05,0.051298917604257706,673,"If those cats cause any more trouble, you let me know."
1380,4331,0,1,19,20,1.05,0.051298917604257706,673,so I see you were refer to me by the Pied Piper of  Hamelen
420,4331,0,1,19,20,1.05,0.051298917604257706,673,Let’s see if this works.
1506,4331,0,1,19,20,1.05,0.051298917604257706,673,"Here take this for a week, it worked for me."
1480,4331,0,1,19,20,1.05,0.051298917604257706,673,This is tonight's special
2090,4331,0,1,19,20,1.05,0.051298917604257706,673,Take two enema--and call me in the morning !
2055,4331,0,1,19,20,1.05,0.051298917604257706,673,My ancestors used to eat you but now we just make money off of you
1949,4331,0,1,19,20,1.05,0.051298917604257706,673,My cousins were the first to try these.
1784,4331,0,1,19,20,1.05,0.051298917604257706,673,"I got my start in Marina del Rey. In those years, lab rats were seen as second-class citizens."
1975,4331,0,1,19,20,1.05,0.051298917604257706,673,Didn't you try to poison me once?
1668,4331,0,1,19,20,1.05,0.051298917604257706,673,Here is your prescription. Take two pieces of cheese for a week and call me in a week if you don’t feel better.
1667,4331,0,1,19,20,1.05,0.051298917604257706,673,"Please, try not to rat me out if this prescription makes you high."
1637,4331,0,1,19,20,1.05,0.051298917604257706,673,"It has been tested on lab rats and it was found that it causes cancer, but hell you're not a lab rat."
1562,4331,0,1,19,20,1.05,0.051298917604257706,673,And I strongly advise that you avoid being human as often as possible. It’s almost as bad for you as you are for the planet.
1686,4331,0,1,19,20,1.05,0.051298917604257706,673,This prescription will improve your perception of me and get rid of those popping eyes.
3565,4385,0,1,20,21,1.0476190476190477,0.048795003647426664,673,"Look John, I cannot cure your broken heart. I have no idea who ratted you out."
3446,4385,0,1,20,21,1.0476190476190477,0.048795003647426664,673,2 pills before full moon and you’ll sleep like a baby.
3528,4385,0,1,20,21,1.0476190476190477,0.048795003647426664,673,Would it kill you to take a bath?
4541,4385,0,1,20,21,1.0476190476190477,0.048795003647426664,673,"The initials next to my name on the diplomas stand for Registered Allergy Therapist."""
3721,4385,0,1,20,21,1.0476190476190477,0.048795003647426664,673,This is for Coumadin... Trust me it's safe.
4475,4385,0,1,20,21,1.0476190476190477,0.048795003647426664,673,Here's my card. I'd like to run a few tests.
4220,4385,0,1,20,21,1.0476190476190477,0.048795003647426664,673,I got my  M. D. at Purdue! You think I'm a rat?
4230,4385,0,1,20,21,1.0476190476190477,0.048795003647426664,673,"You're a Libra, aren't you?"
4245,4385,0,1,20,21,1.0476190476190477,0.048795003647426664,673,I do kids parties on the weekends - here's my card.
4421,4385,0,1,20,21,1.0476190476190477,0.048795003647426664,673,"""Take two parasites and call me in the morning."""
3027,4385,0,1,20,21,1.0476190476190477,0.048795003647426664,673,"Here's some Tic Tacs for your dog's bad breath. And dont take this the wrong way, but you may wanna pop 2 in your mouth before you go."
4160,4385,0,1,20,21,1.0476190476190477,0.048795003647426664,673,"I added OxyContin for the taste.
Eh... your waist, the pain in your waist."
2849,4385,0,1,20,21,1.0476190476190477,0.048795003647426664,673,"Sorry, our minority hire was filled last week."
6,4385,0,1,20,21,1.0476190476190477,0.048795003647426664,673,"You can stop looking at me like I've got rabies, there's no co-pay on the prescription."
2663,4385,0,1,20,21,1.0476190476190477,0.048795003647426664,673,"I don't normally prescribe Gouda, but what I think what you've got calls for it."
2706,4385,0,1,20,21,1.0476190476190477,0.048795003647426664,673,It's been tested on mice.
142,4385,0,1,20,21,1.0476190476190477,0.048795003647426664,673,This is my telephone number for your girlfriend!
317,4385,0,1,20,21,1.0476190476190477,0.048795003647426664,673,My extensive lab experience leads me to recommend this new trial drug. Let me know how it works out.
740,4385,0,1,20,21,1.0476190476190477,0.048795003647426664,673,"And be sure to get a flu shot, it’s spreading like the plague this year."
908,4385,0,1,20,21,1.0476190476190477,0.048795003647426664,673,I'm prescribing some 'maze therapy' to treat your claustropobia.
654,4385,0,1,20,21,1.0476190476190477,0.048795003647426664,673,These should help to domesticate Milo.
1248,4385,0,1,20,21,1.0476190476190477,0.048795003647426664,673,I've sent your mobile to service center and you'll be fine as soon as it gets repaired.
1272,4385,0,1,20,21,1.0476190476190477,0.048795003647426664,673,You can take this but it won’t help you with your lack of insight.
2054,4385,0,1,20,21,1.0476190476190477,0.048795003647426664,673,"Try this, it worked for me."
2142,4385,0,1,20,21,1.0476190476190477,0.048795003647426664,673,"Get busy living, or get busy dying."
2199,4385,0,1,20,21,1.0476190476190477,0.048795003647426664,673,Just tell the pharmacist that Joey sent you.
1053,4385,0,1,20,21,1.0476190476190477,0.048795003647426664,673,"Take two bites of cheese, twice daily, with plenty of rest, and you'll be fine!"
2624,4412,0,1,21,22,1.0454545454545454,0.046524210519923545,673,"Look, people say all sorts of different things about this; but I can assure you that this is completely okay."
3656,4412,0,1,21,22,1.0454545454545454,0.046524210519923545,673,Take this prescription to cure your hallucination or you will look like me!
3469,4412,0,1,21,22,1.0454545454545454,0.046524210519923545,673,"Try this new medication, it did wonders for me."
3435,4412,0,1,21,22,1.0454545454545454,0.046524210519923545,673,I’ve used this myself with no side-effects.
3370,4412,0,1,21,22,1.0454545454545454,0.046524210519923545,673,I hope you can understand why I’m not prescribing Warfarin for your blood pressure.
3202,4412,0,1,21,22,1.0454545454545454,0.046524210519923545,673,Here's your prescription.  It's none of your business but my ex-wife had a really good divorce lawyer.
2573,4412,0,1,21,22,1.0454545454545454,0.046524210519923545,673,"Take one every day!  I had to, despite all my rage."
721,4412,0,1,21,22,1.0454545454545454,0.046524210519923545,673,"Bob, not all rats are chefs. Some of us chose medicine. Stop asking if I can cook as well. Here’s your prescription for Olanzapine"
2314,4412,0,1,21,22,1.0454545454545454,0.046524210519923545,673,Call my connection! he'll hook you up with the best 'CBD'( high THC) in this area.....wink wink
2080,4412,0,1,21,22,1.0454545454545454,0.046524210519923545,673,May increase your cravings for cheese.
633,4412,0,1,21,22,1.0454545454545454,0.046524210519923545,673,Maybe you feel trapped but try some cheese.
575,4412,0,1,21,22,1.0454545454545454,0.046524210519923545,673,"A year's worth of opioids. Hey, pal, if you can't trust your doc, who can you trust?"
296,4412,0,1,21,22,1.0454545454545454,0.046524210519923545,673,"If you have any other concerns about your mole, give me a call."
2454,4412,0,1,21,22,1.0454545454545454,0.046524210519923545,673,And here’s one ‘Get-Out-Of-Maze-Free’ card to help those nightmares!
588,4426,0,1,22,23,1.0434782608695652,0.044455422447438706,673,"yeah i got your prescription right here. 80mg of absolute dick. yeah. bet you feel pretty stupid for making me run that maze so much, don't you dr gellert?"
1403,4426,0,1,22,23,1.0434782608695652,0.044455422447438706,673,"Take my  card....   the LITTLE RED RIDING HOOD thing,it never happened."
2892,4426,0,1,22,23,1.0434782608695652,0.044455422447438706,673,Why Yes I received my Doctorate at the University of Mouseketeer ‘s
3199,4429,0,1,23,24,1.0416666666666667,0.04256282653793743,673,I think you've lived in Baltimore a little too long. You're imagining things..
264,4429,0,1,23,24,1.0416666666666667,0.04256282653793743,673,Ask for “Ben”.
1294,4429,0,1,23,24,1.0416666666666667,0.04256282653793743,673,"I’m going to refer you to a specialist in Baltimore, the place is infested with doctors."
176,4432,0,1,24,25,1.04,0.040824829046386304,673,I know it's safe. It's been tested on 500 of my relatives.
1142,4433,0,1,25,26,1.0384615384615385,0.03922322702763681,673,"Here, this medicine will remedy the side effects of your previous prescription."
3430,4434,0,1,28,29,1.0344827586206897,0.03509312031717982,673,This is the same damn expired credit card that has been laying in my parking lot for the last two weeks.
2865,4435,0,0,15,15,1.0,0.06900655593423542,673,"One of the possible side effects of this drug, that I too am taking..."
2917,4435,0,0,14,14,1.0,0.07412493166611012,673,Two wedges twice a day with some crackers and a frisky Merlot.
2950,4435,0,0,17,17,1.0,0.06063390625908324,673,I'm prescribing a week's vacation in Baltimore.
2997,4435,0,0,17,17,1.0,0.06063390625908324,673,Try it you'll like it - it helped me!!!
3013,4435,0,0,14,14,1.0,0.07412493166611012,673,"So, take this twice-a-day for ten days, and you should be feeling like a rat again in no time at all."
3058,4435,0,0,18,18,1.0,0.05716619504750295,673,And here's your prescription--3 to 5 pieces of garbage per day for the next week. You should be back to normal in a few days.
2841,4435,0,0,22,22,1.0,0.046524210519923545,673,"This will ease your anxiety, it’s a prescription for Lor-Rat-A-Pam."
3066,4435,0,0,17,17,1.0,0.06063390625908324,673,Gene therapy created me but I don't think they've conquered musophobia yet.  Take two of these and don't call me again
3170,4435,0,0,15,15,1.0,0.06900655593423542,673,"No,my long hair doesn't mean I'm a ratstafarian,any more than you're from Long Island."
3201,4435,0,0,18,18,1.0,0.05716619504750295,673,No mousing around; did you realistically think that I would accept a bill from you? I frankly don’t care how many diplomas you have on the wall behind you!
3215,4435,0,0,17,17,1.0,0.06063390625908324,673,We also accept cheese or garbage.
3230,4435,0,0,16,16,1.0,0.06454972243679027,673,Unfortunately the Hippocratic Oath is too inconvenient for a doctor like me.
3233,4435,0,0,23,23,1.0,0.044455422447438706,673,"Yea, you are right: I'm a Lab Rat, but with a license to avenge!"
3297,4435,0,0,15,15,1.0,0.06900655593423542,673,"What do you mean, rodents can’t be practitioners?"
3150,4435,0,0,16,16,1.0,0.06454972243679027,673,"You may or may not have the plague, but, to be on the safe side, I would recommend you avoid vermin-infested offices."
3310,4435,0,0,14,14,1.0,0.07412493166611012,673,To save the brain and thin the blood take this rat poison daily.
2197,4435,0,0,15,15,1.0,0.06900655593423542,673,Eat two locusts and call me in the morning.
2747,4435,0,0,14,14,1.0,0.07412493166611012,673,"I went and got us a village. Now let's have a Wooly Mammoth heir, M'Lady."
2220,4435,0,0,15,15,1.0,0.06900655593423542,673,It's only warfarin.
2265,4435,0,0,18,18,1.0,0.05716619504750295,673,"OK, here's $100 so you don't rat me out."
2301,4435,0,0,15,15,1.0,0.06900655593423542,673,"Besides that, what do you think about my new mustache?"
2352,4435,0,0,15,15,1.0,0.06900655593423542,673,Please don’t eat me out to the Board.
2354,4435,0,0,15,15,1.0,0.06900655593423542,673,Drink this medicine and prove that you're a rat!
2374,4435,0,0,16,16,1.0,0.06454972243679027,673,CBD even works for hallucinations. C’mon! Try it!
2782,4435,0,0,14,14,1.0,0.07412493166611012,673,"Sorry about the hand-writing, but keep in mind, I’m a rat."
2459,4435,0,0,14,14,1.0,0.07412493166611012,673,Take this. It makes rats smarter
2580,4435,0,0,15,15,1.0,0.06900655593423542,673,Things will probably look normal again once we get your eye back into its socket.
2629,4435,0,0,18,18,1.0,0.05716619504750295,673,"Listen doctor, stop looking at me like that.  I am not your 4th pig."
2638,4435,0,0,15,15,1.0,0.06900655593423542,673,"Here's you prescription, just don't Rat me out!"
2651,4435,0,0,15,15,1.0,0.06900655593423542,673,"Here, take three a day and let us know what side effects you get."
2683,4435,0,0,14,14,1.0,0.07412493166611012,673,"Eat two pieces of cheese and call me in the morning"""
2734,4435,0,0,21,21,1.0,0.048795003647426664,673,Listen! I'm NOT gonna rat you out!
2564,4435,0,0,14,14,1.0,0.07412493166611012,673,These should help get your mind out of the sewer.
3340,4435,0,0,20,20,1.0,0.051298917604257706,673,"Here's my card, in case you need any cats exterminated."
4034,4435,0,0,15,15,1.0,0.06900655593423542,673,"they'll give you a free birthday treat when you sign up, so if you create a new email for each month, then use the previous email as your referral, you can save 15 dollars off your first 20 dollar order on each, and you get a free treat every month"
3400,4435,0,0,15,15,1.0,0.06900655593423542,673,"Trust me, this dumpster has some of the best garbage."
4236,4435,0,0,17,17,1.0,0.06063390625908324,673,"No, it's not poison, I've taken it myself!"
4280,4435,0,0,20,20,1.0,0.051298917604257706,673,Take two slices of Emmenthaler or generic Swiss on an empty stomach and call me in the morning.
4284,4435,0,0,15,15,1.0,0.06900655593423542,673,You really shouldn't have eaten that pizza.
4292,4435,0,0,17,17,1.0,0.06063390625908324,673,"Yes, it's a side-effect─so what, you too good for it?"
4332,4435,0,0,16,16,1.0,0.06454972243679027,673,Side effects? None - it's hardly human poison.
4336,4435,0,0,14,14,1.0,0.07412493166611012,673,And don't believe anything people say about me!
4200,4435,0,0,23,23,1.0,0.044455422447438706,673,"No, it's not going to change how I appear to you. But it will alleviate your ridiculous obsession with mousetraps and bubonic plague."
4339,4435,0,0,14,14,1.0,0.07412493166611012,673,Tell him the Lone Sniffer sent you
4474,4435,0,0,15,15,1.0,0.06900655593423542,673,I'd prefer if you didn't look so sheepish.
4489,4435,0,0,15,15,1.0,0.06900655593423542,673,"yo my pharma rep keeps sending me this nasty shit, god damn look at this scandalous shit right here she's fine as hell dude"
4502,4435,0,0,17,17,1.0,0.06063390625908324,673,It’s a get out of hospital  free card
4510,4435,0,0,15,15,1.0,0.06900655593423542,673,Here's a blood thinner for you.  Warfarin used to be rat poison.
4518,4435,0,0,14,14,1.0,0.07412493166611012,673,Swiss cheese including the holes.  Works wonders.
2146,4435,0,0,16,16,1.0,0.06454972243679027,673,"Here, take these to help with your stress in the rat race"
4424,4435,0,0,15,15,1.0,0.06900655593423542,673,Doctor Rat: Don't worry about plague! I've been carrying it for most of my life with hardly any discomfort.
3376,4435,0,0,15,15,1.0,0.06900655593423542,673,Trust me. A couple of these each day and your back pain will be gone.
4158,4435,0,0,16,16,1.0,0.06454972243679027,673,This treatment has never been tested on humans.
4032,4435,0,0,16,16,1.0,0.06454972243679027,673,"Take two of these,  stay away from the cheese, and don't sweep your kitchen floor for at least a month."
3483,4435,0,0,14,14,1.0,0.07412493166611012,673,I understand you're concerned about being in Baltimore; relax and take this low-cost Canadian Oxy covered under Obama Care.
3504,4435,0,0,16,16,1.0,0.06454972243679027,673,It’s not like it’s rat poison or anything?
3520,4435,0,0,15,15,1.0,0.06900655593423542,673,Woof woof woof woof woof... call 911.
3541,4435,0,0,14,14,1.0,0.07412493166611012,673,I find the comedic value of the side effects to be totally worth the risk of a malpractice lawsuit.
3601,4435,0,0,15,15,1.0,0.06900655593423542,673,This prescription should keep you from smelling rats
3611,4435,0,0,15,15,1.0,0.06900655593423542,673,"The addiction only lasts for a lifetime. Trust me, I'm a doctor."
4035,4435,0,0,14,14,1.0,0.07412493166611012,673,Doctor Fox can make from Lion a Frightened Dude
3633,4435,0,0,16,16,1.0,0.06454972243679027,673,You can’t keep weaseling your way out of taking your meds.
3643,4435,0,0,14,14,1.0,0.07412493166611012,673,I'm going to recommend a gluten-free diet. But don't despair. You can still gnaw on the pizza boxes.
3749,4435,0,0,17,17,1.0,0.06063390625908324,673,Eat 1000 ants a day for 2 weeks.
3758,4435,0,0,14,14,1.0,0.07412493166611012,673,"We are a multi-specialty, multi-cultural practice."
3786,4435,0,0,14,14,1.0,0.07412493166611012,673,"For someone of your species the side effects include insomnia, constipation, and general irritability which is why I'm also referring you to a couples therapist."
3928,4435,0,0,15,15,1.0,0.06900655593423542,673,"Spend a night in the sewer, and let me know how you feel  in the morning"
4031,4435,0,0,16,16,1.0,0.06454972243679027,673,"I'm an anteater, but I guess she was a... Maneater- Hohoho. Well- until next time bob, sorry about the break-up. Here's your prescription for antidepressants."
3636,4435,0,0,15,15,1.0,0.06900655593423542,673,Do several hundred lab tests sound good to you?
2064,4435,0,0,14,14,1.0,0.07412493166611012,673,"It has been tested only on mice...but so far, so good."
4558,4435,0,0,14,14,1.0,0.07412493166611012,673,Place two cheese tablets in a trap and try to take them in the morning.
2038,4435,0,0,15,15,1.0,0.06900655593423542,673,"Now be careful, this cheddar has been known to be quite addictive."
341,4435,0,0,15,15,1.0,0.06900655593423542,673,Here's the referral.  He'll be in sheep's clothing.
342,4435,0,0,19,19,1.0,0.05407380704358751,673,"If you insist, but remember-I've been carrying bubonic plague for years."
466,4435,0,0,15,15,1.0,0.06900655593423542,673,"I added a prescription for rabies vaccinations ... you know, just in case."
474,4435,0,0,15,15,1.0,0.06900655593423542,673,"If this final treatment does not gain the desired results, you can still live a  fruitful life among people of your own kind."
476,4435,0,0,15,15,1.0,0.06900655593423542,673,"Don't worry I just write the scrips, I don't touch the pills."
526,4435,0,0,15,15,1.0,0.06900655593423542,673,What? You were expecting something from a pharmacy? It’s my cousin’s pizza joint.
279,4435,0,0,15,15,1.0,0.06900655593423542,673,"Here I,'m giving you this coupon for ice cream it's a gift saying ""we are sorry you are no welcome because you ears GET OUT"
552,4435,0,0,19,19,1.0,0.05407380704358751,673,You have to stop thinking I'm your son. It's not healthy.
563,4435,0,0,18,18,1.0,0.05716619504750295,673,"Yes, unfortunately for you the plague is still around. Here's the number of a lawyer to help you get your affairs in order."
600,4435,0,0,14,14,1.0,0.07412493166611012,673,We can meet in the woods.  Wear your red hood.
664,4435,0,0,14,14,1.0,0.07412493166611012,673,This Rx will cover the pre-op therapy to treat your species dysphoria. Many humans are happier as rats.
684,4435,0,0,14,14,1.0,0.07412493166611012,673,You seem skeptical. Why is that?
739,4435,0,0,14,14,1.0,0.07412493166611012,673,Here. Take two aspirins and call me in the morning.
787,4435,0,0,15,15,1.0,0.06900655593423542,673,Don't worry. I won't tell anyone what I prescribed you.
554,4435,0,0,14,14,1.0,0.07412493166611012,673,I've invited several colleagues to examine you tonight at 8 in the clearing in the forest.  Have some form of I.D. on you.
809,4435,0,0,16,16,1.0,0.06454972243679027,673,William Kotzwinkle owns a lot to this prescription.
275,4435,0,0,16,16,1.0,0.06454972243679027,673,"If  this ginkgo biloba and 'Luminosity' don't help, try running through a maze once in a while."
242,4435,0,0,14,14,1.0,0.07412493166611012,673,You smell what?!
3,4435,0,0,16,16,1.0,0.06454972243679027,673,"yeah the test came back positive, you definitely have that disease that makes doctors look like rats, sorry dude"
25,4435,0,0,15,15,1.0,0.06900655593423542,673,"Yeah, you look alarmed now but just wait till you get the hospital bill."
27,4435,0,0,14,14,1.0,0.07412493166611012,673,"I regret to say, Mr. Cagney, if I'd washed my hands before performing the surgery, your sister-in-law would not be a widow."
67,4435,0,0,18,18,1.0,0.05716619504750295,673,B’more!
84,4435,0,0,14,14,1.0,0.07412493166611012,673,"[Context: I don’t know what animal this is but I think it’s fair to call it a rat— you wouldn’t see a rat joke and think “But that is not a rat!,” and I know mice are connected to cheese, but rats are sorta mice, so they like cheese] “Cheese louise!”"
93,4435,0,0,16,16,1.0,0.06454972243679027,673,Take one a day and try to avoid  sinking ships.
263,4435,0,0,14,14,1.0,0.07412493166611012,673,I am putting you on a hard cheese diet.
132,4435,0,0,14,14,1.0,0.07412493166611012,673,"This prescription will make your cat stop biting, side affects will include sluggishness and an increased mouse population."
139,4435,0,0,15,15,1.0,0.06900655593423542,673,I worked my way up from researchee.
148,4435,0,0,14,14,1.0,0.07412493166611012,673,Consider me an expert in how diseases spread.
157,4435,0,0,15,15,1.0,0.06900655593423542,673,What do you see?
178,4435,0,0,17,17,1.0,0.06063390625908324,673,Take this and you'll never see a rat again
191,4435,0,0,15,15,1.0,0.06900655593423542,673,You're not lactose intolerant are you?
238,4435,0,0,21,21,1.0,0.048795003647426664,673,Dr. Vermin and I concur; this medication does not cause hallucinations.
136,4435,0,0,15,15,1.0,0.06900655593423542,673,Tell the pharmacist Morty The Rat sent you.
811,4435,0,0,15,15,1.0,0.06900655593423542,673,"Here are your results from the racial equality testing. While you are here in Baltimore, we are unable to treat you. It's better if you went back to wherever..."
815,4435,0,0,16,16,1.0,0.06454972243679027,673,"Works great, made my wife into a real pussy cat"
841,4435,0,0,14,14,1.0,0.07412493166611012,673,I like cheese.
1597,4435,0,0,16,16,1.0,0.06454972243679027,673,"Dammit, Jerry. You know the rules: if you're not up to date on your shots, I simply can't issue a license OR release you."
1604,4435,0,0,23,23,1.0,0.044455422447438706,673,Take two Greenies and call me in the morning!
1605,4435,0,0,16,16,1.0,0.06454972243679027,673,Here's your Flea - b- gone. I can't do anything for the hallucinations; you'll have to wait until next week to see a therapist.
1606,4435,0,0,21,21,1.0,0.048795003647426664,673,IT'S A RECIPE FOR TOSSED-INTERACTIVE-SIDE-EFFECTS-SALAD DRESSING
1617,4435,0,0,15,15,1.0,0.06900655593423542,673,"Thank you for not tweeting about your infestation, and to show our appreciation, here are a couple of tickets to a Baltimore Rats game."
1744,4435,0,0,16,16,1.0,0.06454972243679027,673,Take two tablespoons of Cheez Whiz every six hours and get back to me after the weekend.
1552,4435,0,0,16,16,1.0,0.06454972243679027,673,"So the kid goes like, ""What chair, man?"", cracker?"
1756,4435,0,0,16,16,1.0,0.06454972243679027,673,Here's your ticket to the Human Maze...enjoy!
1785,4435,0,0,14,14,1.0,0.07412493166611012,673,Let’s be clear. I don’t bulk bill. Now get out or I’ll Black Plague your arse.
1798,4435,0,0,19,19,1.0,0.05407380704358751,673,It's called the Pizza Diet and look what it has done for the President.
1823,4435,0,0,17,17,1.0,0.06063390625908324,673,Take three times a day with meat
1913,4435,0,0,16,16,1.0,0.06454972243679027,673,"No, the diplomas aren't from Johns Hopkins in Baltimore."
1919,4435,0,0,14,14,1.0,0.07412493166611012,673,Eat 10 of these and let's see if any new lumps develop.
1986,4435,0,0,15,15,1.0,0.06900655593423542,673,It was tested on me and my extended family
1777,4435,0,0,16,16,1.0,0.06454972243679027,673,"I'm sorry to tell you that you only have about 6 months to live,
unless I eat you now."
1515,4435,0,0,15,15,1.0,0.06900655593423542,673,It's a necessary and perfectly legitimate 30 day refill for your opioid Mr. Jones. The disguise is because I don't want you to be able to pick me out of a line-up ... that's how crazy the DEA has gotten.
1440,4435,0,0,16,16,1.0,0.06454972243679027,673,The APR? It's only 502%
1433,4435,0,0,14,14,1.0,0.07412493166611012,673,Take it with plenty of peanut butter.
881,4435,0,0,14,14,1.0,0.07412493166611012,673,"Take this to the lab, and tell them you are my replacement."
898,4435,0,0,16,16,1.0,0.06454972243679027,673,What do you take me for -- this expired 40 years ago!
912,4435,0,0,16,16,1.0,0.06454972243679027,673,Relax. In a few days you'll start feeling like you're Brad Pitt...even though you'll look like Bela Lugosi.
1010,4435,0,0,15,15,1.0,0.06900655593423542,673,Why would you think I'm from Baltimore?
1033,4435,0,0,15,15,1.0,0.06900655593423542,673,Here's your sick note for work. What do you mean about 'ratting you out?'
1051,4435,0,0,15,15,1.0,0.06900655593423542,673,This should help you look at me as I am and the world as is.
1063,4435,0,0,16,16,1.0,0.06454972243679027,673,Fill it at a pet store. It will help control your animal hallucinations.
1083,4435,0,0,15,15,1.0,0.06900655593423542,673,This is the fifth time you've visited my office about your airplane anxiety. Do you actually need this or do you just like staring into my beady eyes?
1171,4435,0,0,16,16,1.0,0.06454972243679027,673,"You'd think his handwriting would be even worse, but somehow, it's better."
1194,4435,0,0,16,16,1.0,0.06454972243679027,673,"Take these, but only one at a time..”"
1228,4435,0,0,18,18,1.0,0.05716619504750295,673,"Who says you don't need opioids?  Besides, the first bottle's free."
1231,4435,0,0,15,15,1.0,0.06900655593423542,673,Lactase - take this before any deadly dish. I swear by this stuff.
1304,4435,0,0,15,15,1.0,0.06900655593423542,673,It's a new drug but the lab research conducted and my sitting here has proved it quite effective
1361,4435,0,0,16,16,1.0,0.06454972243679027,673,"Like I said I'm Doctor Rat.
Call  me if you have any other questions about your results."
1412,4435,0,0,14,14,1.0,0.07412493166611012,673,"What I’m prescribing here is perfectly safe. This stuff has been through extensive testing, believe me."
2043,4435,0,0,20,20,1.0,0.051298917604257706,673,"Warfarin is good for you, in moderation."
4576,4435,0,0,15,15,1.0,0.06900655593423542,673,Take two hundred of these and call me in the morning.
