target_id,rank,funny,somewhat_funny,unfunny,count,score,precision,contest,caption
27,1,5729,5145,4026,14900,2.114295302013423,0.006562439574042058,688,Going up?
4070,2,4323,3844,4358,12525,1.9972055888223552,0.007439128059714996,688,"Sir, I believe the announcement was actually 'prepare for lunch.'"
2795,3,4052,4666,4617,13335,1.9576302962129735,0.006972801444776638,688,"Go ahead, it's just one small step."
312,4,3277,3933,3964,11174,1.9385179881868624,0.0075934593181428865,688,Shall I call you a shuttle?
1216,5,714,1182,887,2783,1.9378368666906216,0.014331675281097996,688,"I can only get you to the penthouse. After that, you’re on your own."
1431,6,3193,3707,4173,11073,1.9114964327643817,0.007705452034978577,688,"Sir, I have a feeling you’re at the wrong Kennedy center..."
3924,7,3464,2587,4413,10464,1.909308103975535,0.008435634756209051,688,This is Trump Tower—we are all going down.
946,8,1455,2506,2120,6081,1.890642986350929,0.009732759479466477,688,Can I assume you’re going to the launch party?
1109,9,1805,2620,2761,7186,1.8669635402170888,0.009272068570067096,688,"Yeah sure. 10, 9, 8, 7..."
3407,10,2673,3387,4184,10244,1.8524990238188208,0.007951397911904391,688,"Look buddy, small step, giant leap, either way - it's the 5th floor."
4636,11,1942,2075,3171,7188,1.8290205898720089,0.009741978543727976,688,I know you’re in there Mrs. Nusbaum and I still expect my Christmas bonus.
3904,12,1622,2015,2774,6411,1.8203088441740758,0.010096318877287316,688,"If you're searching for intelligent life, try another building."
534,13,1362,2152,2796,6310,1.7727416798732172,0.009811245186968515,688,A Russian gentleman went up before you.
324,14,820,1506,1751,4077,1.7716458180034338,0.011913009756639052,688,The Apollo? It’s two blocks down on the right.
3319,15,791,1255,1639,3685,1.7698778833107192,0.01283057911623488,688,Well maybe she misunderstood when you said you needed space.
1784,16,1659,2561,3484,7704,1.763110072689512,0.00890950397355286,688,"I heard the food and service was great, but the place has no atmosphere."
1788,17,409,886,957,2252,1.7566607460035524,0.015593656564930149,688,"Watch the small step, sir."
5017,18,1113,1986,2538,5637,1.7472059606173496,0.010177454177551809,688,"Yes, I guess they do say, ""Dress for the job you want, not the job you have."""
1269,19,733,1543,1829,4105,1.733008526187576,0.011606281524649513,688,"Once again, we have touched down safely, Sir."
2393,20,1425,2241,3311,6977,1.7296832449476853,0.009318296632026785,688,"Lift Off"" just means that the elevator is out of service."
478,21,989,1140,2216,4345,1.7176064441887227,0.0123063577385178,688,My mother in law sucks all the oxygen out of the room.
1487,22,720,1454,1900,4074,1.7103583701521845,0.011717376556306695,688,Getting away for the holidays are we sir?
658,23,321,909,996,2226,1.696765498652291,0.014986031579165863,688,Let me guess......up?
2615,24,1147,1783,2996,5926,1.6879851501856227,0.010077917912217191,688,It's not impossible that Mr. Trump has somewhat exaggerated the height of his tower...
291,25,1309,2624,3767,7700,1.6807792207792207,0.00850814172188866,688,When I said the lobby lacks atmosphere I didn’t   mean it literally.
992,26,1167,1722,3113,6002,1.675774741752749,0.010065388754308267,688,"To bed, bath and beyond !"
91,27,424,741,1276,2441,1.6509627201966408,0.015345860554675581,688,"That’s funny. When I was  a kid, I wanted to be an elevator operator."
4040,28,709,1480,2286,4475,1.6475977653631284,0.011037855049137128,688,"Hold your mail again, Sir?"
401,29,928,2033,3066,6027,1.6452629832420773,0.00943866108593401,688,Would you need me to call you a shuttle?
3944,30,1403,2045,4145,7593,1.6388779138680363,0.00889186758593212,688,Three..two..one..
1306,31,759,1313,2390,4462,1.6344688480502017,0.011324762188105327,688,It’d be a lot easier for all of us if you’d just get the vaccination”
1116,32,879,1610,2873,5362,1.628123834390153,0.010233671858262208,688,"First step, Mankind.  Second step, Menswear."
4199,33,580,1366,2085,4031,1.6266435127759862,0.011378129786145755,688,"I'm sorry, sir, but the best I can do is the 78th floor."
3865,34,145,343,525,1013,1.6248766041461007,0.022682814941259427,688,"Ground floor, Mr. Brown. Oops, I mean 'the Eagle has landed'."
369,35,534,880,1755,3169,1.614704954244241,0.013458897453334,688,"Houston, The Otis has landed."
5222,36,755,1190,2485,4430,1.6094808126410836,0.0114324242840714,688,"Sir, it's still not too late for a flu shot."
1985,37,216,506,818,1540,1.6090909090909091,0.018357128879112335,688,"787,234th floor, please."
2391,38,711,1579,2638,4928,1.608969155844156,0.010339094640957872,688,After the top floor you're on your own.
2674,39,603,1427,2355,4385,1.6004561003420752,0.010837816898769774,688,"Go ahead sir, it's only one small step."
2620,40,564,704,1816,3084,1.5940337224383918,0.014030646382838893,688,... in case it DOESN’T stop at the penthouse ??
3952,41,580,648,1826,3054,1.5920104780615587,0.01426624155224637,688,"Psychiatry - 5th floor, huh? Me too !"
4868,42,307,637,1173,2117,1.5909305621162022,0.015852651775158447,688,"I think that you misunderstood the ""Space Available"" sign"
3472,43,404,1010,1707,3121,1.5825056071771868,0.012685599115552278,688,"Sorry, we don't go to where no man has gone before. We stop at 18."
4080,44,118,282,498,898,1.576837416481069,0.02377200904778552,688,You do know the Moon Room is just a bar ?
1267,45,319,869,1447,2635,1.5719165085388995,0.013596769975079036,688,Take one small step off the elevator please sir.
3877,46,301,693,1307,2301,1.562798783137766,0.014857024295450046,688,"After I release the emergency brake, you’ll have 12 seconds of weightlessness."
4529,47,326,624,1318,2268,1.562610229276896,0.015341401028023921,688,"Otis, we have a problem."
3148,48,222,665,1101,1988,1.5578470824949697,0.015379673303589638,688,Doors closing in T-minus 3.
4731,49,275,488,1108,1871,1.5547835382148583,0.01700832153829315,688,"Major Tom is on vacation this week,sir.  I'm Larry."
301,50,180,546,952,1678,1.5399284862932061,0.016614949629800233,688,You look like you're on a mission.
3137,51,204,500,978,1682,1.539833531510107,0.017090264278468145,688,"For the last time, Tom, it's just a lobby and I'm not 'Ground Control'."
617,52,178,530,939,1647,1.537947783849423,0.0168025945189481,688,I see you're taking the shuttle to work again today.
4446,53,203,450,943,1596,1.536340852130326,0.017759545225946187,688,"Happy to do it, sir. 10…9…8…7…"
3326,54,187,439,898,1524,1.5334645669291338,0.018015222040054908,688,Have you considered just getting a flu shot?
5221,55,179,450,886,1515,1.5333333333333334,0.017901693226557026,688,"Sure, if it’s not the right stuff, you can return it."
3533,56,101,244,503,848,1.525943396226415,0.02399169689513374,688,""" Having a hard time adjusting to your retirement from NASA, sir?"
5064,57,158,378,789,1325,1.5237735849056604,0.01919697119194752,688,Please watch your small step.
3937,58,154,305,728,1187,1.5164279696714407,0.02072073601567112,688,Psychiatry ? 2nd floor. I’m on my way there too.
3581,59,140,326,709,1175,1.5157446808510637,0.020389102071337113,688,I’m not sure how you’ll manage but the men’s room is two doors down on your left.
687,60,135,294,669,1098,1.5136612021857923,0.021257526114266567,688,Heading up to the satellite office?
641,61,128,240,619,987,1.502532928064843,0.02272878763012296,688,My mother-in-law sucks all the air out of the room
1702,62,98,285,577,960,1.5010416666666666,0.021761949879601214,688,Menswear?
3902,63,106,235,560,901,1.4961154273029966,0.023220657176603685,688,"I don’t care if it’s a small step or a giant leap, you just need to exit the elevator, sir."
3359,63,107,233,561,901,1.4961154273029966,0.0232737043694495,688,"There’s no countdown.
 Just tell me what floor you want."
2116,65,93,257,545,895,1.4949720670391062,0.022629096436362565,688,I don’t think you fully understand the gravity of the situation.
2991,66,97,247,547,891,1.494949494949495,0.022924090091319394,688,Sorry...I just kind of assumed you were going up.
3763,67,102,212,529,843,1.4934756820877817,0.0241715542127896,688,Your here to repair the satellite dish?
4232,68,101,220,541,862,1.4895591647331787,0.023715055863999888,688,Does he know you're coming? Should I buzz Aldrin?
1972,69,88,228,510,826,1.4891041162227603,0.023688799047277675,688,Like they always say: Dress for the job you want.
480,70,90,214,505,809,1.4870210135970334,0.024177777408034073,688,Elevator has landed
2667,71,80,220,485,785,1.484076433121019,0.024052665856026032,688,"I'm afraid we don't go that high, sir."
4599,71,66,248,471,785,1.484076433121019,0.023087547063582212,688,I take it you're going up?
5211,73,131,112,531,774,1.483204134366925,0.02758543569471759,688,Isn't it early for Fashion Week?
5103,74,70,223,462,755,1.480794701986755,0.02402092423699481,688,"Going to the launch party, sir?"
4786,75,87,181,472,740,1.4797297297297298,0.025610918554913143,688,"I dress for the job I want, not the job I have."
2590,76,75,200,457,732,1.4781420765027322,0.024933297169703956,688,"Let me guess, you’re going up"
910,77,84,179,463,726,1.477961432506887,0.025755327810940733,688,"Sir, the StarLight Lounge requires a tie."
3298,78,70,182,423,675,1.477037037037037,0.02603581503048703,688,Always great to meet a fellow gravity denier.
4755,79,65,199,430,694,1.4740634005763689,0.025101444326328465,688,"Mission Control or the costume party on 11, sir?"
911,80,57,214,422,693,1.4733044733044733,0.02445325590803351,688,"I’m sorry sir, the twelfth floor is as close as I can get you."
4457,80,71,186,436,693,1.4733044733044733,0.025619310414765492,688,You should go to the bathroom first.
3873,82,66,192,427,685,1.472992700729927,0.025419616904218446,688,"Sorry, you can't get there from here."
3139,83,69,181,427,677,1.4711964549483014,0.025886953502413455,688,They sent me down for more Tang.
3316,84,72,167,423,662,1.4697885196374623,0.026569064087999368,688,"I'm sorry, I just assumed you'd want to go up."
1573,85,76,150,420,646,1.4674922600619196,0.0273999197783915,688,I push buttons and a machine goes as high as I tell it to. It’s basically the same job.
2343,86,70,158,411,639,1.4663536776212833,0.027082836377818206,688,Caught between the moon and New York City I see.
3568,87,64,160,397,621,1.463768115942029,0.027084289375902026,688,"Fly Me to the Moon"" is the name of our penthouse bar, sir"
1103,88,70,148,404,622,1.4630225080385852,0.0276192495983169,688,"I'd be happy to count down from ten, sir, but I draw the line at making rocket noises."
1398,89,56,169,384,609,1.4614121510673235,0.026668623883169797,688,"I know, but it's the best that I can do while I'm caught between the moon and New York City."
1775,90,57,164,382,603,1.4610281923714759,0.026959300091541478,688,"Top floor! Sorry, this is as close as I can get you."
2576,91,61,155,385,601,1.4608985024958403,0.02743070302940362,688,"I am sorry, sir.  This is the lift up. Not the lift off."
1933,92,59,157,382,598,1.459866220735786,0.027323782735516437,688,"I think you misunderstand what they mean by, “space available.”"
1323,93,82,107,401,590,1.459322033898305,0.029892603600754224,688,The elevator refuses to move. It says you killed HAL.
1996,94,61,146,378,585,1.458119658119658,0.027967478836147038,688,"Small step, giant step. Just step out of the elevator, sir."
1695,95,53,156,365,574,1.456445993031359,0.02748224996009486,688,How was your walk Mr. Armstrong?
3377,96,49,129,320,498,1.4558232931726907,0.02991724222972995,688,"Yes, the rent is astronomical."
967,97,58,139,365,562,1.4537366548042705,0.028455970205901293,688,"The 19487167th  floor, please"
662,98,58,130,357,545,1.4513761467889907,0.029094159940441722,688,Earth disappoints me on so many levels.
2354,98,55,136,354,545,1.4513761467889907,0.028744263599207533,688,"Yessir, there's space on the 12th floor."
5137,98,57,132,356,545,1.4513761467889907,0.02897799725734875,688,"So you want me to press 10, 9, 8, 7, 6, 5, 4, 3, 2 and 1 in that order?"
1795,101,50,140,344,534,1.449438202247191,0.028558534807296886,688,Dress for the job you want
3524,101,52,136,346,534,1.449438202247191,0.028803535160452743,688,Welcome to the Apollo.
2832,103,56,126,349,531,1.448210922787194,0.029404167291466783,688,"If you’re interested in space, I’d recommend the three bedroom."
1725,104,43,151,335,529,1.448015122873346,0.02786155100953777,688,I can get you as far as 10. You're on your own from there.
2849,105,87,58,375,520,1.4461538461538461,0.033478949079488396,688,I'm working my way up to the Vomit Comet.
2108,106,44,139,327,510,1.4450980392156862,0.028709465122885903,688,"Going out to launch, Sir?"
509,107,46,133,327,506,1.4446640316205535,0.029137982167532245,688,"Mind the giant leap, sir."
2141,108,47,128,326,501,1.4431137724550898,0.029475030368592014,688,"500,000,012 please."
4754,109,44,131,320,495,1.4424242424242424,0.029312735411806613,688,"I believe they were advertising work space, not space work."
4521,110,40,135,313,488,1.4405737704918034,0.029029580236339,688,"Sir, would you like me to call a shuttle?"
4687,111,57,101,331,489,1.4396728016359919,0.03134581911533052,688,"No Sir, Trump is still President."
2232,112,63,88,336,487,1.4394250513347022,0.03223682858531611,688,"Got as far as the stratosphere and couldn't remember 
if I turned off the stove."""
4657,113,42,127,312,481,1.4386694386694387,0.029611186543371745,688,Welcome back sir. Long trip?
1418,114,45,118,312,475,1.4378947368421053,0.03031538233496687,688,Another book signing Mr. Aldrin?
41,115,43,119,308,470,1.4361702127659575,0.030240841418399337,688,"One too many small steps for man today, sir?"
1434,116,36,130,298,464,1.4353448275862069,0.02942913010345905,688,"Sir, I think you may be at the wrong 'launch party'."
4279,117,48,104,308,460,1.434782608695652,0.03146538520866667,688,"Should I call you a shuttle, sir?"
4719,118,42,115,301,458,1.4344978165938864,0.03064284187569988,688,"Yes, I'm going up. How did you know?"
464,119,41,114,298,453,1.4326710816777042,0.030717175058517694,688,This is as far as NASA's budget will take you.
939,120,45,105,301,451,1.4323725055432373,0.031446005328833314,688,Shall I hold your mail?
1114,121,41,112,296,449,1.4320712694877507,0.03090934866135467,688,One small step for man is as high as we go. The giant leap for mankind is the next car.
4806,122,35,125,292,452,1.4314159292035398,0.029787253106079853,688,This is the headquarters.  You’ll want the satellite office.
4571,123,44,106,300,450,1.431111111111111,0.031333036726742564,688,"I assure you, sir, I go to the one-hundred thirty-first floor all the time dressed just as I am."
1006,124,34,120,284,438,1.4292237442922375,0.030263596455740824,688,"Yes, sir.  I believe the cafe serves Tang."
2666,125,35,117,284,436,1.4288990825688073,0.030531503167156162,688,"The Eagle has landed.  Enjoy your day, sir."
612,125,52,83,301,436,1.4288990825688073,0.03333827904570305,688,"You can take that off, sir.  Melania is not here."""
1811,127,42,101,289,432,1.4282407407407407,0.03192563332190383,688,"Are we going to the moon again today, sir?"
4264,127,42,101,289,432,1.4282407407407407,0.03192563332190383,688,"This is Ground Floor, Major Tom....and you're stepping thru the door..."
3793,129,44,98,293,435,1.4275862068965517,0.032094872795770515,688,The sign in the window says Space for Rent.
3636,130,48,89,296,433,1.4272517321016167,0.03285830608553381,688,"Trump's penthouse? No problem. However, I think the president exaggerated how big the building really is."
4651,131,29,126,277,432,1.4259259259259258,0.02964493245799821,688,Go on! It's just one small step!
3393,132,33,114,276,423,1.425531914893617,0.030806031026704515,688,"I've heard that the restaurant upstairs is good, but that it has no atmosphere"
1799,132,39,102,282,423,1.425531914893617,0.031878459478511784,688,"The Apollo is at 253 West 125th Street, Sir."
2247,132,33,114,276,423,1.425531914893617,0.030806031026704515,688,Would you like me to call the shuttle for you?
3010,132,33,114,276,423,1.425531914893617,0.030806031026704515,688,"Shall I call the shuttle, sir?"
879,136,32,113,272,417,1.4244604316546763,0.030922164685630346,688,"Well, yes, naming it the “Space Needle” may have been a little misleading."
3576,137,44,91,287,422,1.4241706161137442,0.03279464320382394,688,Are you from NASA or the EPA?
4569,137,38,103,281,422,1.4241706161137442,0.03174814380155029,688,So I guess your wife loves a man in uniform too.
5026,139,37,101,276,414,1.422705314009662,0.03199460808350714,688,"It's just one small step to exit the elevator, sir."
2750,140,42,89,279,410,1.421951219512195,0.03312517699892202,688,Forgot my keys.
1939,141,36,96,268,400,1.42,0.03258303447099957,688,I don’t know that we go that high.
2940,141,29,110,261,400,1.42,0.031207929074078787,688,"If this were a New Yorker cartoon, I'd ask if you were going up."
2801,141,39,90,271,400,1.42,0.03315491095299084,688,Someone took your budget to build a wall?
2532,144,39,91,273,403,1.4193548387096775,0.032972351792515994,688,"It’s one small step, sir"
4528,145,35,97,267,399,1.418546365914787,0.03243872855887593,688,"Due to NASA funding cuts, this is as far as you go."
292,146,31,101,259,391,1.4168797953964194,0.03209196746382625,688,"The store is closing, sir. That'll have to be your last ride of the day."
314,147,34,100,269,403,1.4168734491315136,0.03200685824578515,688,From out of town?
1375,148,36,88,261,385,1.4155844155844155,0.03345889098178766,688,"The Apollo is a nightclub, sir."
3901,148,29,102,254,385,1.4155844155844155,0.032012504057542614,688,I am afraid you don't understand the gravity of the situation.
613,150,31,97,255,383,1.4151436031331592,0.032547962493718406,688,Lunch hour? I thought the schedule said launch hour
1728,151,35,89,260,384,1.4140625,0.033307900283665,688,"No, it's pretty much a small step for everybody."
4260,151,44,71,269,384,1.4140625,0.035097083286921855,688,"Fortunately, NASA comped me the room after it canceled my flight."
3445,153,34,98,270,402,1.4129353233830846,0.03203699431658938,688,"Touchdown sir.
Have a nice day."
3340,154,30,105,265,400,1.4125,0.03135789644049697,688,Your son’s class will definitely be impressed.
1937,155,34,86,254,374,1.411764705882353,0.033716715876019425,688,"Sir, would you like me to hail you a rocket?"
536,156,36,78,252,366,1.4098360655737705,0.03466440977742108,688,"Remember, the President uses up all the air in 10 minutes."
5167,156,31,88,247,366,1.4098360655737705,0.033567326417649986,688,"Yeah yeah, I've heard it all before ... One giant step...etc. Just get out."
461,158,31,90,250,371,1.4097035040431267,0.03324611116388306,688,"To infinity, or beyond?"
1296,158,34,84,253,371,1.4097035040431267,0.033897099952547735,688,"Fourth floor, compression socks, catheters."
975,160,30,89,246,365,1.4082191780821918,0.03339572266369705,688,Excuse me sir. I think you misunderstood - I said we were out of  space
3314,160,31,87,247,365,1.4082191780821918,0.033620346993175766,688,I'm not sure that's what they meant when they said there was space in the elevator
692,162,27,89,237,353,1.405099150141643,0.03345486838406389,688,"I think you’re at the wrong Apollo, sir."
792,162,26,91,236,353,1.405099150141643,0.033213437286439586,688,The elevator has landed.
4888,162,30,83,240,353,1.405099150141643,0.034168927774213,688,"Well, it's pretty much the same size step for everyone, sir."
1151,165,30,82,239,351,1.4045584045584045,0.034302481076435846,688,"Yes, I heard the food is is great but the restaurant has NO atmosphere"
2251,165,20,102,229,351,1.4045584045584045,0.031841169030032125,688,"Wait, don't tell me . . . going up?"
1132,165,23,96,232,351,1.4045584045584045,0.0325990811839709,688,"Just one small step, sir."
4914,168,30,79,236,345,1.4028985507246376,0.03471161725087405,688,"Watch your step, the last guy made a big deal out of it."
2103,168,25,89,231,345,1.4028985507246376,0.03347590441926138,688,"This is ground floor control, Major Tom."
3181,170,26,84,229,339,1.40117994100295,0.03412589493476356,688,"What time should I expect you for re-entry, Sir"
1164,171,29,84,241,354,1.4011299435028248,0.03383288876443872,688,"You know we're going down, right?"
962,172,26,82,228,336,1.3988095238095237,0.03431732482225223,688,I don't think we go that high.
170,173,31,70,231,332,1.3975903614457832,0.03588582321479655,688,"Let me guess, going up?"
2786,173,34,64,234,332,1.3975903614457832,0.03663865948284385,688,Oh no sir. Fake moon landings are on the 63rd floor at Trump Tower. This is the Ted Cruz's father/ Kennedy assassination floor.
5297,173,35,62,235,332,1.3975903614457832,0.03688619058218357,688,"What a long, strange trip it's been."
4371,176,24,83,223,330,1.396969696969697,0.03420123276329327,688,Then just take me as close as you can.
241,177,35,60,233,328,1.396341463414634,0.03720632373412246,688,Sharon and I broke up. I told her I needed some space.
3903,177,27,76,225,328,1.396341463414634,0.035144483523359415,688,"Scene from Kubrick's lesser known film ""2001: A Space Lobby."""
3805,179,32,65,229,326,1.3957055214723926,0.0366035593121578,688,"Shall I try to call a shuttle for you, sir?"
1858,179,25,79,222,326,1.3957055214723926,0.03475173022266944,688,"I'm sorry, sir, but the highest we can go is the penthouse."
843,179,31,67,228,326,1.3957055214723926,0.03634478952512828,688,"I couldn’t do what you do, being stuck in a small spaces all day."
802,179,27,75,224,326,1.3957055214723926,0.035290741149127995,688,"Yet another perfect landing, sir."
605,179,29,71,226,326,1.3957055214723926,0.0358216424559276,688,"Don’t dress for the job you have, dress for the job you want."
530,179,28,73,225,326,1.3957055214723926,0.03555718267168443,688,"He's in Florida, Sir, there will be enough oxygen."
137,185,24,80,220,324,1.3950617283950617,0.034620280179291155,688,"Is she aware of the  gravity of your situation,  Sir?"
1009,185,26,76,222,324,1.3950617283950617,0.035167964344549586,688,"Watch that one small step, sir."
1615,185,24,80,220,324,1.3950617283950617,0.034620280179291155,688,Forgot my gloves.
1765,185,24,80,220,324,1.3950617283950617,0.034620280179291155,688,"It’s pronounced “How-stan,” sir, and we do not have a problem."
2223,185,32,64,228,324,1.3950617283950617,0.036762092778841945,688,You're going to be disappointed.
2955,185,32,64,228,324,1.3950617283950617,0.036762092778841945,688,I hear there's space available in this building.
3502,185,30,68,226,324,1.3950617283950617,0.03623850919992836,688,"Welcome back, Mr. Bowie, we've missed you."
4539,192,23,82,220,325,1.393846153846154,0.03425890091087293,688,"Welcome home, sir. Long trip?"
2606,193,28,68,219,315,1.3936507936507936,0.03641881399791704,688,"59,726,538 please"
789,194,29,69,225,323,1.3931888544891642,0.03603646973726347,688,How's that mold situation in your apartment?
632,194,30,67,226,323,1.3931888544891642,0.03630229759880252,688,Hit the space bar.
1285,196,25,74,217,316,1.3924050632911393,0.035485350328317664,688,"You know what, I'll just press the button for the top floor."
3658,196,30,64,222,316,1.3924050632911393,0.03687373338437561,688,"Concierge, we have a problem..."
180,198,23,77,214,314,1.39171974522293,0.0350614340668547,688,"Sir, I think you may have  misunderstood our courtesy shuttle system..."
500,198,31,61,222,314,1.39171974522293,0.03731086984653874,688,I'm not kidding. This is as high as it goes.
770,198,28,67,219,314,1.39171974522293,0.036483587954037576,688,To the moon sir?
850,198,29,65,220,314,1.39171974522293,0.036761417222886214,688,"To your penthouse, Mr. Branson?"
2311,198,26,71,217,314,1.39171974522293,0.03592148350959015,688,"Elon, are you high again?"
2412,198,30,63,221,314,1.39171974522293,0.037037162451654344,688,"Excuse me Sir, was that 1 step up or down for Mankind"
3334,198,25,73,216,314,1.39171974522293,0.03563710666278391,688,"Third floor, moon landing and flat earth conspiracies, please watch your step. 
Next floor, UFO’s and Area 51."
1012,205,30,62,220,312,1.391025641025641,0.03720250836000105,688,Can you take me back up? I forgot the flag.
592,205,26,70,216,312,1.391025641025641,0.03607741122213871,688,You seem prepared for the gravity of the situation upstairs.
310,207,20,82,211,313,1.389776357827476,0.034233655835564245,688,"Up, I presume?"
1829,207,22,78,213,313,1.389776357827476,0.03482676121498711,688,"It's a great building sir, just no atmosphere"""
2608,207,30,62,221,313,1.389776357827476,0.03710449724975672,688,"Venturing north of 23rd street again today, sir?"
3081,207,22,78,213,313,1.389776357827476,0.03482676121498711,688,I can assure you sir that the restaurant has great atmosphere
1818,211,34,53,224,311,1.3890675241157557,0.038367640241151774,688,So now everybody knows you live in the penthouse. Happy?
2262,211,22,77,212,311,1.3890675241157557,0.03497340397209913,688,"I'm sorry sir, Space Needle is just the name of the building"
3347,211,23,75,213,311,1.3890675241157557,0.03526873575022039,688,Should I call for a shuttle?
4126,214,24,72,213,309,1.3883495145631068,0.035715050800172815,688,"The hotel does offer shuttle services, sir. 
I’m just not sure if that’s what you had in mind."
4189,214,25,70,214,309,1.3883495145631068,0.03600804684761873,688,"Indeed sir, we've all had to lower our expectations a bit."
3964,216,24,70,210,304,1.388157894736842,0.03612346267389808,688,Do you want me to countdown?
4671,216,16,86,202,304,1.388157894736842,0.033633361040314176,688,"Here's the lobby, sir.  I'm sure the concierge can help you find a store that sells Tang."
3922,216,26,66,212,304,1.388157894736842,0.03671961261674208,688,Excuse me… I…I don't think this elevator goes as high as you're expecting.
2830,216,29,60,215,304,1.388157894736842,0.037596117399011406,688,Down to the parking garage. I’ve changed my mind.
2471,216,24,70,210,304,1.388157894736842,0.03612346267389808,688,The fake moon landing reunion? It’s in our Area 57 Ballroom.
1086,216,15,88,201,304,1.388157894736842,0.03330901195296215,688,"Up to the sky lounge, Sir?"
32,216,24,70,210,304,1.388157894736842,0.03612346267389808,688,"Uh Houston, we’ve got a problem"
21,216,28,62,214,304,1.388157894736842,0.037306237359115965,688,"Yes,of course, as you wish: ten, nine, eight, seven...™"
2995,224,28,61,213,302,1.3874172185430464,0.03747670731287901,688,"You can do it, sir, it's just one small step."
707,225,24,72,214,310,1.3870967741935485,0.035621689480198414,688,I'm positive sir.  The farthest we can go is the penthouse.
739,225,26,68,216,310,1.3870967741935485,0.03620307685463063,688,"I can get you to the penthouse, Mr. Silver, but after that you're on your own."
1120,227,31,56,218,305,1.3868852459016394,0.03806520293012207,688,Funny!  We both work in transportation
2019,227,27,64,214,305,1.3868852459016394,0.03691447408738847,688,I changed my mind
3499,229,32,53,219,304,1.3848684210526316,0.03842059383656533,688,"I'm sorry sir, this elevator only goes up to the Troposphere,"
4039,230,21,73,205,299,1.3846153846153846,0.035575546704817086,688,Nobody’s ever asked me to press that button before.
5003,230,22,71,206,299,1.3846153846153846,0.035889632327699254,688,Is it flu season already?
2650,230,24,67,208,299,1.3846153846153846,0.03650969842602184,688,"Taking off this afternoon, sir?"
1386,233,23,58,190,271,1.3837638376383763,0.03878864152073085,688,off to film another fake moon landing sir?
455,234,21,69,201,291,1.3814432989690721,0.036211743453722384,688,I can get you to the penthouse. From there you’re on your own.
2527,234,21,69,201,291,1.3814432989690721,0.036211743453722384,688,It's 11 small steps to your left.
702,236,25,61,206,292,1.38013698630137,0.03739203172642906,688,I ran out of clean laundry.
375,237,22,65,200,287,1.3797909407665505,0.0368734315351069,688,Watch your small step.
393,237,29,51,207,287,1.3797909407665505,0.03911791276825897,688,"The moon has changed a lot since you were first here."""
1388,237,27,55,205,287,1.3797909407665505,0.03848999017012461,688,I'm looking for the Starlight Ballroom.
3245,237,26,57,204,287,1.3797909407665505,0.038172155627785476,688,Watch your step as you make 'one giant leap for mankind.'
4384,237,20,69,198,287,1.3797909407665505,0.03620660433022388,688,I'm glad you felt that it was a safe landing.
5272,237,26,57,204,287,1.3797909407665505,0.038172155627785476,688,It's just the one small step.
4674,243,24,62,204,290,1.3793103448275863,0.037247477261299886,688,"Sir, I can't take you up to the executive suite without a tie."
3225,244,25,55,198,278,1.3776978417266188,0.038701780161744984,688,"Go ahead, sir. It’s one small step."
4269,245,18,70,193,281,1.3772241992882561,0.03600793472888742,688,And we have touch down.
1172,245,22,62,197,281,1.3772241992882561,0.03739316842938925,688,"3rd floor - robot cranes, trace gas analyzers, titanium bolts, and women's lingerie."
837,247,23,59,197,279,1.3763440860215055,0.03791242117737227,688,"Be careful of the step sir. Some find it small, but for some it's a giant leap."
884,247,25,55,199,279,1.3763440860215055,0.038586569236452525,688,I don’t smell anything.
1101,247,23,59,197,279,1.3763440860215055,0.03791242117737227,688,"Ground floor, Major Tom."
4348,247,15,75,189,279,1.3763440860215055,0.03508653724570364,688,"All the way up, sir?"
3672,251,16,72,189,277,1.3754512635379061,0.035611179137003866,688,"We've landed, sir."
2314,251,21,62,194,277,1.3754512635379061,0.03740263500086349,688,"1,367,890th Floor"""
4872,251,23,58,196,277,1.3754512635379061,0.0380956364325343,688,Can you hit “sky lobby” for me?
402,251,17,70,190,277,1.3754512635379061,0.03597660746407014,688,"Actually, I'm going down."
1127,251,24,56,197,277,1.3754512635379061,0.03843745205259894,688,"Sir, watch your step."
2586,256,23,56,193,272,1.375,0.038586302708015774,688,I've been waiting my whole life for someone to request free-fall.
557,257,21,61,193,275,1.3745454545454545,0.03758146527135214,688,"Here we are sir, the final frontier"
3465,257,15,73,187,275,1.3745454545454545,0.03539928996956406,688,I just needed some space this morning
4828,257,24,55,196,275,1.3745454545454545,0.03862635023838171,688,Your fly is open.
4722,260,21,58,188,267,1.3745318352059925,0.03836709853065096,688,I see you’ve reconsidered the ‘staycation’ idea.
990,261,20,61,189,270,1.374074074074074,0.0376982151435659,688,Will you be leaving us today sir?
4215,261,17,67,186,270,1.374074074074074,0.03658613034304334,688,"I'm sorry, sir, you'll need to take the express elevator or you'll never get past the gravitational pull."
994,263,20,62,191,273,1.3736263736263736,0.037404282404506176,688,"My name's not Houston, and I don't care if you have a problem. What floor?!"
1261,263,20,62,191,273,1.3736263736263736,0.037404282404506176,688,Will you be needing a shuttle?
5307,265,19,62,187,268,1.373134328358209,0.0375113538934226,688,I'm sorry sir -- this is as far as I go...
2870,266,19,63,189,271,1.3726937269372694,0.037218798269696575,688,"Sorry...
This is as high as we can go."
2752,266,12,77,182,271,1.3726937269372694,0.034552911569860054,688,"Going up, obviously."
4503,266,26,49,196,271,1.3726937269372694,0.03970609765925341,688,Perhaps you should have thought about using the bathroom before leaving the Space Station.
1786,266,17,67,187,271,1.3726937269372694,0.03647700277300163,688,"No, this goes only to the Penthouse. You want the "" Where No Man Has Gone Before"" lift."
2733,266,18,65,188,271,1.3726937269372694,0.03684976713591239,688,It's one small step to the lobby; one giant leap to Park Avenue.
5039,266,19,63,189,271,1.3726937269372694,0.037218798269696575,688,Can we skip the countdown just this once?
3320,272,20,63,194,277,1.371841155234657,0.03700664073966587,688,I can take you part of the way.
4196,273,18,64,187,269,1.3717472118959109,0.03702460953597285,688,My other suit's at the cleaners.
1074,274,14,70,180,264,1.371212121212121,0.0359273817824394,688,You could say we’re in the same line of work.
5309,275,21,57,189,267,1.3707865168539326,0.03832033788130671,688,"No, Major Tom. This is the ground floor, not ground control."
1087,276,20,58,187,265,1.369811320754717,0.03813822070933804,688,"I'm going down, actually."
2588,276,19,60,186,265,1.369811320754717,0.03776156927932631,688,Didn’t realize it was that kind of launch party.
3653,276,20,58,187,265,1.369811320754717,0.03813822070933804,688,"Final frontier, please."
1288,279,19,61,188,268,1.3694029850746268,0.037463363600220505,688,"One giant leap to which floor, sir?"
1966,279,23,53,192,268,1.3694029850746268,0.038926907918109946,688,Define UP
4894,281,20,58,188,266,1.368421052631579,0.03802000071754897,688,"If that flying saucer was yours, it got towed.  Would you like me to call you a cab?"
4679,281,21,56,189,266,1.368421052631579,0.03839131768254348,688,Does it look like I'm going down?
4475,281,24,50,192,266,1.368421052631579,0.03948432258404126,688,"Believe it or not, down."
475,281,19,60,187,266,1.368421052631579,0.03764502139357703,688,Working from home?
637,281,26,46,194,266,1.368421052631579,0.040196484517924375,688,"Excuse me commander, this one only goes up to the fifth dimension"
538,281,20,58,188,266,1.368421052631579,0.03802000071754897,688,Good idea—the landlord tends to suck all the oxygen out of his rooms.
3207,281,25,48,193,266,1.368421052631579,0.03984199478891817,688,"I love you to the moon and back, too, sir."
4574,288,13,71,180,264,1.3674242424242424,0.03547121775366606,688,I’ll take you to the 40th floor.  You’re on your own after that.
2406,288,23,51,190,264,1.3674242424242424,0.039322498747893585,688,"Lets’s just say, his elevator didn’t go all the way to the top."
772,288,15,67,182,264,1.3674242424242424,0.03627420037296499,688,Careful.  It's a small step.  Not a giant leap.
2400,288,24,49,191,264,1.3674242424242424,0.03968707685964163,688,"The right stuff?  Third floor, sir."
1062,292,19,57,183,259,1.3667953667953667,0.038326153982786625,688,This will be a disappointment.
1302,292,19,57,183,259,1.3667953667953667,0.038326153982786625,688,I guess you read the review of our rooftop bar that said it had no atmosphere.
2741,292,27,41,191,259,1.3667953667953667,0.04133202365018543,688,Is this where the new Space Force is meeting?
4711,292,14,67,178,259,1.3667953667953667,0.03632138167347521,688,Up? I suppose.
5023,292,19,57,183,259,1.3667953667953667,0.038326153982786625,688,Doors closing in five...four...three...two...
1069,297,19,58,185,262,1.366412213740458,0.03801554790319483,688,"I know letting go is tough sir, but you’ve been retired five years now!"
1993,297,18,60,184,262,1.366412213740458,0.037628904044597115,688,"""I presume you're going up?"""
3874,297,21,54,187,262,1.366412213740458,0.03877727179605739,688,I heard the atmosphere in America is toxic right now.
4878,297,18,60,184,262,1.366412213740458,0.037628904044597115,688,"Good afternoon Elon, you're back from launch break early..."
5347,297,19,58,185,262,1.366412213740458,0.03801554790319483,688,"Yeah, bedbugs sort of weird me out too."
3312,302,21,55,189,265,1.3660377358490565,0.03846213593702533,688,You left the flag WHERE?!
4205,303,27,41,192,260,1.3653846153846154,0.0411969094839832,688,"To your right, sir.  The others are waiting for you."
2911,303,27,41,192,260,1.3653846153846154,0.0411969094839832,688,"Astronaut lingerie please, 6th Floor."
1684,303,24,47,189,260,1.3653846153846154,0.040100938417092134,688,"'Out for a walk, Mr. Armstrong'?"
1998,303,19,57,184,260,1.3653846153846154,0.03820451692445891,688,"When we called it Atmosphere Lounge” it was just a branding exercise, I can assure you."
736,307,22,50,186,258,1.3643410852713178,0.03955684942748351,688,Eleventh Floor. Unrealized childhood dreams department
1802,307,24,46,188,258,1.3643410852713178,0.04031216568564265,688,"Yes sir, Van Allen belts in menswear"
177,309,18,59,184,261,1.3639846743295019,0.03769466732665689,688,"The cosmonauts drove up rates at Trump Tower, so here i am."
3946,309,24,47,190,261,1.3639846743295019,0.03997152241859965,688,I know the sign says “Space for Rent” but...
5051,311,17,60,183,260,1.3615384615384616,0.03736482112453262,688,"Well, if it makes you happy:  Three ... Two ... One ... Liftoff!"
1201,312,20,50,179,249,1.3614457831325302,0.03972918907800451,688,How about two medium steps so I can take my lunch break?
2079,312,18,54,177,249,1.3614457831325302,0.038905439656219884,688,"Sorry, there's no moon at the inn."
3850,314,19,51,177,247,1.360323886639676,0.039526503262666796,688,I don't think this goes where you're going.
2856,314,23,43,181,247,1.360323886639676,0.0411583004485645,688,Are you going to take one small step or one  giant leap
3027,314,21,47,179,247,1.360323886639676,0.040350651518828745,688,"I can take you as far as the roof, the rest is up to you."
1667,314,19,51,177,247,1.360323886639676,0.039526503262666796,688,"238, 857 please."
2454,314,20,49,178,247,1.360323886639676,0.039940703162109986,688,"Good to see that you are prepared for the toxic political environment, Senator."
8,319,14,63,176,253,1.359683794466403,0.03678462083877132,688,Are you sure that’s what she meant by | ‘needing some space’?” |
2095,320,16,56,173,245,1.3591836734693878,0.03845281370039103,688,What floor is alterations?
2961,320,11,66,168,245,1.3591836734693878,0.03621241299212434,688,"Watch your step, Sir.  Gravity is in full force here."
3836,320,17,54,174,245,1.3591836734693878,0.03888540711925157,688,There's a dehydrated fruit basket in your room
4640,320,17,54,174,245,1.3591836734693878,0.03888540711925157,688,"Mr. Musk, your car is ready."
4922,320,16,56,173,245,1.3591836734693878,0.03845281370039103,688,Just one small step and you'll be in the lobby.
3381,325,13,61,169,243,1.3580246913580247,0.03730812601255816,688,Just take me to the top floor and I'll figure it out from there.
655,325,19,49,175,243,1.3580246913580247,0.03994943149395665,688,Just mind the small step there Sir.
2126,325,15,57,171,243,1.3580246913580247,0.038208854165093606,688,"Be careful of that one small step, sir."
3342,328,18,52,176,246,1.3577235772357723,0.039180320077660855,688,"They will know how to fix a zipper here, yes sir."
3590,329,25,38,184,247,1.3562753036437247,0.041894775342947554,688,"The roof, Sir. May you have a most pleasant voyage!"
1491,330,18,49,172,239,1.3556485355648535,0.03994693274887092,688,"We're terribly sorry about the bed bug problem in your room, sir."
2618,330,13,59,167,239,1.3556485355648535,0.03768228890943541,688,It's actually not that big a step.
3673,330,17,51,171,239,1.3556485355648535,0.0395043912536959,688,"Yes Major Tom, this IS Ground Control."
1224,333,15,54,168,237,1.3544303797468353,0.038805892666958455,688,"When the real estate agent said the apartment was ""out of this world,"" that was a figure of speech."
718,333,17,50,170,237,1.3544303797468353,0.03971665541370136,688,Going up I assume?
4097,333,16,52,169,237,1.3544303797468353,0.03926391487695919,688,"Well, this is as far as I go. Good luck!"
5302,333,17,50,170,237,1.3544303797468353,0.03971665541370136,688,"Please take one small step, sir."
4879,333,16,52,169,237,1.3544303797468353,0.03926391487695919,688,"Seriously, man, it's just one small step."
3928,333,16,52,169,237,1.3544303797468353,0.03926391487695919,688,I'm sorry but this elevator doesn't go that high.
1059,339,22,42,179,243,1.353909465020576,0.04114716153798342,688,Shall I count backwards?
4347,339,17,52,174,243,1.353909465020576,0.0390261223737604,688,"Going up, I take it."
284,341,15,52,165,232,1.353448275862069,0.03935810378112527,688,"Going up, I presume."
2267,341,19,44,169,232,1.353448275862069,0.041210876532667966,688,I heard the restaurant has no atmosphere.
1222,343,19,45,171,235,1.353191489361702,0.04083264723985295,688,Your floor Major Tom.
1564,343,23,37,175,235,1.353191489361702,0.042576825588095425,688,I agree. Christmas music is really annoying.
3009,343,27,29,179,235,1.353191489361702,0.04425231150690236,688,"Regardless, no smoking allowed."
3296,343,19,45,171,235,1.353191489361702,0.04083264723985295,688,If it's hot air you're worried about I wouldn't take it off until the Senate trial is through...
4373,343,19,45,171,235,1.353191489361702,0.04083264723985295,688,"Sorry Sir, but Trump Tower is not as high as he says it is"
280,348,16,49,165,230,1.3521739130434782,0.04004789069770183,688,"No sir, M is the Mezzanine."
609,348,12,57,161,230,1.3521739130434782,0.03810438857130973,688,You're interested in the space for rent?
2367,348,19,43,168,230,1.3521739130434782,0.041445752376345596,688,"Taking the stairs would be 2,300 small steps for man, sir."
3778,348,9,63,158,230,1.3521739130434782,0.036579059415013326,688,"Right this way, please—the lobby is one small step ahead of you."
4979,348,26,29,175,230,1.3521739130434782,0.04453713452490353,688,"I'm sorry, this is the local elevator to the International Space Station."
3282,353,19,44,170,233,1.351931330472103,0.04106165453964042,688,"On second thought, I'll just take the stairway to heaven."
3077,353,18,46,169,233,1.351931330472103,0.0406086296922812,688,"Sorry, but Pres. Trump is wrong. You can't take an elevator to the international space station."
2456,353,21,40,172,233,1.351931330472103,0.041953030994538086,688,You're sure this thing doesn't go any higher?
1820,353,17,48,168,233,1.351931330472103,0.04015049361386323,688,"I assure you, Mrs Weinberg, we eradicated the bedbug problem three years ago."
228,353,24,34,175,233,1.351931330472103,0.04325566799591152,688,I’m assuming you’re not going down.
452,353,11,60,162,233,1.351931330472103,0.03728364425789371,688,Try jumping while we go down. It feels like there’s no gravity.
2641,359,13,55,163,231,1.3506493506493507,0.03846220596064865,688,Oh dear.  Did you miss your flight?
3722,360,12,54,158,224,1.3482142857142858,0.03870689873051929,688,Wouldn't it be easier to just get a flu shot?
1723,360,19,40,165,224,1.3482142857142858,0.042172183576744515,688,"This doesn't go to the moon, and my name is not Alice."
2442,360,12,54,158,224,1.3482142857142858,0.03870689873051929,688,"Um, sir, this is the Apollo Hotel."
2948,360,16,46,162,224,1.3482142857142858,0.04072318451364492,688,"Launch not go well today, Mr. Musk?"
2465,364,19,41,167,227,1.3480176211453745,0.041769608165038795,688,"You do realize that this is a three story building, sir?"
3170,364,13,53,161,227,1.3480176211453745,0.0388688970369051,688,"I'm sorry sir, did you say Floor 51 or Area 51?"
3617,364,16,47,164,227,1.3480176211453745,0.040345330108492145,688,The air is thinner on the top floor is just an expression.
4010,364,18,43,166,227,1.3480176211453745,0.04130030667394192,688,"Last chance to use the bathroom, Captain."
2195,364,14,51,162,227,1.3480176211453745,0.03936719435983157,688,"Careful, it's one small step."
4349,364,12,55,160,227,1.3480176211453745,0.038364128062114304,688,"Twelfth floor: gravity, oxygen, restrooms."
4627,364,18,43,166,227,1.3480176211453745,0.04130030667394192,688,"What do you mean you ""need a little space'?"
5341,364,14,51,162,227,1.3480176211453745,0.03936719435983157,688,"You can walk on the moon, but you can't take the stairs?"
4982,364,12,55,160,227,1.3480176211453745,0.038364128062114304,688,"Your ""back after launch"" joke is always a knee-slapper, sir."
4303,364,20,39,168,227,1.3480176211453745,0.04223369509242709,688,"I'll close the pod bay doors, but don't call me HAL"
2119,364,16,47,164,227,1.3480176211453745,0.040345330108492145,688,NASA budget got slashed again?
2972,364,13,53,161,227,1.3480176211453745,0.0388688970369051,688,I'm afraid you'll have to take the stairs the rest of the way.
1652,364,15,49,163,227,1.3480176211453745,0.039859262746116855,688,"Bringing work home again, sir?"
1048,364,14,51,162,227,1.3480176211453745,0.03936719435983157,688,Watch that small step.
950,364,12,55,160,227,1.3480176211453745,0.038364128062114304,688,"Beam me up, Ernie."
731,364,15,49,163,227,1.3480176211453745,0.039859262746116855,688,"Do watch the one small step, sir,"
421,364,17,45,165,227,1.3480176211453745,0.04082561079105158,688,I'd like the planetarium please.
2064,364,13,53,161,227,1.3480176211453745,0.0388688970369051,688,"It's a huge step for me too, sir."
337,364,13,53,161,227,1.3480176211453745,0.0388688970369051,688,"Here we are, sir, back to 1-G."
94,364,17,45,165,227,1.3480176211453745,0.04082561079105158,688,"| heard once you should dress | for the job you want and not |  the job you have, so...”"
60,384,16,48,166,230,1.3478260869565217,0.03997671456360262,688,Last floor with a bathroom before the moon.”
3942,385,16,45,162,223,1.345291479820628,0.04080071495307617,688,"Beware of Alien life forms, you are in NYC."
2944,385,12,53,158,223,1.345291479820628,0.03876985641615849,688,"Going way up, I assume?"
1144,385,14,49,160,223,1.345291479820628,0.03979824184063738,688,Your visiting Mrs. Ralph Kramden ?
1042,385,12,53,158,223,1.345291479820628,0.03876985641615849,688,"Sorry Pal, it's as far as I go."
5024,385,14,49,160,223,1.345291479820628,0.03979824184063738,688,"Sir, please stop counting down."
5235,385,10,57,156,223,1.345291479820628,0.03771343897675246,688,Do you want the observation deck?
4781,385,10,57,156,223,1.345291479820628,0.03771343897675246,688,I bet you’re going up.
246,392,14,48,159,221,1.3438914027149322,0.04001857173595518,688,‘Its only a small step sir’
4739,393,11,56,160,227,1.3436123348017621,0.03777314667113991,688,"Difficult transition, sir?"
2680,394,13,48,155,216,1.3425925925925926,0.040092525456814805,688,"The view from up top is unlike anything you’ve… well, it’s really good."
2721,394,15,44,157,216,1.3425925925925926,0.0411526820727097,688,Chicks dig astronauts.
4248,394,17,40,159,216,1.3425925925925926,0.042186204925896115,688,"Sixth floor: Lunar rovers, golf clubs, Tang..."
5231,394,15,44,157,216,1.3425925925925926,0.0411526820727097,688,"Earth, main level sir"""
2662,394,16,42,158,216,1.3425925925925926,0.04167264767102772,688,"The Otis has landed, sir."
2623,394,13,48,155,216,1.3425925925925926,0.040092525456814805,688,"I mean, you could just get the vaccine."
463,394,16,42,158,216,1.3425925925925926,0.04167264767102772,688,The tenant has landed.
1246,394,15,44,157,216,1.3425925925925926,0.0411526820727097,688,Most of our residents just get a flu shot.
935,394,15,44,157,216,1.3425925925925926,0.0411526820727097,688,"Sir, I believe the penthouse has scheduled a “power lunch” not launch."
932,394,15,44,157,216,1.3425925925925926,0.0411526820727097,688,The Germaphobe will see you now.
1827,394,13,48,155,216,1.3425925925925926,0.040092525456814805,688,"That's one small step, sir."
5240,405,15,45,159,219,1.3424657534246576,0.04075937796777809,688,Small step or giant leap?
5080,405,14,47,158,219,1.3424657534246576,0.040242204922679006,688,I'm just going to push all the buttons and we'll see what happens.
3597,405,10,55,154,219,1.3424657534246576,0.03810338194850525,688,"First floor, the final frontier."
5016,405,16,43,160,219,1.3424657534246576,0.04127007060330159,688,"One small step and you will be in the lobby, sir."
4985,405,12,51,156,219,1.3424657534246576,0.0391873881048008,688,5th floor in 3... 2... 1...
4911,405,17,41,161,219,1.3424657534246576,0.04177452049853836,688,My guidance counselor said I could be anything too.
4670,405,14,47,158,219,1.3424657534246576,0.040242204922679006,688,"Beyond the penthouse as usual, Sir."
4136,405,15,45,159,219,1.3424657534246576,0.04075937796777809,688,A package came while you were away.
4105,405,12,51,156,219,1.3424657534246576,0.0391873881048008,688,"So, buddy, what do you do?"
4026,405,15,45,159,219,1.3424657534246576,0.04075937796777809,688,"Take one small step, and it's on your left."
3905,405,15,45,159,219,1.3424657534246576,0.04075937796777809,688,Maybe air pollution deregulation wasn't such a good idea.
3490,405,15,45,159,219,1.3424657534246576,0.04075937796777809,688,Everything else was in the laundry basket.
3401,405,17,41,161,219,1.3424657534246576,0.04177452049853836,688,"Watch the step. It's a small step for man, but you know."
3232,405,13,49,157,219,1.3424657534246576,0.03971829832404186,688,"Good evening, Major Tom."
3016,405,14,47,158,219,1.3424657534246576,0.040242204922679006,688,"Sir, we've landed."
2774,405,19,37,163,219,1.3424657534246576,0.042765572993301616,688,"Yes, it is one small step, but it's not for mankind -- this is your floor."
2522,405,16,43,160,219,1.3424657534246576,0.04127007060330159,688,I only farted in here one time. ONE time.
2014,405,14,47,158,219,1.3424657534246576,0.040242204922679006,688,Down actually.
1845,405,12,51,156,219,1.3424657534246576,0.0391873881048008,688,Would you like to do the countdown or shall I?
1505,405,13,49,157,219,1.3424657534246576,0.03971829832404186,688,All the way up I assume...
201,405,14,47,158,219,1.3424657534246576,0.040242204922679006,688,Do you have shuttle service here?
497,405,14,47,158,219,1.3424657534246576,0.040242204922679006,688,"This is the local, sir."
2447,427,12,57,168,237,1.3417721518987342,0.037179692542905325,688,This is as far as we go.
3528,428,20,33,161,214,1.341121495327103,0.043962932989180026,688,It’s so the president can say we’re sending astronauts up again.
330,428,17,39,158,214,1.341121495327103,0.042439469483891816,688,"Will you be needing the Moon Buggy, sir?"
851,428,18,37,159,214,1.341121495327103,0.04295329485677632,688,"I see you're new to the Republican Party. Trump Tower isn't literally ""out of this world"", it's just crap he says to market his brand."
1129,428,13,47,154,214,1.341121495327103,0.040318738747116736,688,I missed the shuttle.
1685,428,13,47,154,214,1.341121495327103,0.040318738747116736,688,"Actually, Mars requires your key card."
2279,428,13,47,154,214,1.341121495327103,0.040318738747116736,688,What do you mean going down?
2600,428,12,49,153,214,1.341121495327103,0.03977089042477261,688,"The bar is casual dress, sir. But I'm afraid you'll need a jacket for the outdoor terrace."
2804,428,14,45,155,214,1.341121495327103,0.04085924207737138,688,"Moving: That’s One Small Step For Man, One Giant Sigh Of Relief ForThe Co-op Board"
3178,428,16,41,157,214,1.341121495327103,0.04191934638201318,688,Forgot my charger.
4462,428,13,47,154,214,1.341121495327103,0.040318738747116736,688,Oh so you heard the hotel has no atmosphere?
459,438,15,44,158,217,1.3410138248847927,0.04099301227990095,688,"No, I don't think anybody will suspect you're a prostitute."
4633,439,13,46,153,212,1.3396226415094339,0.04054840956304769,688,The moon is just above lingerie.
1626,439,14,44,154,212,1.3396226415094339,0.04109603678852384,688,The listing said spacious not spaceish.
4950,441,13,47,155,215,1.3395348837209302,0.04016212349496342,688,"One time, just one time I had beans for breakfast and you still won’t let it go."
399,442,15,47,165,227,1.3392070484581498,0.039706011283531385,688,"I can take you part of the way, sir."
4901,443,16,40,157,213,1.3380281690140845,0.04200178948069589,688,"Sir, will you be using your frequent flier miles for this stay?"
4596,443,16,40,157,213,1.3380281690140845,0.04200178948069589,688,"You know, sir, the garbage strike is over."
4047,443,12,48,153,213,1.3380281690140845,0.039837001756988594,688,Just take one small step.
3958,443,14,44,155,213,1.3380281690140845,0.04093370877752839,688,This wasn't what I expected from the star button.
3633,443,16,40,157,213,1.3380281690140845,0.04200178948069589,688,"The ""ten, nine, eight"" thing was cute when you were four, but..."
3014,443,13,46,154,213,1.3380281690140845,0.0403890778755211,688,"Sorry, I can only take you as far as the 43rd floor."
5342,443,16,40,157,213,1.3380281690140845,0.04200178948069589,688,Mrs. Kramden! You’re back!
1772,443,17,38,158,213,1.3380281690140845,0.0425257712714219,688,"First time leaving New York?"""
1715,443,14,44,155,213,1.3380281690140845,0.04093370877752839,688,I think you will like the atmosphere on this floor
1480,443,15,42,156,213,1.3380281690140845,0.04147118779263623,688,I need more space
392,443,14,44,155,213,1.3380281690140845,0.04093370877752839,688,"NASA Recruitment Office on the right, Germophobe Support Center on the left."
79,443,11,50,152,213,1.3380281690140845,0.039277166475418214,688,"And that’s when I told  my wife. Honey, I need some space"
2933,443,13,46,154,213,1.3380281690140845,0.0403890778755211,688,"I like it, but the rent's astronomical."
2496,456,18,35,158,211,1.3364928909952607,0.043308502357201795,688,Please watch your one step for mankind
719,456,10,51,150,211,1.3364928909952607,0.03891701520162469,688,"Going up, I imagine, Sir?"
1971,456,11,49,151,211,1.3364928909952607,0.03949266527130095,688,I don't know altitude.  What floor do ya want?
2483,456,12,47,152,211,1.3364928909952607,0.04006004428677724,688,"The breakfast buffet is five small steps down the hall, one giant leap to the right."
3748,460,9,45,134,188,1.3351063829787233,0.04127349604153249,688,I believe the bedbug situation has been resolved.
3624,461,13,42,148,203,1.3349753694581281,0.041675650526114126,688,"From here, you can take the shuttle"
5192,462,16,37,153,206,1.3349514563106797,0.0429462956778027,688,"What, on earth, are you doing?"
1322,463,12,49,158,219,1.3333333333333333,0.03901371573204353,688,It's ok. Just one small step.
4751,463,13,42,149,204,1.3333333333333333,0.041503350367126365,688,Close the pod bay doors HAL
4715,463,15,39,153,207,1.3333333333333333,0.04221706267429292,688,I’m afraid the “M” stands for mezzanine.
4527,463,13,42,149,204,1.3333333333333333,0.041503350367126365,688,I cant find the zipper.
3875,463,16,36,152,204,1.3333333333333333,0.04321358157014429,688,"Be careful sir, small step."
3760,463,12,44,148,204,1.3333333333333333,0.04091739130926392,688,Thank you for coming quickly to fix the Presidential toilet.
3101,463,16,35,150,201,1.3333333333333333,0.04367071114154914,688,"I understand that it's Snoop's party, but just how high are you planning to get?"
2598,463,13,41,147,201,1.3333333333333333,0.04192704712074701,688,Down? Really?
4277,463,9,50,145,204,1.3333333333333333,0.03910687114986777,688,The restaurant has a great view but no atmosphere.
2201,463,14,39,148,201,1.3333333333333333,0.04251621483677063,688,You may want the express.
1950,463,15,38,151,204,1.3333333333333333,0.042651124861819205,688,"Last time, you farted."
1666,463,14,41,152,207,1.3333333333333333,0.04165787159181055,688,"You might think it's odd that we are in the space age and there are still elevator operators, but to me, the real mystery is why is there a chair in here?"
805,463,11,45,145,201,1.3333333333333333,0.04072314811876841,688,Mr. Jackson! Just get a flu shot!
676,463,12,43,146,201,1.3333333333333333,0.041329481444656986,688,It’s only one small step...
458,463,8,52,144,204,1.3333333333333333,0.03848444089487775,688,Please take one small step back so I can close the door
2154,463,17,33,151,201,1.3333333333333333,0.044236661892481426,688,"Good morning. To the moon, Alice?"
453,463,8,53,146,207,1.3333333333333333,0.038130900511886424,688,I work best under pressure.
405,463,16,36,152,204,1.3333333333333333,0.04321358157014429,688,Just get off this elevator.  I don't care if you start with a small step or a giant leap.
5109,481,11,46,148,205,1.3317073170731708,0.04015867095854851,688,It looks like one small step to me.
4274,481,14,40,151,205,1.3317073170731708,0.041906931122577935,688,My name is not Scotty.
1331,483,8,51,143,202,1.3316831683168318,0.038689821830228455,688,"I was told that if I wanted in, I’d need to dazzle the co-op board."
1539,483,17,33,152,202,1.3316831683168318,0.04404804454383716,688,"I can get you to the roof, but the rest is up to you."
2291,483,23,21,158,202,1.3316831683168318,0.04728405832191109,688,Welcome to the Apollo Hotel - Did you say Floor 1 or 11?
4615,483,10,47,145,202,1.3316831683168318,0.03994270431096061,688,"What exactly to do you mean by ALL the way up, sir?"
1683,487,12,42,146,200,1.33,0.041401332729258784,688,"I'm sorry sir, the ""To the Moon!"" button appears to be broken."
2249,487,13,40,147,200,1.33,0.042003828492652925,688,"Houston, we DEFINITELY have a problem"
3910,489,14,37,146,197,1.3299492385786802,0.04304806984671743,688,Boldly going down?
2616,489,11,43,143,197,1.3299492385786802,0.0412036917210928,688,"I missed my flight. Can you hit floor 23,890 for me?"
3289,489,11,43,143,197,1.3299492385786802,0.0412036917210928,688,Sign outside says you've got some space for rent.
2980,489,12,41,144,197,1.3299492385786802,0.04182752180252281,688,"That’s one small step out of the elevator, and one giant leap for the continental breakfast."
2698,489,9,47,141,197,1.3299492385786802,0.03992680145039808,688,"Careful, there’s a small step."
4850,489,12,41,144,197,1.3299492385786802,0.04182752180252281,688,"Look, you'll have to speak up or lose the helmet. I can't make any assumptions here."
5108,489,22,21,154,197,1.3299492385786802,0.04761843410988254,688,T-minus ten seconds and counting.
1189,489,10,45,142,197,1.3299492385786802,0.040570270429874884,688,Well the AIRPORT Shuttle will be in in 5 minutes.
814,489,11,43,143,197,1.3299492385786802,0.0412036917210928,688,Ready for lift off?
543,489,14,37,146,197,1.3299492385786802,0.04304806984671743,688,My honeymoon wasn't what I expected either.
523,489,9,47,141,197,1.3299492385786802,0.03992680145039808,688,"You know, sometimes I jump a little on the way down, and it feels like floating."
1080,489,12,41,144,197,1.3299492385786802,0.04182752180252281,688,"Might I suggest an umbrella, meteor showers are in today's forecast."
1401,501,9,47,142,198,1.3282828282828283,0.03975957592069659,688,"Bringing your work home with you, again?"
4978,502,13,38,144,195,1.3282051282051281,0.04270613173086513,688,"No, it doesn't actually scrape the sky."
4560,502,12,40,143,195,1.3282051282051281,0.04208260440263646,688,"Sir, I believe the ad said, ""spacious"" apartments."
3823,502,12,40,143,195,1.3282051282051281,0.04208260440263646,688,Taxis are one small step and one giant leap to the right.
3650,502,11,42,142,195,1.3282051282051281,0.04144969842114162,688,"Unfortunately, the button to the Moon floor hasn't worked since the 1970s."
3637,502,12,40,143,195,1.3282051282051281,0.04208260440263646,688,"Watch the small step, Mr. Armstrong."
3106,502,10,44,141,195,1.3282051282051281,0.04080697740703644,688,Have a nice light year.
2984,502,14,36,145,195,1.3282051282051281,0.04332068537684062,688,"This IS ground control, Major Tom ..."
2395,502,11,42,142,195,1.3282051282051281,0.04144969842114162,688,Moonlight Lounge or Mars Bar?
2166,502,8,48,139,195,1.3282051282051281,0.03949016607825254,688,"Um, rooftop?"
2117,502,10,44,141,195,1.3282051282051281,0.04080697740703644,688,And 3…2…1…lobby.
1423,502,18,28,149,195,1.3282051282051281,0.04569632543148346,688,"Unfortunately, the plunger didn’t do the trick. I’m going in."
1352,502,14,36,145,195,1.3282051282051281,0.04332068537684062,688,Floor two thousand six hundred eighty three please.
1115,502,11,42,142,195,1.3282051282051281,0.04144969842114162,688,10? 9? 8? 7? 6? 5? 4? 3? or 2?
1091,502,10,44,141,195,1.3282051282051281,0.04080697740703644,688,The new apartments are spacious but maybe you misunderstood.
1066,502,11,42,142,195,1.3282051282051281,0.04144969842114162,688,Down?  Are you sure?
887,502,9,46,140,195,1.3282051282051281,0.04015397005270058,688,I missed my ride. How fast will this thing go?
758,502,11,42,142,195,1.3282051282051281,0.04144969842114162,688,"Lunar buggies, Satellites, Asteroids.  Thank you for shopping at Macy's, enjoy the experience."
513,502,15,34,146,195,1.3282051282051281,0.043926641979832926,688,"So, this is Trump's Military Space Force?"
300,502,12,40,143,195,1.3282051282051281,0.04208260440263646,688,Fly me to the moon!
198,502,11,42,142,195,1.3282051282051281,0.04144969842114162,688,"Sir, you do know that our “Mercury suite” isn’t actually Mercury, right?"
1195,502,13,38,144,195,1.3282051282051281,0.04270613173086513,688,"Yes, Mr. Aldrin, we all know that you walked on the moon."
1619,523,10,46,146,202,1.3267326732673268,0.03983725190307578,688,Fake moon landing auditions? Two doors down.
4769,524,12,40,144,196,1.3265306122448979,0.04190082008277108,688,The air a bit thin on the 117th floor?
890,524,11,42,143,196,1.3265306122448979,0.04127166218910448,688,I agree with you. This place lacks atmosphere.
2668,526,10,42,138,190,1.3263157894736841,0.04147396409711801,688,"Just press 3,2,1..."
408,527,15,36,152,203,1.3251231527093597,0.04263599903170733,688,"Okay sir, but this is the last time..... 'Prepare for lift off'"
5291,528,11,41,142,194,1.324742268041237,0.04151825800030636,688,That's one small tip...
4898,528,13,37,144,194,1.324742268041237,0.04278548407328524,688,"One small step should do it, sir."
2677,528,13,37,144,194,1.324742268041237,0.04278548407328524,688,President Trump they will still find you.
4268,528,10,43,141,194,1.324742268041237,0.04086991310704407,688,You had a good trip I hope?
2660,528,9,45,140,194,1.324742268041237,0.040211115967785094,688,I borrow it for flu season.
1387,528,10,43,141,194,1.324742268041237,0.04086991310704407,688,"Yeah, NASA budget cuts have really impacted our training."
178,528,15,33,146,194,1.324742268041237,0.04401624185900798,688,Forgot my toothbrush.
118,528,14,35,145,194,1.324742268041237,0.043405225461780696,688,"Going up, sir?"
3264,536,9,44,138,191,1.324607329842932,0.0406187828571637,688,"I said, 'Close the elevator doors, Hal.'"
5292,536,13,36,142,191,1.324607329842932,0.04324733430820275,688,"I can get you to the 50th floor, but from there you’re on your own”"
4667,536,10,42,139,191,1.324607329842932,0.04129161079189603,688,Should we hold your mail Mr. Musk?
4634,536,17,28,146,191,1.324607329842932,0.04572502956514612,688,Down the hall to the right.  But there's a line.
4502,536,13,36,142,191,1.324607329842932,0.04324733430820275,688,The Jetsons? Top floor.
4382,536,12,38,141,191,1.324607329842932,0.04260540251861778,688,"What altitude, sir?"
4253,536,11,40,140,191,1.324607329842932,0.04195364969560376,688,This place has no atmosphere.
3656,536,17,28,146,191,1.324607329842932,0.04572502956514612,688,"On your countdown, sir."
3354,536,16,30,145,191,1.324607329842932,0.0451183635312882,688,Your rover is waiting at the curb
3324,536,8,46,137,191,1.324607329842932,0.03993462056668884,688,My name isn't Houston.
3108,536,13,36,142,191,1.324607329842932,0.04324733430820275,688,"My mom always said, “Dress for the job you want, not the job you have.”"
2788,536,9,44,138,191,1.324607329842932,0.0406187828571637,688,"We just count backwards from 10, push this little button and up we go !!!!"
3185,536,14,34,143,191,1.324607329842932,0.04387987609095381,688,"Sorry, Sir. P is for Penthouse.  Anyway, Pluto's no longer on the agenda."
1896,536,11,40,140,191,1.324607329842932,0.04195364969560376,688,"You should dress for the job you want, not the job you have."
1809,536,12,38,141,191,1.324607329842932,0.04260540251861778,688,Are you sure your mother said you could go to school in that?
1732,536,12,38,141,191,1.324607329842932,0.04260540251861778,688,"Sir, the air today is really not that bad."
1730,536,8,46,137,191,1.324607329842932,0.03993462056668884,688,"I suppose I can get you part of the way there, sir."
4223,536,10,42,139,191,1.324607329842932,0.04129161079189603,688,"3G the apartment, or the gravitational pull?"
1140,536,11,40,140,191,1.324607329842932,0.04195364969560376,688,"It might take a little longer to get there, but we will save the country billions!"
883,536,10,42,139,191,1.324607329842932,0.04129161079189603,688,Let me guess: they promised you the moon!
779,536,12,38,141,191,1.324607329842932,0.04260540251861778,688,Can you take one giant leap back?
116,536,12,38,141,191,1.324607329842932,0.04260540251861778,688,Happy Halloween Mr Armstrong
527,536,10,42,139,191,1.324607329842932,0.04129161079189603,688,"Fifth floor, lingerie , decontamination."
2380,559,12,37,139,188,1.324468085106383,0.043067421420575666,688,I heard he sucks all the oxygen out of the room.
4369,560,8,49,144,201,1.3233830845771144,0.038626963072202335,688,I see they’ve cut NASA’s budget again.
1461,561,12,39,144,195,1.323076923076923,0.04197293850380622,688,Welcome back sir
5256,561,11,41,143,195,1.323076923076923,0.04133835352961087,688,I think it just left.
2704,563,10,42,140,192,1.3229166666666667,0.04111076595102186,688,"You know what they say, dress for the job you want."
4530,563,11,40,141,192,1.3229166666666667,0.04176879934705697,688,"Please, no leaping of any kind."
2158,563,10,42,140,192,1.3229166666666667,0.04111076595102186,688,"Reception, we have a problem"
3849,563,12,38,142,192,1.3229166666666667,0.04241662552242594,688,These budget cuts at NASA have really limited the scope of our exploration.
2142,563,10,42,140,192,1.3229166666666667,0.04111076595102186,688,"Could I suggest a simple flu shot, Sir?"
4580,563,13,36,143,192,1.3229166666666667,0.04305470523095849,688,Oh! I thought you said the dark side of the ROOM!
988,563,12,38,142,192,1.3229166666666667,0.04241662552242594,688,"To the Oxygen Bar, please."
239,563,12,38,142,192,1.3229166666666667,0.04241662552242594,688,"I think you're taking ""Space needle"" too literally"
25,563,13,36,143,192,1.3229166666666667,0.04305470523095849,688,"High flyers lounge, sir?"
5058,572,11,39,139,189,1.3227513227513228,0.04221179015089436,688,NASA lost my luggage.
5329,572,15,31,143,189,1.3227513227513228,0.04479937933791624,688,"Yes, the penthouse is out of this world, but it still has oxygen."
4255,572,12,37,140,189,1.3227513227513228,0.04287333108207228,688,"Houston, we have a lobby."
3907,572,11,39,139,189,1.3227513227513228,0.04221179015089436,688,"Great story. Now, please take a small step out of the elevator."
3311,572,13,35,141,189,1.3227513227513228,0.043524818304076,688,"Yes, four more years wants me to leave the planet too."
2930,572,12,37,140,189,1.3227513227513228,0.04287333108207228,688,"This is Ground Floor,Major Tom."
2877,572,11,39,139,189,1.3227513227513228,0.04221179015089436,688,Watch that first small step!
2472,572,13,35,141,189,1.3227513227513228,0.043524818304076,688,"Your Planet, sir."
2435,572,14,33,142,189,1.3227513227513228,0.04416669671520242,688,"How was it, Alice?"
1931,572,7,47,135,189,1.3227513227513228,0.03945486112538945,688,Please take me where no man has gone before.
1834,572,13,35,141,189,1.3227513227513228,0.043524818304076,688,"Would you mind saying ""We have Liftoff"" ?"
1696,572,11,39,139,189,1.3227513227513228,0.04221179015089436,688,"Watch your leap, sir."
5105,572,10,41,138,189,1.3227513227513228,0.04153971518213983,688,The fake moon set is right around the corner on your left.
1584,572,10,41,138,189,1.3227513227513228,0.04153971518213983,688,"This is as far as I can take you,son."
1297,572,16,29,144,189,1.3227513227513228,0.045423250427422734,688,Mr. Trump told you his Tower went to where?
1136,572,13,35,141,189,1.3227513227513228,0.043524818304076,688,"No, we do not sort of have the same job."
918,572,11,39,139,189,1.3227513227513228,0.04221179015089436,688,Tenth Floor. The Right Stuff. The Left Stuff and All the Middle Stuff.
747,572,8,45,136,189,1.3227513227513228,0.04016183955888489,688,"I'm a dreamer, too."
738,572,11,39,139,189,1.3227513227513228,0.04221179015089436,688,I assume you are going up.
92,572,11,39,139,189,1.3227513227513228,0.04221179015089436,688,"Going out for a walk, Sir?"
1488,572,14,33,142,189,1.3227513227513228,0.04416669671520242,688,Ten? Nine? Eight?
5326,572,8,45,136,189,1.3227513227513228,0.04016183955888489,688,"This is the best I can offer you, a lobby with no atmosphere."
4241,594,10,40,136,186,1.3225806451612903,0.04198128632314873,688,"You can go up, or down, there is no re-entry button."
1808,595,8,44,135,187,1.320855614973262,0.04039248217604247,688,"You do know we're in Cape Coral, Florida, right?"
1598,595,5,50,132,187,1.320855614973262,0.03819750773989162,688,"Well, I'm happy to help but I think there's so much more to it than getting used to heights."
1983,595,7,46,134,187,1.320855614973262,0.039674319276760114,688,Things still toxic at home then?
329,598,12,35,137,184,1.3206521739130435,0.043624649614925494,688,"Yes, I’m afraid the restaurant lacks atmosphere."
3772,598,13,33,138,184,1.3206521739130435,0.04430018719224101,688,"Yeah, well, the city ain't the kind of place to raise your kids either."
4515,598,9,41,134,184,1.3206521739130435,0.04153216175805556,688,I am looking for the “moonwalking” competition
4851,598,15,29,140,184,1.3206521739130435,0.045621263110009844,688,"I hear that you should dress for the job you want, not for the job you have."
5042,598,11,37,136,184,1.3206521739130435,0.042938485334050196,688,"Welcome to the Space Needle. I hope, but doubt, we will meet your expectations."
382,603,10,42,142,194,1.3195876288659794,0.04075353443758232,688,"Way,Way,Way up Sir?"
597,604,11,39,141,191,1.3193717277486912,0.0418365663113027,688,Actually you don't need that- we got the elevator fixed.
4976,605,12,36,140,188,1.3191489361702127,0.042949570427322635,688,"Would you mind saying ""lift off"" after you hit the button?"
2122,605,10,40,138,188,1.3191489361702127,0.041603930259310785,688,"I see our jobs to be very similar, only you have more buttons to push."
2760,607,11,37,137,185,1.318918918918919,0.04274091315792126,688,"Thanks for opening the pod bay doors, Hal"
4115,608,9,42,138,189,1.3174603174603174,0.040732479560555875,688,"Ground, please, Major Tom."
1277,608,12,36,141,189,1.3174603174603174,0.04275507878767893,688,I grabbed the wrong keys.
807,608,13,34,142,189,1.3174603174603174,0.04340834081683469,688,Sinatra fan?
326,611,8,42,133,183,1.3169398907103824,0.04086433534470527,688,"The Eagle has landed, Mr. Baxter."
1457,611,14,30,139,183,1.3169398907103824,0.04505762250082869,688,"Ground floor. Terrestrials. Life, death, joy and sorrow."
5085,613,8,41,131,180,1.3166666666666667,0.041297245013268244,688,"An elevator operator? Wow, the Upper East Side really is an entirely different planet."
4517,613,9,39,132,180,1.3166666666666667,0.0420420705022564,688,Watch your one small step as you exit.
4452,613,11,35,134,180,1.3166666666666667,0.04349347290086495,688,"Sorry, we don't go any higher."
3808,613,8,41,131,180,1.3166666666666667,0.041297245013268244,688,"Well, it's no rocket ship, but I make do."
3059,613,12,33,135,180,1.3166666666666667,0.04420130576588278,688,The Coop Board says you have to return the terrace rocks you took.
2967,613,8,41,131,180,1.3166666666666667,0.041297245013268244,688,I thought the elevator would be faster.
2269,613,11,35,134,180,1.3166666666666667,0.04349347290086495,688,"True, the cheap seats are very high in this stadium but the atmosphere does support life."
2084,613,11,35,134,180,1.3166666666666667,0.04349347290086495,688,"Is this not the landing you expected, sir?"
1040,613,9,39,132,180,1.3166666666666667,0.0420420705022564,688,"Sir, it's just one small step"
2954,613,8,41,131,180,1.3166666666666667,0.041297245013268244,688,Are you sure you have enough oxygen to walk down the stairs?
3192,623,10,37,134,181,1.3149171270718232,0.04257291573274369,688,This may take a while.
4877,623,8,41,132,181,1.3149171270718232,0.041105698456263065,688,"It's one giant step to your left and then it'll be on your right, sir."
5191,623,14,29,138,181,1.3149171270718232,0.04536521322343179,688,"Sir, can you please take a giant leap for mankind and exit?"
5209,623,8,41,132,181,1.3149171270718232,0.041105698456263065,688,"I assure you, Sir, this hotel has a great atmosphere."""
4737,623,12,33,136,181,1.3149171270718232,0.04399122483402074,688,"Going up. Way, way up."
4693,623,2,53,126,181,1.3149171270718232,0.036350437691271685,688,More cutbacks at NASA?
5336,623,9,39,133,181,1.3149171270718232,0.04184573813164563,688,Re-entry sequence complete; lobby level sir
4391,623,10,37,134,181,1.3149171270718232,0.04257291573274369,688,"Space station?
You want the express elevator."
4288,623,12,33,136,181,1.3149171270718232,0.04399122483402074,688,Watch that first step.
4165,623,12,33,136,181,1.3149171270718232,0.04399122483402074,688,Oh. You want a moon with a view...not a room with a view
3930,623,9,39,133,181,1.3149171270718232,0.04184573813164563,688,"Let me guess, budget cuts?"
3132,623,8,41,132,181,1.3149171270718232,0.041105698456263065,688,"Yes, Mr. Damon, I believe you mentioned that you can grow potatoes from poop last week as well."
923,623,14,29,138,181,1.3149171270718232,0.04536521322343179,688,"To infinity, or 3rd floor menswear?"
2451,623,11,35,135,181,1.3149171270718232,0.043287879460564116,688,I’m just looking forward to a hot shower in gravity.
2273,623,11,35,135,181,1.3149171270718232,0.043287879460564116,688,"Going way up, sir?"
2129,623,11,35,135,181,1.3149171270718232,0.043287879460564116,688,Boldly go where no one has been before and have a wonderful day sir!
1547,623,12,33,136,181,1.3149171270718232,0.04399122483402074,688,"Ralph keeps telling me, ""to the moon, Alice."" I figure I ought to be prepared, just in case."
1263,623,9,39,133,181,1.3149171270718232,0.04184573813164563,688,"Welcome back to earth, sir. Things here are not quite the same before you left."
1156,623,12,33,136,181,1.3149171270718232,0.04399122483402074,688,"Floor 2, please, for man. And Floor 3 for mankind."
540,623,12,33,136,181,1.3149171270718232,0.04399122483402074,688,I don't think your elevator goes all the way to the top.
121,623,11,35,135,181,1.3149171270718232,0.043287879460564116,688,Waaay behind in laundry”
2970,623,9,39,133,181,1.3149171270718232,0.04184573813164563,688,"Watch your one giant step, sir."
3284,645,8,40,130,178,1.3146067415730338,0.04154617471899413,688,"Oh, this is ground floor. Ground control is on three."
3409,645,11,34,133,178,1.3146067415730338,0.043778128671605236,688,"Soak it all in while you can, there won't be elevator music on the rocket ship."
3758,645,8,40,130,178,1.3146067415730338,0.04154617471899413,688,"Yes, it would feel like zero gravity if someone cut the cable when we hit the top floor. Why do you ask?"
4606,645,10,36,132,178,1.3146067415730338,0.04304700428506973,688,"Uniforms suck, am I right?"
2977,645,14,28,136,178,1.3146067415730338,0.045901682607438925,688,"Welcome back, Mr. Mitty."
5230,645,7,42,129,178,1.3146067415730338,0.04077504949981514,688,Wouldn't a flu shot be easier?
5115,645,14,28,136,178,1.3146067415730338,0.045901682607438925,688,Don't ask.
3791,645,18,20,140,178,1.3146067415730338,0.048588932427758795,688,Good luck on your new planet Mr. Trump.
2846,645,8,40,130,178,1.3146067415730338,0.04154617471899413,688,Climate change anxiety?
4109,645,8,40,130,178,1.3146067415730338,0.04154617471899413,688,"Thank you, Hal."
1446,645,7,42,129,178,1.3146067415730338,0.04077504949981514,688,"Sorry, there’s only one “G.”"
1439,645,13,30,135,178,1.3146067415730338,0.04520491670300089,688,You'll find vacuums in our housewares department.
1166,645,10,36,132,178,1.3146067415730338,0.04304700428506973,688,Be brave. Its only four more years.
977,645,9,38,131,178,1.3146067415730338,0.042303245807502755,688,"Zero-G again,Frank?"
922,645,13,30,135,178,1.3146067415730338,0.04520491670300089,688,I see you fell for the hype about the penthouse level's breathtaking atmosphere.
677,645,9,38,131,178,1.3146067415730338,0.042303245807502755,688,"Ground control, please."
1917,645,12,32,134,178,1.3146067415730338,0.04449724173537543,688,I thought there'd be more cheese.
1445,662,12,36,143,191,1.3141361256544504,0.04237110922830628,688,"Welcome to the 116,914th floor, featuring light oxygen, burning meteorites, space debris and obsolete satellites. Please mind the saftey warnings and guard rails on Exosphere Obsevation Deck."
4798,662,15,30,146,191,1.3141361256544504,0.044279179082420767,688,You'll find can openers on five.
5325,664,4,43,116,163,1.312883435582822,0.04037380475790278,688,Shall I hail you a rover?
756,665,10,36,133,179,1.312849162011173,0.04284191003145463,688,My therapist says that I need to overcome my fear of heights to be successful in my profession.
1640,666,11,38,143,192,1.3125,0.04153009905357379,688,"Back in my day, ""climate change"" meant carrying your umbrella and galoshes."
1339,666,15,25,136,176,1.3125,0.04692232459559677,688,"Sorry, but Trump Tower doesn't actually have as many floors as advertised."
2525,668,5,44,124,173,1.3121387283236994,0.039804143381108104,688,"Well, judging by your outfit I would assume you want to go up?"
5070,669,6,43,128,177,1.310734463276836,0.04002663649899449,688,Ground floor. Earth.
4555,669,11,33,133,177,1.310734463276836,0.04385360083689272,688,They said I’d need to find another way up.
4499,669,9,37,131,177,1.310734463276836,0.042364320313041326,688,"Well, there's plenty of space IN this elevator, but that still doesn't make it the Space Elevator."
4125,669,9,37,131,177,1.310734463276836,0.042364320313041326,688,"Hm, it’s not every day you see an elevator operator around here."
4788,669,10,35,132,177,1.310734463276836,0.043115391346637943,688,"No, you're looking for the express elevator."
2778,669,8,39,130,177,1.310734463276836,0.041599691107004504,688,"OK, let’s go for Zero G in this thing."
2718,669,11,33,133,177,1.310734463276836,0.04385360083689272,688,"You realize the Orbit Room is just a nightclub, right?"""
345,669,12,31,134,177,1.310734463276836,0.04457958772520552,688,How long do you have to wear that before you win the bet?
2507,669,9,37,131,177,1.310734463276836,0.042364320313041326,688,If you tip me enough at Christmas I will make rocket sounds as I take you to your apartment.
3082,669,7,41,129,177,1.310734463276836,0.04082074184541988,688,The real thing goes up much faster.
5161,679,8,38,128,174,1.3103448275862069,0.04205590406650257,688,"We could go up again if you like the sensation."""
3095,679,11,32,131,174,1.3103448275862069,0.04436238689494406,688,"212th floor. Oxygen tanks, satellite parts, moon boots."
3234,679,10,34,130,174,1.3103448275862069,0.043607116425664116,688,Which floor is the fake moon landing set?
3327,679,10,34,130,174,1.3103448275862069,0.043607116425664116,688,I just had this nagging thought I'd left the front door unlocked.
3364,679,8,38,128,174,1.3103448275862069,0.04205590406650257,688,"Eight thousand two hundred and thirty-one, please."
3424,679,10,34,130,174,1.3103448275862069,0.043607116425664116,688,"Yes, sir, I do realize that  flu season has started."
3831,679,11,32,131,174,1.3103448275862069,0.04436238689494406,688,"Listen, I know it looks weird, but I'd rather figure life out in outer space than hear another argument against the impeachment inquiry. You feel me?"
3919,679,10,34,130,174,1.3103448275862069,0.043607116425664116,688,"""I'm sorry, sir, the penthouse is as far as I go."""
3978,679,7,40,127,174,1.3103448275862069,0.04125843306277626,688,"The Eagle has landed, Mr. Steinberg."
4363,679,9,36,129,174,1.3103448275862069,0.04283853212828547,688,Just took it for a test drive
4254,679,8,38,128,174,1.3103448275862069,0.04205590406650257,688,You could have just told me you don’t like my cologne.
4481,679,12,30,132,174,1.3103448275862069,0.045105012349759784,688,Glad to see you're prepared for the 546th Floor.
4524,679,10,34,130,174,1.3103448275862069,0.043607116425664116,688,"Shall I count down, sir?"
4588,679,7,40,127,174,1.3103448275862069,0.04125843306277626,688,"I'm sorry, but this is as far as I can take you."
4708,679,10,34,130,174,1.3103448275862069,0.043607116425664116,688,"Beam me up, Otis."
4889,679,8,38,128,174,1.3103448275862069,0.04205590406650257,688,"Watch your one small step for man, sir."
4897,679,9,36,129,174,1.3103448275862069,0.04283853212828547,688,Can you give me some space?
5004,679,9,36,129,174,1.3103448275862069,0.04283853212828547,688,Is this your first time in Denver?
2897,679,14,26,134,174,1.3103448275862069,0.04655473848259208,688,John realized that the only way to avoid hearing another word about Impeachment was to rent a vacuum chamber at the local hotel.
4069,679,14,26,134,174,1.3103448275862069,0.04655473848259208,688,You want To Infinity and Beyond?
2808,679,10,34,130,174,1.3103448275862069,0.043607116425664116,688,"I'm sorry sir, you need the elevators across the lobby."
3556,679,10,34,130,174,1.3103448275862069,0.043607116425664116,688,"I've seen all sorts of strange things in a lift, but never a chair."
2649,679,3,48,123,174,1.3103448275862069,0.037901124344463376,688,Can't be too careful around the office during flu season.
153,679,16,22,136,174,1.3103448275862069,0.047960663165693376,688,Enjoy your holidays Mr. Musk.
379,679,10,34,130,174,1.3103448275862069,0.043607116425664116,688,"Thanks for opening the pod door, Hal."
384,679,5,44,125,174,1.3103448275862069,0.03961536018623372,688,Express or local?
422,679,8,38,128,174,1.3103448275862069,0.04205590406650257,688,"Down the hall, to infinity, and beyond."
484,679,7,40,127,174,1.3103448275862069,0.04125843306277626,688,"To the moon, Ellis!"
531,679,8,38,128,174,1.3103448275862069,0.04205590406650257,688,Forget something?
673,679,11,32,131,174,1.3103448275862069,0.04436238689494406,688,T minus 5 seconds till the doors close.
711,679,10,34,130,174,1.3103448275862069,0.043607116425664116,688,You'll have to take the stairs the rest of the way.
768,679,8,38,128,174,1.3103448275862069,0.04205590406650257,688,"Can you find your way back, sir, or would you like a tether?"
608,679,10,34,130,174,1.3103448275862069,0.043607116425664116,688,"There’s a lot of space, but not much of an atmosphere."
948,679,11,32,131,174,1.3103448275862069,0.04436238689494406,688,"Thanks George, that was the smoothest decent I’ve had in years!"
2426,679,9,36,129,174,1.3103448275862069,0.04283853212828547,688,My air-conditioning is extremely temperamental.
865,679,8,38,128,174,1.3103448275862069,0.04205590406650257,688,"Gosh Mike, you could have just gotten a flu shot."
1341,679,9,36,129,174,1.3103448275862069,0.04283853212828547,688,"This time, Mr. Aldrin, you can step off first."
1139,679,12,30,132,174,1.3103448275862069,0.045105012349759784,688,I see your dog is having flatulence problems again.
1691,679,12,30,132,174,1.3103448275862069,0.045105012349759784,688,Care to count us down?
2730,679,6,42,126,174,1.3103448275862069,0.04044524113836275,688,Bad weather. Launch aborted!
1035,679,12,30,132,174,1.3103448275862069,0.045105012349759784,688,"Not exactly a ride of your lifetime, right?"
3006,720,7,30,105,142,1.3098591549295775,0.04707305385797126,688,"Open the elevator doors, Hal."
3911,720,10,24,108,142,1.3098591549295775,0.05015518679176264,688,"A lot of pressure at work, sir?"
2709,722,12,30,133,175,1.3085714285714285,0.04488157848452404,688,"Yes, sir, the oxygen's a little thin these days in the president's suite."
5113,722,10,34,131,175,1.3085714285714285,0.04339346952340768,688,To the top Mr. Musk?
317,722,16,22,137,175,1.3085714285714285,0.04771877897882185,688,We’re a new military branch.  It’s the only simulator we’ve got.
1196,722,9,36,130,175,1.3085714285714285,0.04262993962331077,688,"Sorry, it stops at the penthouse."
1876,722,10,34,131,175,1.3085714285714285,0.04339346952340768,688,Who is Scottie?
4994,722,12,30,133,175,1.3085714285714285,0.04488157848452404,688,"Nice disguise, Comrade Rudy. The Putin penthouse tonight?"
3974,728,7,39,126,172,1.308139534883721,0.0415056475240337,688,Shall I announce you or will the Montforts recognize you?
3384,728,9,35,128,172,1.308139534883721,0.04311284829836726,688,You might have been oversold on the view.
3149,728,8,37,127,172,1.308139534883721,0.04231687881204941,688,"They certainly are building them taller than ever, aren't they, sir?"
3566,731,8,36,125,169,1.3076923076923077,0.04279604925109129,688,"If you are looking for more space, I suggest a suite."
2762,732,11,30,129,170,1.3058823529411765,0.04496745067440669,688,Try the stairs. Those have flights.
2803,732,7,38,125,170,1.3058823529411765,0.04175664070609713,688,I can take you as far as the penthouse. You’re on your own after that.
2880,732,10,32,128,170,1.3058823529411765,0.04418662666328943,688,"Yes, the Observation Deck is out of this world!"
2906,732,9,34,127,170,1.3058823529411765,0.04339175418909269,688,"10th floor....9,8,7..."
2996,732,10,32,128,170,1.3058823529411765,0.04418662666328943,688,"They say dress for the job you want, not the one you have"
3133,732,9,34,127,170,1.3058823529411765,0.04339175418909269,688,"You'll be wanting the lunar floor, sir."
3280,732,4,44,122,170,1.3058823529411765,0.039176218682196146,688,"The Stratosphere Lounge, madam?"
3390,732,11,30,129,170,1.3058823529411765,0.04496745067440669,688,"Some days, even a small step can feel like a giant leap."
3657,732,8,36,126,170,1.3058823529411765,0.042582046537623874,688,Your floor sir. Your room is one small step then a giant leap on the left.
3661,732,9,34,127,170,1.3058823529411765,0.04339175418909269,688,My doctor prescribed this for all future travel to New Jersey.
3765,732,10,32,128,170,1.3058823529411765,0.04418662666328943,688,"Sorry, that floor does not exist yet."""
3767,732,11,30,129,170,1.3058823529411765,0.04496745067440669,688,I’m afraid the Space Elevator is still theoretical.
3775,732,8,36,126,170,1.3058823529411765,0.042582046537623874,688,This is the ground floor. The eagle has landed.
3835,732,8,36,126,170,1.3058823529411765,0.042582046537623874,688,"Yes, this is the express elevator but this is as far as it goes."
3863,732,8,36,126,170,1.3058823529411765,0.042582046537623874,688,My employer got downsized but I’m keeping my uniform.
3882,732,11,30,129,170,1.3058823529411765,0.04496745067440669,688,The Otis has landed
3987,732,10,32,128,170,1.3058823529411765,0.04418662666328943,688,You know something I don't?
4053,732,10,32,128,170,1.3058823529411765,0.04418662666328943,688,"It's ok, sir. I don't know what mezzanine means either."
4065,732,11,30,129,170,1.3058823529411765,0.04496745067440669,688,"Shall I begin the countdown, sir?"
4201,732,9,34,127,170,1.3058823529411765,0.04339175418909269,688,"I agree sir, Space Needle is a bit misleading."
4305,732,9,34,127,170,1.3058823529411765,0.04339175418909269,688,It's laundry day.
4367,732,6,40,124,170,1.3058823529411765,0.04091458662608984,688,We don't have a Launch Cafe.  This is the floor for the lunch cafe.
4443,732,11,30,129,170,1.3058823529411765,0.04496745067440669,688,"Sir, did you park your ship on the roof again...?"
4511,732,13,26,131,170,1.3058823529411765,0.046489772087027426,688,Please tell me you’re only going to the penthouse.
4857,732,10,32,128,170,1.3058823529411765,0.04418662666328943,688,I assume you won't be needing a cab
4909,732,9,34,127,170,1.3058823529411765,0.04339175418909269,688,I heard that this hotel lacked atmosphere...
5071,732,10,32,128,170,1.3058823529411765,0.04418662666328943,688,"I'll have your rover brought around front, sir."
5128,732,9,34,127,170,1.3058823529411765,0.04339175418909269,688,Coming or going?
5091,732,12,28,130,170,1.3058823529411765,0.04573494576830147,688,You up?
5269,732,6,40,124,170,1.3058823529411765,0.04091458662608984,688,"The moon landing is down the hall to the right, Sir."
2596,732,8,36,126,170,1.3058823529411765,0.042582046537623874,688,I prefer the term Resident Alien
649,732,8,36,126,170,1.3058823529411765,0.042582046537623874,688,This is Venus. Mars is two floors up.
2526,732,11,30,129,170,1.3058823529411765,0.04496745067440669,688,No one on this floor knows you're Mike Pence.
2534,732,8,36,126,170,1.3058823529411765,0.042582046537623874,688,Is that you Scottie?
48,732,8,36,126,170,1.3058823529411765,0.042582046537623874,688,"Ad astra, please."
234,732,8,36,126,170,1.3058823529411765,0.042582046537623874,688,Can you count down this time?
340,732,4,44,122,170,1.3058823529411765,0.039176218682196146,688,Do you know something that I don't know?
414,732,11,30,129,170,1.3058823529411765,0.04496745067440669,688,"Going away for the holidays, Mr. Branson?"
433,732,9,34,127,170,1.3058823529411765,0.04339175418909269,688,Moon or Mars
689,732,9,34,127,170,1.3058823529411765,0.04339175418909269,688,"It's just under 240,000 miles. And yes, this hotel does provide free shuttle service."
952,732,9,34,127,170,1.3058823529411765,0.04339175418909269,688,"To infinity and beyond, ma’am?"
997,732,11,30,129,170,1.3058823529411765,0.04496745067440669,688,I'm afraid this is still Trump Tower sir.
1162,732,9,34,127,170,1.3058823529411765,0.04339175418909269,688,The agoraphobia clinic is on the left
1197,732,7,38,125,170,1.3058823529411765,0.04175664070609713,688,"Up, please!"
1252,732,5,42,123,170,1.3058823529411765,0.04005483434629997,688,"Will it be a short walk today, sir ?"
4,732,9,34,127,170,1.3058823529411765,0.04339175418909269,688,"Take me back up, Frank. I forgot my umbrella."
1359,732,10,32,128,170,1.3058823529411765,0.04418662666328943,688,C’mon. It’s not really that big of a leap.
1343,732,9,34,127,170,1.3058823529411765,0.04339175418909269,688,Mind the one small step.
2491,732,9,34,127,170,1.3058823529411765,0.04339175418909269,688,"Sorry, the closest I can get you is the 22nd floor."
2474,732,5,42,123,170,1.3058823529411765,0.04005483434629997,688,"Sorry sir, this is as high as we go."
2432,732,10,32,128,170,1.3058823529411765,0.04418662666328943,688,"Sir, you do know it’s casual Friday."
2334,732,8,36,126,170,1.3058823529411765,0.042582046537623874,688,"Mars is as high as we go. For Uranus, use Elevator Bank #7"
2439,732,8,36,126,170,1.3058823529411765,0.042582046537623874,688,Up.Wherever.
1489,732,9,34,127,170,1.3058823529411765,0.04339175418909269,688,"Once again, Mr Nunes, this will not take you to the Moon and I’m also sorry to add that failure IS your only option."
2040,732,9,34,127,170,1.3058823529411765,0.04339175418909269,688,Just practicing.
1960,732,11,30,129,170,1.3058823529411765,0.04496745067440669,688,"Trump re-elected, so, Mars, please"
2202,732,13,26,131,170,1.3058823529411765,0.046489772087027426,688,I took a Lyft. Don't ask.
3542,789,5,43,126,174,1.3045977011494252,0.039453580390338694,688,"Floor 84,092,800, please."
1641,789,13,27,134,174,1.3045977011494252,0.045695854845479666,688,Neil always dressed for the job he wanted.
2783,791,10,31,127,168,1.3035714285714286,0.04448396302390643,688,"Major Tom, Going for your nightly moon walk?"
2895,791,7,37,124,168,1.3035714285714286,0.04201148614394804,688,"Fourth floor: space suits & accessories, NASA notions, ISS home deco"
3396,791,8,35,125,168,1.3035714285714286,0.04285149901056963,688,"To infinity and beyond, sir?"
3436,791,7,37,124,168,1.3035714285714286,0.04201148614394804,688,"To achieve escape velocity, you should really take the express elevator."
4535,791,11,29,128,168,1.3035714285714286,0.045278129000014856,688,"One small step to exit, sir.  One giant leap to hail a taxi at this hour."
4676,791,8,35,125,168,1.3035714285714286,0.04285149901056963,688,"I'm sorry, the space elevator to the moon is across the hall. This one only goes into low orbit for interstellar spacecraft launches."
2519,791,5,41,122,168,1.3035714285714286,0.040278939523822055,688,I think sir might be a little disappointed by our free shuttle service.
3815,791,10,31,127,168,1.3035714285714286,0.04448396302390643,688,"Yes sir, I am opening the doors, but I'm afraid my name is not, nor ever has been, Hal."
4141,791,6,39,123,168,1.3035714285714286,0.04115433110370555,688,It's a bad air day.
4513,791,9,33,126,168,1.3035714285714286,0.043675358806569205,688,Where the hell do you think I’m going?
3607,791,13,25,130,168,1.3035714285714286,0.04682607141968468,688,"This is your floor Mr. Damon, or is it Mr. Clooney? Or is it Mr. Pitt?"
2497,791,11,29,128,168,1.3035714285714286,0.045278129000014856,688,I’m waiting for my career to take off
969,791,9,33,126,168,1.3035714285714286,0.043675358806569205,688,"Command modules, jet packs, and housewares are on this floor, sir."
1832,791,7,37,124,168,1.3035714285714286,0.04201148614394804,688,"Can you press Mars for me, please?"
1482,791,7,37,124,168,1.3035714285714286,0.04201148614394804,688,"Another small step, sir..."
1443,791,11,29,128,168,1.3035714285714286,0.045278129000014856,688,That’s one small step for Bill one giant surprise for the lobby.
298,791,7,37,124,168,1.3035714285714286,0.04201148614394804,688,Yeah...the new Space Force is underfunded.
200,791,9,33,126,168,1.3035714285714286,0.043675358806569205,688,Sic itur ad astra?
83,791,11,29,128,168,1.3035714285714286,0.045278129000014856,688,Laundry day?’
1987,791,6,39,123,168,1.3035714285714286,0.04115433110370555,688,"No, we don’t go that high."
5216,811,6,38,121,165,1.303030303030303,0.04160867428346732,688,Prepare for re-entry.
3851,811,8,34,123,165,1.303030303030303,0.04334860361813811,688,"Okay, I'll say it:""The Eagle has landed."""
1959,811,10,30,125,165,1.303030303030303,0.04502134044713949,688,"Last floor, sir. I told you Trump Tower isn't that yuuuge."
151,814,6,39,124,169,1.301775147928994,0.04094950615880426,688,"I don’t know about the moon, but here we have landed safely on the lobby, sir!"
1072,815,5,40,121,166,1.3012048192771084,0.04050599955388385,688,"Prepared for lift-off, sir?"
5077,815,4,42,120,166,1.3012048192771084,0.03959440174736139,688,Mission success. My ears didn't pop.
3437,815,10,30,126,166,1.3012048192771084,0.04478652420648602,688,First Floor—Planet Earth!
2227,818,6,37,120,163,1.3006134969325154,0.04185989670850455,688,"I understand your confusion.  Our brochure does say ""We Cater to the Stars""."
1088,819,6,39,125,170,1.3,0.04074660005376552,688,"Sorry, Commander. This is as high as we go."
416,819,6,39,125,170,1.3,0.04074660005376552,688,"Goodnight and godspeed, sir."
2973,819,6,39,125,170,1.3,0.04074660005376552,688,"Be careful, sir. That's one small step."
4429,822,7,39,131,177,1.2994350282485876,0.04051302661603364,688,"2,787,322nd floor, sir?"
3452,823,7,36,124,167,1.2994011976047903,0.04205507403214372,688,"Sorry, only 'Gold Club' members are authorized to access that floor."
4752,824,13,23,128,164,1.298780487804878,0.047517984537068673,688,It wasn't me.
4554,824,11,27,126,164,1.298780487804878,0.04591650527087863,688,"I said, ""MARS!"""
4463,824,10,29,125,164,1.298780487804878,0.045094442642119315,688,"Sir, the Stratosphere is a wine bar."
1930,824,13,23,128,164,1.298780487804878,0.047517984537068673,688,"Floor 238,901 please"
3892,824,6,37,121,164,1.298780487804878,0.041644230823181784,688,..Top floor I suppose?
1063,824,7,35,122,164,1.298780487804878,0.04253303022289477,688,"They lost your luggage.again, didn't they?"
813,824,9,31,124,164,1.298780487804878,0.044257113079324915,688,Apollo you say? Is David Bowie performing?
1606,824,9,31,124,164,1.298780487804878,0.044257113079324915,688,"10,034,849th floor. Going up!"""
743,824,7,35,122,164,1.298780487804878,0.04253303022289477,688,"Yes, the prices in this place are astronomical."
686,824,10,29,125,164,1.298780487804878,0.045094442642119315,688,"Mr. President
Ready to activate your exit strategy?"
2611,834,6,36,119,161,1.2981366459627328,0.04211482427449895,688,NASA's budget was cut again?
2661,834,11,26,124,161,1.2981366459627328,0.0464957759526164,688,"""Good morning, Commander, the President will be happy to see you after the Space Force goes on CNN  and announces it will investigate the Bidens."
2796,834,7,34,120,161,1.2981366459627328,0.04302671466919966,688,"Sorry, sir, the 12th floor is as high as we go."
3008,834,10,28,123,161,1.2981366459627328,0.045653230223973267,688,Should I countdown first?
3247,834,11,26,124,161,1.2981366459627328,0.0464957759526164,688,'It really is just a small step.'
3480,834,6,36,119,161,1.2981366459627328,0.04211482427449895,688,Just landed... Long flight
3619,834,8,32,121,161,1.2981366459627328,0.043919675850096124,688,"I apologize again, sir. My wife's chili."
3660,834,8,32,121,161,1.2981366459627328,0.043919675850096124,688,Great outfit for flu season!
3853,834,8,32,121,161,1.2981366459627328,0.043919675850096124,688,Do you mind giving me my Christmas tip before you blast off ?
4018,834,3,42,116,161,1.2981366459627328,0.03925225049616316,688,"The elevator, uh ... I mean, the eagle has landed, Mr. Jenkins."
4052,834,8,32,121,161,1.2981366459627328,0.043919675850096124,688,I have to pee.
2592,834,9,30,122,161,1.2981366459627328,0.04479483986275999,688,I forgot the keys to the ship on my dresser.
4073,834,11,26,124,161,1.2981366459627328,0.0464957759526164,688,"Close the elevator doors, HAL"
4108,834,8,32,121,161,1.2981366459627328,0.043919675850096124,688,"“Trust me, the whole Universe is an awkward silence.”"
4620,834,9,30,122,161,1.2981366459627328,0.04479483986275999,688,"95,794th floor, please."
4767,834,5,38,118,161,1.2981366459627328,0.0411827472628907,688,I think you'll find this floor has the atmosphere you're looking for...
4917,834,9,30,122,161,1.2981366459627328,0.04479483986275999,688,Welcome to Venice.
4965,834,9,30,122,161,1.2981366459627328,0.04479483986275999,688,"My God, the lengths you one-percenters will go to avoid tipping at the holidays!"
5035,834,9,30,122,161,1.2981366459627328,0.04479483986275999,688,Some people will do anything to avoid tipping.
5147,834,9,30,122,161,1.2981366459627328,0.04479483986275999,688,I'm here for the launch party.
4031,834,11,26,124,161,1.2981366459627328,0.0464957759526164,688,"You were right, the Penthouse view was breathtaking!"
2548,834,7,34,120,161,1.2981366459627328,0.04302671466919966,688,"You say ""Singularity?"""
4383,834,9,30,122,161,1.2981366459627328,0.04479483986275999,688,I may have misunderstood space for rent.
2266,834,6,36,119,161,1.2981366459627328,0.04211482427449895,688,These new skyscrapers just keep getting higher and higher.
6,834,10,28,123,161,1.2981366459627328,0.045653230223973267,688,Today Mr. Kubrick said we’ re shooting the ‘one small step for man’ scene
248,834,12,24,125,161,1.2981366459627328,0.047323323351056996,688,"Darn it, | forgot the flag."
381,834,7,34,120,161,1.2981366459627328,0.04302671466919966,688,"Please watch your one small step, sir."
431,834,8,32,121,161,1.2981366459627328,0.043919675850096124,688,Would that be the stratosphere or exosphere sir?
539,834,4,40,117,161,1.2981366459627328,0.040229080533444164,688,It's not exactly a giant leap for mankind
840,834,9,30,122,161,1.2981366459627328,0.04479483986275999,688,""" I guess I'll never understand why you don't just get a flu shot like everyone else."
1025,834,7,34,120,161,1.2981366459627328,0.04302671466919966,688,The stairway to heaven will reopen in 2020.
1095,834,6,36,119,161,1.2981366459627328,0.04211482427449895,688,I can step out if you need some space.
1254,834,10,28,123,161,1.2981366459627328,0.045653230223973267,688,They've really fixed up the place since you were here last.
564,834,13,22,126,161,1.2981366459627328,0.04813664596273292,688,"Where are you going?
""To where no man has gone before!""

Next stop...Ladies Lingerie."
1329,834,7,34,120,161,1.2981366459627328,0.04302671466919966,688,Rooftop bar sir?
2028,834,8,32,121,161,1.2981366459627328,0.043919675850096124,688,It does take time to acclimate.
1895,834,8,32,121,161,1.2981366459627328,0.043919675850096124,688,"No sir, Cape Canaveral is three blocks south."
1321,834,7,34,120,161,1.2981366459627328,0.04302671466919966,688,Can you press ‘Take Off’ for me?
1815,834,8,32,121,161,1.2981366459627328,0.043919675850096124,688,"Top floor. Linens, house appliances, Atlas V rockets."
1519,834,9,30,122,161,1.2981366459627328,0.04479483986275999,688,"Again, Mrs. Kramden?"
1883,834,9,30,122,161,1.2981366459627328,0.04479483986275999,688,Fifth floor; space heaters.
1419,834,5,38,118,161,1.2981366459627328,0.0411827472628907,688,The restaurant at the top has great food but no atmosphere.
1411,834,7,34,120,161,1.2981366459627328,0.04302671466919966,688,"And here we are sir, back on Earth."
2473,834,7,34,120,161,1.2981366459627328,0.04302671466919966,688,Will you be taking our shuttle?
2922,878,7,33,118,158,1.2974683544303798,0.043536976558959106,688,"The Skylounge is open until moonset, Mr. Musk"
4257,878,9,29,120,158,1.2974683544303798,0.045351070969297406,688,"July 16, 1973, Neil became the first man to stay at the Ramada."
5320,878,10,27,121,158,1.2974683544303798,0.04623143187427464,688,"That's one small step for man, one giant leap for men's suits, lingerie,  and casual wear."
5141,878,9,29,120,158,1.2974683544303798,0.045351070969297406,688,Hail a capsule for you?
1141,878,13,21,124,158,1.2974683544303798,0.04877727194499545,688,"Yes, I'm with the new Space Force."
1420,878,12,23,123,158,1.2974683544303798,0.047943681578625066,688,I’d watch out. ICE is on the lookout for aliens.
2884,878,5,37,116,158,1.2974683544303798,0.04164393134333573,688,"I’m sorry, only 44 floors."
2962,878,9,29,120,158,1.2974683544303798,0.045351070969297406,688,I think this means you're not going on the Moon mission.
3921,878,8,31,119,158,1.2974683544303798,0.04445327865274734,688,You'll  get there faster in the express elevator.
4551,878,10,27,121,158,1.2974683544303798,0.04623143187427464,688,"I couldn't tell you whether it's an alien atmosphere, sir. I haven't been outside of this elevator since 1962."
5028,888,9,23,106,138,1.2971014492753623,0.0497634521828742,688,"Non-smoking, I take it?"
4831,888,7,27,104,138,1.2971014492753623,0.04759021041730343,688,"Yessir, just one small step."
3237,888,10,21,107,138,1.2971014492753623,0.0508152309446115,688,My dance instructor says tonight we're going to learn to moonwalk.
510,891,9,31,125,165,1.2969696969696969,0.044025325662036485,688,I can get you as far as the 90th floor...
716,891,12,25,128,165,1.2969696969696969,0.04647535679981963,688,"200,000th floor please."
4195,891,8,33,124,165,1.2969696969696969,0.04317776591766852,688,We're only going to the penthouse.
5154,891,9,31,125,165,1.2969696969696969,0.044025325662036485,688,"Kind of like yours, it has its ups and downs."
1276,895,11,26,125,162,1.2962962962962963,0.04624450749546494,688,We could go as a bellhop and a spaceman
2974,895,12,24,126,162,1.2962962962962963,0.04706629058678449,688,"I was listening to '""Fly Me to the Moon"" a month ago and got stuck in a song loop."
3945,895,4,40,118,162,1.2962962962962963,0.040022316534496484,688,"I assure you, he hasn't LITERALLY sucked all the oxygen out of the room."
4378,895,7,34,121,162,1.2962962962962963,0.04279987767613371,688,It's a marvelous night for a moondance!
1975,899,12,23,124,159,1.2955974842767295,0.047677915156001414,688,"100,000,000th floor ?"
4995,899,7,33,119,159,1.2955974842767295,0.04330272640519104,688,"I guess this is the day I finally get to hit THAT button, Mr. Musk."
2847,899,11,25,123,159,1.2955974842767295,0.046835585805270565,688,Going up--or going down?
2570,899,9,29,121,159,1.2955974842767295,0.0451037593324863,688,Can you hear me Major Tom?
2118,899,9,29,121,159,1.2955974842767295,0.0451037593324863,688,Welcome to Mars. Turn left for the immigration line.
2178,899,9,29,121,159,1.2955974842767295,0.0451037593324863,688,Up sir?
5041,899,12,23,124,159,1.2955974842767295,0.047677915156001414,688,I'm afraid even our largest accommodations won't provide you with the space you need.
2164,899,10,27,122,159,1.2955974842767295,0.0459778272847125,688,The Lift Off Will BeDisapointing
3067,899,9,29,121,159,1.2955974842767295,0.0451037593324863,688,"Frankly sir, I found your countdown from the 10th floor a little nerve racking."
2436,899,9,29,121,159,1.2955974842767295,0.0451037593324863,688,"I'm afraid this is going down, sir."
3171,899,7,33,119,159,1.2955974842767295,0.04330272640519104,688,"To Mars, Mr. Musk?"
4123,899,7,33,119,159,1.2955974842767295,0.04330272640519104,688,Another soft landing sir.
3610,899,8,31,120,159,1.2955974842767295,0.04421241465949171,688,I guess flu season started
3681,899,9,29,121,159,1.2955974842767295,0.0451037593324863,688,"This is as close as we get to Mars, Sir"
3915,899,10,27,122,159,1.2955974842767295,0.0459778272847125,688,I guess you have to get creative Mr. Giuliani.
4239,899,7,33,119,159,1.2955974842767295,0.04330272640519104,688,Need a lift?
4261,899,4,39,116,159,1.2955974842767295,0.040451101671311815,688,Is the flu season early this year?
4460,899,10,27,122,159,1.2955974842767295,0.0459778272847125,688,"5th Floor, Vaccuums"
4526,899,9,29,121,159,1.2955974842767295,0.0451037593324863,688,"Third Floor: Cosmetics, Hosiery, High Acceleration G-Force Training Centrifuges and Women's Lingerie."
4817,899,7,33,119,159,1.2955974842767295,0.04330272640519104,688,That's one small step as you leave the elevator.
4625,899,9,29,121,159,1.2955974842767295,0.0451037593324863,688,"Shall I press, Lift Off?"
4696,899,3,41,115,159,1.2955974842767295,0.03945478590136814,688,Out of Tang again Sir?
3292,899,8,31,120,159,1.2955974842767295,0.04421241465949171,688,Ready?
1884,899,6,35,118,159,1.2955974842767295,0.04237351316828499,688,I know just how you feel-‘Going up?’ jokes....I’m so over it.
1147,899,9,29,121,159,1.2955974842767295,0.0451037593324863,688,"We've landed sir, welcome to the dark side."
1635,899,9,29,121,159,1.2955974842767295,0.0451037593324863,688,Looks like you've still got a long ways to go.
262,899,7,33,119,159,1.2955974842767295,0.04330272640519104,688,"I am not sure if this is enough but this is the highest we can  go, sir"
378,899,7,33,119,159,1.2955974842767295,0.04330272640519104,688,Another complaint about the Monolith on 42?
645,899,10,27,122,159,1.2955974842767295,0.0459778272847125,688,Watch your one small step.
733,899,6,35,118,159,1.2955974842767295,0.04237351316828499,688,NASA budget cuts?
900,899,9,29,121,159,1.2955974842767295,0.0451037593324863,688,Welcome back to the ground floor Commander.
938,899,8,31,120,159,1.2955974842767295,0.04421241465949171,688,Watch out for that one small step!
949,899,10,27,122,159,1.2955974842767295,0.0459778272847125,688,"Intergalactic level, sir?"
1030,899,9,29,121,159,1.2955974842767295,0.0451037593324863,688,"Sir,this is as high as we go."
1055,899,5,37,117,159,1.2955974842767295,0.04142346101332932,688,Let me off at the top
1075,899,11,25,123,159,1.2955974842767295,0.046835585805270565,688,"To the penthouse, sir?"
896,899,10,27,122,159,1.2955974842767295,0.0459778272847125,688,I’mlookingforthespacebar
1112,899,9,29,121,159,1.2955974842767295,0.0451037593324863,688,"Just one small step, Sir, and then one giant leap."
1081,899,12,23,124,159,1.2955974842767295,0.047677915156001414,688,Press 'Ignition' please.
1617,899,9,29,121,159,1.2955974842767295,0.0451037593324863,688,"Are you one of us, Sir ?"
1465,899,12,23,124,159,1.2955974842767295,0.047677915156001414,688,"10 to the what power, floor?"
1349,899,7,33,119,159,1.2955974842767295,0.04330272640519104,688,Headed to an outer borough?
1636,899,5,37,117,159,1.2955974842767295,0.04142346101332932,688,To the roof?
1250,899,7,33,119,159,1.2955974842767295,0.04330272640519104,688,"I know it’s a small one, but please watch your step as you exit."
1213,899,8,31,120,159,1.2955974842767295,0.04421241465949171,688,And ground floor for Major Tom.
1170,899,6,35,118,159,1.2955974842767295,0.04237351316828499,688,"Watch your step now, Mr. Aldrin."
1506,945,8,31,121,160,1.29375,0.04397404448137918,688,"What level is the hoax photoshoot on, please?"
1007,945,8,31,121,160,1.29375,0.04397404448137918,688,"Three, Spacewear and Ladies’ better dresses."
4924,945,9,29,122,160,1.29375,0.04485903409851324,688,"Hello, Major Tom.  Welcome to Ground Control."
780,948,9,28,120,157,1.2929936305732483,0.045418145909484696,688,"It's just one small step, man."
1239,948,12,22,123,157,1.2929936305732483,0.048039420581846765,688,"Welcome to the alternate universe of the Trump Tower, Penthouse!"
2891,948,10,26,121,157,1.2929936305732483,0.04630839335566878,688,The perfume department sir.
3843,951,10,25,119,154,1.2922077922077921,0.04691060391649483,688,"I'm sorry, sir. The aerospace conference was yesterday."
3784,951,4,37,113,154,1.2922077922077921,0.04112554112554113,688,I think you'll find our lobby pleasantly terrestrial.
3425,951,5,35,114,154,1.2922077922077921,0.042144899699633746,688,3...2...1........Lobby!
3646,951,7,31,116,154,1.2922077922077921,0.0441130076773214,688,"To the penthouse, and beyond, as usual?"
3382,951,10,25,119,154,1.2922077922077921,0.04691060391649483,688,"So what!  You have a uniform for work, too!  So what's the BFD?"
3325,951,7,31,116,154,1.2922077922077921,0.0441130076773214,688,I need to run out for a Mars Bar
3046,951,9,27,118,154,1.2922077922077921,0.04599698166169869,688,"I'm sorry, but the sky's the limit."
3734,951,12,21,121,154,1.2922077922077921,0.04868644200860737,688,When should I say you will be back from Mars if your wife asks?
3341,951,7,31,116,154,1.2922077922077921,0.0441130076773214,688,"Well Sir, It's just one small step."
4816,951,9,27,118,154,1.2922077922077921,0.04599698166169869,688,"The decor might be a little bland, but literally speaking, it does have atmosphere."
4289,951,7,31,116,154,1.2922077922077921,0.0441130076773214,688,Someone always does fart in the elevator don’t they.
4352,951,9,27,118,154,1.2922077922077921,0.04599698166169869,688,How high can you take me?
4387,951,9,27,118,154,1.2922077922077921,0.04599698166169869,688,"The buffet’s just past the monolith—if you become the star baby, you’ve passed it."
4590,951,7,31,116,154,1.2922077922077921,0.0441130076773214,688,"Yes, Sir, I believe the flu season is nearly over."
4681,951,6,33,115,154,1.2922077922077921,0.0431401785869716,688,I'm afraid the elevator doesn't go... quite that far up.
4760,951,8,29,117,154,1.2922077922077921,0.04506484088691572,688,You'll have to get off and change over to the express on 42.
2714,951,9,27,118,154,1.2922077922077921,0.04599698166169869,688,"Holodeck, please!"
4958,951,6,33,115,154,1.2922077922077921,0.0431401785869716,688,"Where we're going, we don't need elevators."
5112,951,9,27,118,154,1.2922077922077921,0.04599698166169869,688,It’s no problem. I need the overtime.
5252,951,11,23,120,154,1.2922077922077921,0.047806769370392244,688,Talking apes? You've been gone an hour and a half.
3923,951,8,29,117,154,1.2922077922077921,0.04506484088691572,688,"Yes, sir. You certainly can't be too careful, sir."
2536,951,10,25,119,154,1.2922077922077921,0.04691060391649483,688,This is as high as NASA will go these days.
255,951,10,25,119,154,1.2922077922077921,0.04691060391649483,688,"Erm, going up?"
2272,951,13,19,122,154,1.2922077922077921,0.04955050023240031,688,One of us is in the wrong place.
2206,951,6,33,115,154,1.2922077922077921,0.0431401785869716,688,Slip the surly bonds of this elevator.
2150,951,6,33,115,154,1.2922077922077921,0.0431401785869716,688,"Going up is easy, coming down is hard."
1941,951,10,25,119,154,1.2922077922077921,0.04691060391649483,688,"That's one small step for man, one giant leap for germaphobes!"
1643,951,9,27,118,154,1.2922077922077921,0.04599698166169869,688,Watch that first step....it's a doozy.
1542,951,9,27,118,154,1.2922077922077921,0.04599698166169869,688,"This IS the top floor, sir."
1294,951,8,29,117,154,1.2922077922077921,0.04506484088691572,688,"Very true, Sir!  We’ve both had our ups and downs!”"
1281,951,8,29,117,154,1.2922077922077921,0.04506484088691572,688,So they still don't have women's toilets?
901,951,7,31,116,154,1.2922077922077921,0.0441130076773214,688,Can you hear me now Major Tom?
643,951,6,33,115,154,1.2922077922077921,0.0431401785869716,688,"And how is your application to the Mars colonization program coming along, Mr. Dickson?"
245,951,6,33,115,154,1.2922077922077921,0.0431401785869716,688,YOU DO KNOW WHEN YOU INTERVIEW FOR NASA THEY DON’T MAKE YOU WEAR THE SUIT?
104,951,11,23,120,154,1.2922077922077921,0.047806769370392244,688,FORGET YOUR KEYS AGAIN?
2348,951,6,33,115,154,1.2922077922077921,0.0431401785869716,688,"Apparently, 'wear a suit to the interview' was not open to interpretation."
373,987,4,32,101,137,1.2919708029197081,0.04415197798397687,688,"Yes, sir. Fresh paint, new carpet, and ready to colonize."
3648,988,6,35,120,161,1.2919254658385093,0.041925465838509306,688,"Straight to the top, I assume?"
4324,989,12,22,124,158,1.2911392405063291,0.04777041147232562,688,"Terrible disguise, Mr. Trump!  Congress will see right through ya.
Don’tcha know?  You can try an’ hide, but you cain’t always run!"
919,990,8,29,118,155,1.2903225806451613,0.04481282764116549,688,This is the top floor.
2320,991,8,28,116,152,1.2894736842105263,0.04537860074596002,688,It suits you.
3697,991,7,30,115,152,1.2894736842105263,0.04440809644558711,688,"This is ground control, Major."
1611,993,10,26,123,159,1.2893081761006289,0.04579778882396355,688,"Floor ten please... then nine... eight... seven... six..."""
3764,994,6,27,102,135,1.288888888888889,0.0468660354734897,688,"Here for the Kubrick Cosplay, Sir?"
804,994,7,25,103,135,1.288888888888889,0.048031069116936574,688,Fifth floor.  Men's underwear.
547,996,8,28,117,153,1.2875816993464053,0.04512071739016899,688,not much of a skyscraper.
2037,996,13,18,122,153,1.2875816993464053,0.04965758449452629,688,It's a Blue Moon tonight.
3049,996,7,30,116,153,1.2875816993464053,0.044157443605784004,688,I'm sorry sir but this elevator does not go that high.
4523,996,9,26,118,153,1.2875816993464053,0.04606385187768173,688,You'll have to walk from 12.
4237,996,7,30,116,153,1.2875816993464053,0.044157443605784004,688,"Please sir, it’s just a small step for a man."
4491,996,6,32,115,153,1.2875816993464053,0.04317268249474997,688,"Actually, down."
4794,996,5,34,114,153,1.2875816993464053,0.042164928575618224,688,"No sir, it's not. But this is as high as we go."
4939,996,8,28,117,153,1.2875816993464053,0.04512071739016899,688,I'm still going to talk to you.
3279,996,11,22,120,153,1.2875816993464053,0.04789443677317868,688,I’m going to meet Mrs. Kramden.
3484,996,10,24,119,153,1.2875816993464053,0.04698805977920887,688,Did you get your flu shot?
2926,1006,5,34,115,154,1.2857142857142858,0.041931838371378836,688,Floor 453244 please.
3613,1006,6,30,111,147,1.2857142857142858,0.04423739552038088,688,Let’s defy gravity.
4533,1006,5,34,115,154,1.2857142857142858,0.041931838371378836,688,"I believe this is your planet, sir."
5308,1009,5,35,118,158,1.2848101265822784,0.04123757930113808,688,"I assure you sir. Every floor of our hotel has enough atmospheric pressure, that that, won't be necessary."
5313,1010,11,21,119,151,1.2847682119205297,0.04826113975988858,688,Aren't you in my triskaidekaphobia support group?
5069,1010,7,29,115,151,1.2847682119205297,0.04445150984973728,688,"Yes, Mr. Musk, we think we found your Tesla."
5054,1010,8,27,116,151,1.2847682119205297,0.04543387446247395,688,"That’s one small step for a man, a thousand fewer steps than if you took the stairs."
4629,1010,10,23,118,151,1.2847682119205297,0.04733748398650847,688,"Are you here for the taxi to NASA, the limo to MGM, or the shuttle to the hotel Halloween party?"
4414,1010,7,29,115,151,1.2847682119205297,0.04445150984973728,688,"I got on the wrong elevator, didn’t I?"
4318,1010,5,33,113,151,1.2847682119205297,0.04241858421046354,688,I think you want a much higher floor.
3885,1010,10,23,118,151,1.2847682119205297,0.04733748398650847,688,"One small step for man, one giant leap for elevator music."
2812,1010,5,33,113,151,1.2847682119205297,0.04241858421046354,688,This is the mezzanine. You want the lunar landing.
2739,1010,7,29,115,151,1.2847682119205297,0.04445150984973728,688,You're an optimist.
2094,1010,7,29,115,151,1.2847682119205297,0.04445150984973728,688,"No, this is the lunch floor."
2092,1010,9,25,117,151,1.2847682119205297,0.04639544341228343,688,"Yes sir. Space Force Recruitment, 13th floor."
1456,1010,11,21,119,151,1.2847682119205297,0.04826113975988858,688,"Moon roof, please."
2182,1010,6,31,114,151,1.2847682119205297,0.043446938985050934,688,"No need for the space suit, I heard she's not contagious anymore."
1353,1010,5,33,113,151,1.2847682119205297,0.04241858421046354,688,Moon exhibit? Observation level sir.
1184,1010,5,33,113,151,1.2847682119205297,0.04241858421046354,688,She said not that kind of space.
309,1010,6,31,114,151,1.2847682119205297,0.043446938985050934,688,Good afternoon Mr Aldrin
270,1010,5,33,113,151,1.2847682119205297,0.04241858421046354,688,An itchy nose is only one of the problems.
156,1010,6,31,114,151,1.2847682119205297,0.043446938985050934,688,Year 2050 “Heading out to Central  Park sir?”
122,1010,7,29,115,151,1.2847682119205297,0.04445150984973728,688,"you know, there’s a shuttle."
1416,1010,7,29,115,151,1.2847682119205297,0.04445150984973728,688,Take one small step.
3515,1030,9,24,115,148,1.2837837837837838,0.047010794061335605,688,Wait a second this isn’t mars
3392,1030,8,26,114,148,1.2837837837837838,0.04602266935891564,688,"Way up, please"
3258,1030,4,34,110,148,1.2837837837837838,0.04183744066612026,688,Cutbacks.
3241,1030,8,26,114,148,1.2837837837837838,0.04602266935891564,688,"No, this is the second landing."
3064,1030,7,28,113,148,1.2837837837837838,0.04501285851357185,688,I assume going up?
2766,1030,9,24,115,148,1.2837837837837838,0.047010794061335605,688,"Which planet, please?"
2585,1030,7,28,113,148,1.2837837837837838,0.04501285851357185,688,"Sorry, this is as high as I go"
2185,1030,7,28,113,148,1.2837837837837838,0.04501285851357185,688,Now boldly go where the last tenant went before.
2175,1030,3,36,109,148,1.2837837837837838,0.040723982837314654,688,"Going up, way up."
2180,1030,8,26,114,148,1.2837837837837838,0.04602266935891564,688,"Yeah we told them it wouldn't work either, but they cut NASA funding"
2219,1030,9,24,115,148,1.2837837837837838,0.047010794061335605,688,"Going to the EPA hearing, Mr. Wheeler?"
2243,1030,10,22,116,148,1.2837837837837838,0.0479785725260198,688,Up.  Waaaay up!
2333,1030,4,34,110,148,1.2837837837837838,0.04183744066612026,688,"Mars to the right, Venus to the left."
3601,1030,6,30,112,148,1.2837837837837838,0.0439798677602105,688,Eighth Floor - Atrium Level. You will want to walk to your right for the launch platform. Good Luck!
2258,1030,7,28,113,148,1.2837837837837838,0.04501285851357185,688,"Several of my bosses consider me a 'space cadet', so the suit became inevitable."
2368,1030,6,30,112,148,1.2837837837837838,0.0439798677602105,688,"Sir, we're going down..."
3712,1030,8,26,114,148,1.2837837837837838,0.04602266935891564,688,"134,112th floor, please."
3523,1030,5,32,111,148,1.2837837837837838,0.04292202354093255,688,"8,473,600th floor please."
3727,1030,6,30,112,148,1.2837837837837838,0.0439798677602105,688,Here you are sir...floor 2001
4907,1030,8,26,114,148,1.2837837837837838,0.04602266935891564,688,The whato-sphere?
4725,1030,9,24,115,148,1.2837837837837838,0.047010794061335605,688,"You're right, the prices are astronomical, 
but the food is out of this world."
4697,1030,6,30,112,148,1.2837837837837838,0.0439798677602105,688,Are you sure you’re from around here?
4653,1030,7,28,113,148,1.2837837837837838,0.04501285851357185,688,Back from the moon already.
4516,1030,9,24,115,148,1.2837837837837838,0.047010794061335605,688,Moon rocks on this floor
4434,1030,4,34,110,148,1.2837837837837838,0.04183744066612026,688,"The Starlight Ballroom is straight ahead, Sir."
4276,1030,6,30,112,148,1.2837837837837838,0.0439798677602105,688,NASA has really cut its training budget.
3723,1030,7,28,113,148,1.2837837837837838,0.04501285851357185,688,Perhaps I ordered the wrong shuttle for you?
2057,1030,9,24,115,148,1.2837837837837838,0.047010794061335605,688,Looks like another week for the sanitation workers' strike.
4071,1030,7,28,113,148,1.2837837837837838,0.04501285851357185,688,"Well, yes sir I did say the penthouse suite was rarefied air, but..."
4043,1030,7,28,113,148,1.2837837837837838,0.04501285851357185,688,Back to the moon again?
3998,1030,6,30,112,148,1.2837837837837838,0.0439798677602105,688,"Please exit, it's just one small step"
3898,1030,5,32,111,148,1.2837837837837838,0.04292202354093255,688,"Beam me up to the top floor, please."
3838,1030,7,28,113,148,1.2837837837837838,0.04501285851357185,688,I'd try the express.
3797,1030,8,26,114,148,1.2837837837837838,0.04602266935891564,688,NASA having issues with the microgravity machine again?
3762,1030,9,24,115,148,1.2837837837837838,0.047010794061335605,688,Seriously?  For 12 floors?
4084,1030,8,26,114,148,1.2837837837837838,0.04602266935891564,688,I don't take chances with air quality anymore.
1980,1030,10,22,116,148,1.2837837837837838,0.0479785725260198,688,"Ok, if I must... 10!..9!...8!..7!.."
2292,1030,7,28,113,148,1.2837837837837838,0.04501285851357185,688,"Floor 12 ... liquid oxygen, launch pads, multistage rockets, flight plans..."
1828,1030,7,28,113,148,1.2837837837837838,0.04501285851357185,688,Just relax and press the buttons in exactly the order I tell you.
281,1030,7,28,113,148,1.2837837837837838,0.04501285851357185,688,"Seventh floor, Space Suits, Jet packs, Tang..."
318,1030,7,28,113,148,1.2837837837837838,0.04501285851357185,688,Lift-off in five...four...three...two...
336,1030,5,32,111,148,1.2837837837837838,0.04292202354093255,688,You'll have better luck with the express elevator.
341,1030,8,26,114,148,1.2837837837837838,0.04602266935891564,688,Space Available” just meant there’s an office to rent.
397,1030,11,20,117,148,1.2837837837837838,0.04892721211137803,688,Moon Lounge. Watch your step.
577,1030,11,20,117,148,1.2837837837837838,0.04892721211137803,688,"It’s suit AND tie for gentlemen in our dining room, after six."
640,1030,3,36,109,148,1.2837837837837838,0.040723982837314654,688,"It appears everyone's gone out for launch, sir."
672,1030,9,24,115,148,1.2837837837837838,0.047010794061335605,688,Going up! in 3...2...1...
701,1030,6,30,112,148,1.2837837837837838,0.0439798677602105,688,The stairway to the stars is around the corner to the right.
710,1030,6,30,112,148,1.2837837837837838,0.0439798677602105,688,"Actually, it’s also a small step for mankind."
815,1030,10,22,116,148,1.2837837837837838,0.0479785725260198,688,"Good luck with your interview to lead the Space Force, sir."
820,1030,7,28,113,148,1.2837837837837838,0.04501285851357185,688,Going way up?
889,1030,7,28,113,148,1.2837837837837838,0.04501285851357185,688,To the roof garden - and Beyond!
864,1030,8,26,114,148,1.2837837837837838,0.04602266935891564,688,Top floor. From here you're on your own.
1099,1030,8,26,114,148,1.2837837837837838,0.04602266935891564,688,I think the smog report was a little overstated.
1761,1030,7,28,113,148,1.2837837837837838,0.04501285851357185,688,"Observation deck, sir?"
1756,1030,7,28,113,148,1.2837837837837838,0.04501285851357185,688,"Bringing your work home again, Ms. Davis?"
1565,1030,3,36,109,148,1.2837837837837838,0.040723982837314654,688,Initiating door closing sequence...up button engaged...and departing in 10...9...8...
1338,1030,4,34,110,148,1.2837837837837838,0.04183744066612026,688,Stage 2 please.
1219,1030,8,26,114,148,1.2837837837837838,0.04602266935891564,688,It's HAL's day off today.
1187,1030,5,32,111,148,1.2837837837837838,0.04292202354093255,688,"It’s nice, but it lacks atmosphere."
904,1030,6,30,112,148,1.2837837837837838,0.0439798677602105,688,"Top floor, I'm assuming?"
971,1030,5,32,111,148,1.2837837837837838,0.04292202354093255,688,"Where you the thump on the roof, sir?"
1979,1030,5,32,111,148,1.2837837837837838,0.04292202354093255,688,Know when the shuttle bus gets here?
945,1030,3,36,109,148,1.2837837837837838,0.040723982837314654,688,Out of  order sir. The small steps for man are on your left.
943,1030,10,22,116,148,1.2837837837837838,0.0479785725260198,688,How did you know my name is Scottie?
909,1030,7,28,113,148,1.2837837837837838,0.04501285851357185,688,"Good evening, Mr. Musk. Launch pad I presume?"
959,1030,9,24,115,148,1.2837837837837838,0.047010794061335605,688,"10,000th Floor Observation Deck"
593,1097,7,24,103,134,1.2835820895522387,0.04809458881742017,688,It's about 29 small steps to the hotel bar.
1085,1097,8,22,104,134,1.2835820895522387,0.049247439772548224,688,"International space station, please."
2969,1097,7,24,103,134,1.2835820895522387,0.04809458881742017,688,Enjoy your stay in LA
135,1097,9,20,105,134,1.2835820895522387,0.05037391363379276,688,My apologies. Maybe we lied when we said our rooftop view was “out of this world...”
4135,1097,6,26,102,134,1.2835820895522387,0.046913416235472225,688,If you're looking for the new Space Force- you've got the wrong building.
1383,1102,9,27,123,159,1.2830188679245282,0.04473032666294518,688,Between us... the oxygen bar at 59th and 3rd is substandard.
4361,1102,6,33,120,159,1.2830188679245282,0.04197579821365831,688,"Until people start vaccinating their kids again, I'm not taking any chances."
5270,1104,9,25,118,152,1.2828947368421053,0.046127261145655206,688,"Up, I assume."
2462,1105,8,25,112,145,1.282758620689655,0.04663324775885241,688,"I see you have prepared for their toxic culture, Sir."
859,1106,8,26,115,149,1.2818791946308725,0.045752408340147585,688,I took HRs advice and dressed for the job I want
223,1107,8,24,110,142,1.2816901408450705,0.04726692437588792,688,"— On which floor Mr Apollo?  - 11, please."
4225,1108,7,24,104,135,1.2814814814814814,0.04778319825611717,688,"110th floor. Oxygen tanks, jet fuel and moon boots."
3466,1108,8,22,105,135,1.2814814814814814,0.04892639732390831,688,"Moon, Mars, or Jupiter?"
3439,1110,6,29,111,146,1.2808219178082192,0.04426820678301526,688,"I understand, Mr. Jones. You're leaving because you just need more space."
1721,1110,5,31,110,146,1.2808219178082192,0.04318797078463212,688,BUT MR. JONES YOUR APARTMENT IS ONLY ON THE FOURTH FLOOR.....!!
511,1110,7,27,112,146,1.2808219178082192,0.045322703395465715,688,"Sir, this elevator only goes to the 55th floor. If you want to go to the moon you will have to transfer to another elevator."
1094,1113,8,24,111,143,1.2797202797202798,0.04697654169764333,688,NASA cutbacks?
1336,1113,12,16,115,143,1.2797202797202798,0.050997722447463895,688,You don’t look like you need a cab.
1368,1113,7,26,110,143,1.2797202797202798,0.045916254351056195,688,Is there something about the 17th floor that i need to know?
150,1113,5,30,108,143,1.2797202797202798,0.04371860360477925,688,"Perhaps you have taken the advice to bring protections for the date too literally, Sir."
1371,1113,5,30,108,143,1.2797202797202798,0.04371860360477925,688,"Sorry, this elevator doesn't go up that high."
1773,1113,8,24,111,143,1.2797202797202798,0.04697654169764333,688,"One small step for man, one giant leap for mankind's aversion to elevator conversation"
1824,1113,10,20,113,143,1.2797202797202798,0.04902837527748082,688,Can you believe that NASA put on elevator music for the whole trip?
2768,1113,8,24,111,143,1.2797202797202798,0.04697654169764333,688,Staircase: the final frontier.
3120,1113,7,26,110,143,1.2797202797202798,0.045916254351056195,688,Fourth floor moon wear.
3167,1113,8,24,111,143,1.2797202797202798,0.04697654169764333,688,Do you mind counting down from 10 first?
3174,1113,10,20,113,143,1.2797202797202798,0.04902837527748082,688,Is this high enough for you sir?
3740,1113,8,24,111,143,1.2797202797202798,0.04697654169764333,688,Ralph's been promising to send me to the moon for years.
685,1113,10,20,113,143,1.2797202797202798,0.04902837527748082,688,I forgot my phone.
542,1113,9,22,112,143,1.2797202797202798,0.04801342027089882,688,"The Starlight Room is to your left, sir."
4563,1113,6,28,109,143,1.2797202797202798,0.044830897352064594,688,"Please don't say, 'Going Down.'"
231,1113,7,26,110,143,1.2797202797202798,0.045916254351056195,688,Well..they were out of the Santa suit
133,1113,7,26,110,143,1.2797202797202798,0.045916254351056195,688,You must be the new penthouse resident.
4270,1113,10,20,113,143,1.2797202797202798,0.04902837527748082,688,"Sorry for that rough landing, sir, but one small step is all you need from here."
4792,1113,10,20,113,143,1.2797202797202798,0.04902837527748082,688,"Going up, yes, but not that up."
316,1113,7,26,110,143,1.2797202797202798,0.045916254351056195,688,Is it just me or does this simulator seem a little slow?
4327,1133,8,29,124,161,1.279503105590062,0.0433560838827112,688,"5-4-3-2-1, Please."
2782,1134,5,28,103,136,1.2794117647058822,0.0451228973832111,688,Handi-wipes are on 7.
4081,1135,8,21,104,133,1.2781954887218046,0.04932141881026054,688,"Sorry, this elevator only goes to the top floor."
544,1135,9,19,105,133,1.2781954887218046,0.05046309067040849,688,"This takes a while; the building has over a million stories.  Not to worry, so do I."
2819,1137,6,30,115,151,1.2781456953642385,0.043224288402862826,688,"Fourth planet from the sun, please."
1563,1137,5,32,114,151,1.2781456953642385,0.04219050707426151,688,Stratosphere or bathysphere?
3071,1139,7,24,106,137,1.2773722627737227,0.04717198442927356,688,"Sir, the Moon Hotel doesn't actually go to the moon..."
1704,1140,5,26,99,130,1.2769230769230768,0.04635218761832849,688,"Very nice, sir.  I see you have been packing for Mars."
4147,1140,7,22,101,130,1.2769230769230768,0.04885740952771086,688,"This lift’s off, you’re going to need to take the stairs."
4742,1142,6,32,121,159,1.2767295597484276,0.041766530769877415,688,"Please watch your step. It's not a giant one, but we do have gravity here."
1904,1143,6,27,108,141,1.2765957446808511,0.045134475394886006,688,"The plague is on floor 27, Ebola is on floor 28, 
Cholera is on floor 29 Sir."
4473,1143,5,29,107,141,1.2765957446808511,0.04399776979095477,688,"You know, people can still breathe on this floor."
3947,1143,7,25,109,141,1.2765957446808511,0.046243248066774996,688,"Lemme guess, Penthouse"""
3037,1143,6,27,108,141,1.2765957446808511,0.045134475394886006,688,I guess you're looking for an apartment with space
2867,1143,7,25,109,141,1.2765957446808511,0.046243248066774996,688,Keys again?
2282,1143,11,17,113,141,1.2765957446808511,0.05043517108268953,688,"What do you mean, ""where is the rocket?"""
5183,1143,8,23,110,141,1.2765957446808511,0.047326051117318114,688,More budget cuts?
1783,1143,7,25,109,141,1.2765957446808511,0.046243248066774996,688,"Sorry, this is the Local."
1623,1143,6,27,108,141,1.2765957446808511,0.045134475394886006,688,Huh. I’ve never actually seen a chair inside an elevator before.
1244,1143,8,23,110,141,1.2765957446808511,0.047326051117318114,688,I only go as far as the penthouse.
1142,1143,7,25,109,141,1.2765957446808511,0.046243248066774996,688,Will you be going out for a walk?
1097,1143,5,29,107,141,1.2765957446808511,0.04399776979095477,688,I’m here to see Elon
518,1143,9,21,111,141,1.2765957446808511,0.048384628105966936,688,"Going way, way, way. way, way up?"
4622,1143,4,31,106,141,1.2765957446808511,0.04283090734486177,688,I might only be able to take you part way
4805,1143,5,29,107,141,1.2765957446808511,0.04399776979095477,688,I guess you're going way up.
2387,1158,8,31,131,170,1.276470588235294,0.041719849626640736,688,We only go to 12 sir
3001,1159,6,25,103,134,1.2761194029850746,0.04664936533718852,688,I don't want to talk about it.
3575,1159,6,25,103,134,1.2761194029850746,0.04664936533718852,688,Launch Pad straight ahead.
1797,1161,6,26,106,138,1.2753623188405796,0.04572964298740044,688,"All the way up, please."
5100,1161,11,16,111,138,1.2753623188405796,0.051187233386266164,688,Welcome back to the worldly cosmos!
748,1161,8,22,108,138,1.2753623188405796,0.047987220104410026,688,"Sorry pal,this is the 51st floor,not Area 51."
2690,1164,6,24,101,131,1.2748091603053435,0.047303613388792874,688,"To the moon sir, or just the rooftop?"
3979,1165,6,27,109,142,1.2746478873239437,0.044857810626764444,688,"This is the first time we've used the ""free fall"" button."
3100,1166,3,31,101,135,1.2740740740740741,0.04261962273509436,688,Do you think I'd be wearing this if I wanted to go down?
2217,1166,5,27,103,135,1.2740740740740741,0.04513921666476789,688,"Well, what planet are you looking for??"
155,1168,7,24,108,139,1.2733812949640289,0.04657574374835,688,"To the moon, Alice"
3388,1168,7,24,108,139,1.2733812949640289,0.04657574374835,688,I hope you don’t mind confined spaces.
3308,1168,8,22,109,139,1.2733812949640289,0.04768190768276031,688,"I don't think that ""the penthouse is out of this world""  is exactly what you think it means."
3156,1168,6,26,107,139,1.2733812949640289,0.04544266157650377,688,"Osmophobia clinic? 
That's on the thirteenth floor."
3140,1168,7,24,108,139,1.2733812949640289,0.04657574374835,688,Is it safe to come back to earth yet?
3117,1168,4,30,105,139,1.2733812949640289,0.043087198354569624,688,Antivaxxers or climate change. Take your pick.
3115,1168,7,24,108,139,1.2733812949640289,0.04657574374835,688,New suit?
3068,1168,6,26,107,139,1.2733812949640289,0.04544266157650377,688,"Going for a walk this evening, sir?"
2963,1168,7,24,108,139,1.2733812949640289,0.04657574374835,688,Your ride is waiting!
2835,1168,6,26,107,139,1.2733812949640289,0.04544266157650377,688,"Just so you know, this thing has limitations."
2743,1168,6,26,107,139,1.2733812949640289,0.04544266157650377,688,You know this elevator only goes up to the 60th floor.
2692,1168,4,30,105,139,1.2733812949640289,0.043087198354569624,688,"Ready for blast off to planet 17G, Mr. Carlson?"
2628,1168,7,24,108,139,1.2733812949640289,0.04657574374835,688,"For stratosphere, exit here and take the express elevator."
2604,1168,9,20,110,139,1.2733812949640289,0.04876298529440736,688,No giant leap. Just watch your next small step.
2410,1168,7,24,108,139,1.2733812949640289,0.04657574374835,688,Convention or bachelorette party?
3839,1168,5,28,106,139,1.2733812949640289,0.04428059480857658,688,"Oops, I mean the Eagle has landed."
3908,1168,6,26,107,139,1.2733812949640289,0.04544266157650377,688,Here you are Mr. Armstrong. They're waiting for you on set.
3926,1168,7,24,108,139,1.2733812949640289,0.04657574374835,688,Tang for breakfast again sir?
3929,1168,4,30,105,139,1.2733812949640289,0.043087198354569624,688,"No sir, I didn't read the article about all the people who've suffocated in overcrowded elevators'"
5332,1168,6,26,107,139,1.2733812949640289,0.04544266157650377,688,We all need a little space sometimes.
5043,1168,7,24,108,139,1.2733812949640289,0.04657574374835,688,"The roof, I presume?"
5012,1168,8,22,109,139,1.2733812949640289,0.04768190768276031,688,"You realize, sir, that this floor is the Mars candy company?"
4646,1168,5,28,106,139,1.2733812949640289,0.04428059480857658,688,Please watch your first small step...
4538,1168,8,22,109,139,1.2733812949640289,0.04768190768276031,688,"3, 2, 1– lift off!"
4385,1168,6,26,107,139,1.2733812949640289,0.04544266157650377,688,"Not exactly a giant leap for mankind, but it is the fourth floor."
2384,1168,8,22,109,139,1.2733812949640289,0.04768190768276031,688,"I'm not ground control, Major Tom, and I'm getting tired of you announcing that your stepping through the friggin door."
4332,1168,6,26,107,139,1.2733812949640289,0.04544266157650377,688,"Will you splash down in the pool, sir?"
4191,1168,7,24,108,139,1.2733812949640289,0.04657574374835,688,Do you require a shuttle service?
4139,1168,7,24,108,139,1.2733812949640289,0.04657574374835,688,"To the penthouse and beyond, Alfred."
4078,1168,6,26,107,139,1.2733812949640289,0.04544266157650377,688,"10, 9, 8, 7, 6, 5, 4, 3, 2, 1...Lobby!!!"
4067,1168,8,22,109,139,1.2733812949640289,0.04768190768276031,688,"I almost didn’t recognize you, Mr. Aldrin."
4038,1168,5,28,106,139,1.2733812949640289,0.04428059480857658,688,"No, it's the shoe department."
4021,1168,6,26,107,139,1.2733812949640289,0.04544266157650377,688,"Sir, please be more specific than ‘beam me up’."
4224,1168,7,24,108,139,1.2733812949640289,0.04657574374835,688,You want to go where?
2336,1168,7,24,108,139,1.2733812949640289,0.04657574374835,688,You have reached your final destination.
5180,1168,6,26,107,139,1.2733812949640289,0.04544266157650377,688,Looks like you could use some space.
2236,1168,5,28,106,139,1.2733812949640289,0.04428059480857658,688,"Wow! I guess there are severe government cut-backs on astronaut training, huh?"
715,1168,6,26,107,139,1.2733812949640289,0.04544266157650377,688,Building that wall had really affected our budget at NASA
611,1168,7,24,108,139,1.2733812949640289,0.04657574374835,688,"The atmosphere is laden with pretentious perfumery, be careful."
741,1168,7,24,108,139,1.2733812949640289,0.04657574374835,688,"For better atmosphere, head over to the cocktail lounge."
565,1168,8,22,109,139,1.2733812949640289,0.04768190768276031,688,This is the observation deck. The other elevator will take you to the Moon.
417,1168,4,30,105,139,1.2733812949640289,0.043087198354569624,688,"To the moon or the ISS, Mr. Musk?"
878,1168,7,24,108,139,1.2733812949640289,0.04657574374835,688,I gather you are going up Sir?
966,1168,11,16,112,139,1.2733812949640289,0.050856244099748586,688,"Morning, Mr. Pence."
1029,1168,6,26,107,139,1.2733812949640289,0.04544266157650377,688,"What is it today, sir, taking off or landing?"
1108,1168,8,22,109,139,1.2733812949640289,0.04768190768276031,688,Wow! Penthouse prices really are astronomical
1186,1168,7,24,108,139,1.2733812949640289,0.04657574374835,688,"You hear about Pluto?  That's messed up, right?"
1231,1168,10,18,111,139,1.2733812949640289,0.049820609684927596,688,I thought taking the elevator would be safer.
1236,1168,7,24,108,139,1.2733812949640289,0.04657574374835,688,"Don't you wish, just once, you could say, 'Mind the giant leap?'"
1328,1168,4,30,105,139,1.2733812949640289,0.043087198354569624,688,Bringing your work home again Mr. Tyler?
1463,1168,8,22,109,139,1.2733812949640289,0.04768190768276031,688,"Floor 226792, sir?"
1530,1168,6,26,107,139,1.2733812949640289,0.04544266157650377,688,I guess up or down is kind of a moot question at this point
1560,1168,7,24,108,139,1.2733812949640289,0.04657574374835,688,"One small step for man, huh? You couldn't take the stairs?"
391,1168,3,32,104,139,1.2733812949640289,0.04185979273110075,688,"Well, I can get you to 25."
368,1168,8,22,109,139,1.2733812949640289,0.04768190768276031,688,I find holiday gatherings alien and life-sucking.  Good thing the invite said “Dress for the Occassion.”
350,1168,4,30,105,139,1.2733812949640289,0.043087198354569624,688,We are ‘go’ for the penthouse suite.
1644,1168,5,28,106,139,1.2733812949640289,0.04428059480857658,688,"Is it to the dark side this time, sir?"
1729,1168,9,20,110,139,1.2733812949640289,0.04876298529440736,688,You don’t need to say it every time Neil...
265,1168,6,26,107,139,1.2733812949640289,0.04544266157650377,688,Enough climate change for today?
2252,1168,7,24,108,139,1.2733812949640289,0.04657574374835,688,"Observation deck, please."
1853,1168,7,24,108,139,1.2733812949640289,0.04657574374835,688,"Did you say ""down?"""
2021,1168,4,30,105,139,1.2733812949640289,0.043087198354569624,688,The Moon.
2146,1168,7,24,108,139,1.2733812949640289,0.04657574374835,688,"Going up, Mr Musk?"
2160,1168,7,24,108,139,1.2733812949640289,0.04657574374835,688,It’s just that asking if you were “going up” seemed appropriate.
274,1168,4,30,105,139,1.2733812949640289,0.043087198354569624,688,"The Sky Lounge is not THAT high, Sir."
2168,1168,6,26,107,139,1.2733812949640289,0.04544266157650377,688,"Penthouse, yes. Space station, no."
646,1168,7,24,108,139,1.2733812949640289,0.04657574374835,688,Well it is flu season.  Over.
654,1168,7,24,108,139,1.2733812949640289,0.04657574374835,688,Welcome back to Earth.
3651,1236,8,24,115,147,1.272108843537415,0.0458488551881332,688,NASA cut your budget again?
4087,1237,7,23,106,136,1.2720588235294117,0.04721769885837242,688,"One small step for mankind, one giant leap for penthouse living."
1978,1237,7,23,106,136,1.2720588235294117,0.04721769885837242,688,I only stay here when The Moon is full.
4896,1237,5,27,104,136,1.2720588235294117,0.044851378593446456,688,You'll need to take the stairs the rest of the way
2431,1237,5,27,104,136,1.2720588235294117,0.044851378593446456,688,"Venus or Mars, Sir?"
4631,1237,2,33,101,136,1.2720588235294117,0.04104690945871262,688,The space capsule is now a restaurant sir!
2734,1237,5,27,104,136,1.2720588235294117,0.044851378593446456,688,Fifth floor. Men's wear
4532,1237,5,27,104,136,1.2720588235294117,0.044851378593446456,688,"Yes Sir, it was quick wasn't it."
3318,1237,8,21,107,136,1.2720588235294117,0.04835745596444856,688,"No, just one button at a time. It's really not rocket science"
3362,1237,6,25,105,136,1.2720588235294117,0.046049740755039065,688,Both our costumes are kinda lousy
3442,1237,8,21,107,136,1.2720588235294117,0.04835745596444856,688,Where to Mrs. Kramden?
3491,1237,7,23,106,136,1.2720588235294117,0.04721769885837242,688,"I’m sorry sir, going down is not an option"
4497,1237,10,17,109,136,1.2720588235294117,0.05055994927905742,688,"That's one small step for man, one giant leap for Amazon packages."
3719,1237,9,19,108,136,1.2720588235294117,0.04947096127252047,688,"Ladies lingerie, please. I like to feel sexy under all this equipment."
3777,1237,3,31,102,136,1.2720588235294117,0.04235305464763304,688,"Tranquility Basement, please."
4439,1237,8,21,107,136,1.2720588235294117,0.04835745596444856,688,The air on this level has been breathable for almost three weeks.  I swear.
4436,1237,9,19,108,136,1.2720588235294117,0.04947096127252047,688,I forget how tall this building is sometimes.
4231,1237,7,23,106,136,1.2720588235294117,0.04721769885837242,688,Ooh! Before you push the button do you think you could do a count down?
1973,1237,4,29,103,136,1.2720588235294117,0.04362010660072977,688,My therapist says this is the first step to overcoming my fear of heights.
3934,1237,7,23,106,136,1.2720588235294117,0.04721769885837242,688,"Welcome home sir. Your ""out of town"" guests have already arrived."
1940,1237,6,25,105,136,1.2720588235294117,0.046049740755039065,688,I don’t think this is what she meant when she said she needs space.
2602,1237,7,23,106,136,1.2720588235294117,0.04721769885837242,688,"It only elevates so far, but it's one small step in the right direction."
1902,1237,5,27,104,136,1.2720588235294117,0.044851378593446456,688,Welcome to my world
3090,1237,2,33,101,136,1.2720588235294117,0.04104690945871262,688,And you can enjoy cocktails and a panoramic view from our exclusive exosphere balcony...
80,1237,6,25,105,136,1.2720588235294117,0.046049740755039065,688,"Despite claims, Trump Tower doesn’t actually have | a billion-anth floor"
294,1237,8,21,107,136,1.2720588235294117,0.04835745596444856,688,"4,728,512th floor, sir."
494,1237,6,25,105,136,1.2720588235294117,0.046049740755039065,688,Mens' clothing please...I need a new suit.
811,1237,8,21,107,136,1.2720588235294117,0.04835745596444856,688,"Infinity and Beyond , please!"
293,1237,5,27,104,136,1.2720588235294117,0.044851378593446456,688,This High-G training just isn't the same after we lost that funding
1292,1237,6,25,105,136,1.2720588235294117,0.046049740755039065,688,"I'm sorry sir, this really is the highest this elevator goes."
1407,1237,5,27,104,136,1.2720588235294117,0.044851378593446456,688,Just buzz me when you want to splash down.
1469,1237,2,33,101,136,1.2720588235294117,0.04104690945871262,688,"Low Earth orbit, please"
1657,1237,7,23,106,136,1.2720588235294117,0.04721769885837242,688,"Go ahead. It's just one small step, sir."
1133,1237,8,21,107,136,1.2720588235294117,0.04835745596444856,688,"Should I hold the elevator for you sir?”

“No thank you. I think it’s gonna be a long long time."
3163,1270,8,20,105,133,1.2706766917293233,0.04906022675980432,688,"It's the flu season, and I'm not done Holiday shopping yet."
3305,1271,2,36,110,148,1.2702702702702702,0.039057891648631965,688,"Just a small step this way, sir."
4042,1272,8,21,108,137,1.27007299270073,0.048044242208911604,688,Fly me to the Moon and let me wish upon the stars.
320,1272,7,23,107,137,1.27007299270073,0.04691382528075054,688,Want to count down with me?
3744,1274,6,15,79,100,1.27,0.05659532050470519,688,I can take you as far as the penthouse.
3630,1275,5,25,100,130,1.2692307692307692,0.04605933475683601,688,"Welcome, Space Force Cadet, to the penthouse suite at Trump Tower."
3603,1276,4,28,102,134,1.2686567164179106,0.043888253320673705,688,Turns out the stairs didn't have all the right stuff.
3616,1276,7,22,105,134,1.2686567164179106,0.04756933183724331,688,How high do you think this elevator goes?
3895,1276,4,28,102,134,1.2686567164179106,0.043888253320673705,688,"More budget cuts to NASA this month, sir?"
3735,1276,5,26,103,134,1.2686567164179106,0.045148639294819,688,"Yes, sir. We have oxygen and artificial gravity in the lounge."
3818,1276,7,22,105,134,1.2686567164179106,0.04756933183724331,688,I understand you like to be prepared but no suit is needed at the Space Needle sir.
3894,1276,5,26,103,134,1.2686567164179106,0.045148639294819,688,Did your ears pop?
4088,1276,5,26,103,134,1.2686567164179106,0.045148639294819,688,"Sorry Buzz, but this elevator only goes to Bed Bath & Beyond.”"
3714,1276,7,22,105,134,1.2686567164179106,0.04756933183724331,688,are you going up?
3529,1276,5,26,103,134,1.2686567164179106,0.045148639294819,688,"If anyone asks, you didn't see me."
3206,1276,8,20,106,134,1.2686567164179106,0.04873460969450579,688,"You know this only goes to the tenth floor, right?"
3423,1276,7,22,105,134,1.2686567164179106,0.04756933183724331,688,Just one small step for mankind and you'll be on your floor.
3286,1276,5,26,103,134,1.2686567164179106,0.045148639294819,688,"Sir, I believe you will need the express elevator"
3244,1276,5,26,103,134,1.2686567164179106,0.045148639294819,688,How far up are you going?
3221,1276,8,20,106,134,1.2686567164179106,0.04873460969450579,688,"So, how high up does this thing go?"
4148,1276,6,24,104,134,1.2686567164179106,0.04637478281143451,688,"Just press up, up and away."
3199,1276,7,22,105,134,1.2686567164179106,0.04756933183724331,688,You're going to wear white after Labor Day?
3130,1276,4,28,102,134,1.2686567164179106,0.043888253320673705,688,Didn't I see you with a deep sea diver at a party three weeks ago?
3103,1276,5,26,103,134,1.2686567164179106,0.045148639294819,688,"It may not be a giant leap for mankind, but please mind the gap nonetheless."
3053,1276,5,26,103,134,1.2686567164179106,0.045148639294819,688,"Unfortunately, sir, the elevator doesn't go that high."
3470,1276,8,20,106,134,1.2686567164179106,0.04873460969450579,688,Would you like the mesosphere or thermosphere?
4155,1276,3,30,101,134,1.2686567164179106,0.04259058497961232,688,Eh...Define top floor.
4706,1276,8,20,106,134,1.2686567164179106,0.04873460969450579,688,Long year at work?
4267,1276,5,26,103,134,1.2686567164179106,0.045148639294819,688,"Houston, this is ground floor."
5246,1276,8,20,106,134,1.2686567164179106,0.04873460969450579,688,"No, sorry, it’s just 1. No ‘Ignition.’ No ‘blast off.’"
5053,1276,4,28,102,134,1.2686567164179106,0.043888253320673705,688,...and I’m shopping in a most peculiar way.
5074,1276,4,28,102,134,1.2686567164179106,0.043888253320673705,688,How high do you want to go?
5204,1276,6,24,104,134,1.2686567164179106,0.04637478281143451,688,Ascending?
5193,1276,9,18,107,134,1.2686567164179106,0.049872668193208444,688,"I'm sorry, ma'am, but we don't have a 3,414,003rd floor."
5082,1276,6,24,104,134,1.2686567164179106,0.04637478281143451,688,Does the moon make the Earth look fat or is it just all that excess water weight?
5001,1276,8,20,106,134,1.2686567164179106,0.04873460969450579,688,Could you please take one small step back?
2917,1276,5,26,103,134,1.2686567164179106,0.045148639294819,688,Better luck next time.
5156,1276,6,24,104,134,1.2686567164179106,0.04637478281143451,688,Really? Going down?
4990,1276,9,18,107,134,1.2686567164179106,0.049872668193208444,688,"If your ears pop, gum also works."
4933,1276,7,22,105,134,1.2686567164179106,0.04756933183724331,688,You'll have to get the next one.
4929,1276,5,26,103,134,1.2686567164179106,0.045148639294819,688,"Sorry, can't help you...if you have a problem call Houston."
4902,1276,5,26,103,134,1.2686567164179106,0.045148639294819,688,"Sir, there's no need -- it's only the third floor."
4887,1276,3,30,101,134,1.2686567164179106,0.04259058497961232,688,How is your acrophobia therapy going Mr. Finster?
5034,1276,6,24,104,134,1.2686567164179106,0.04637478281143451,688,"A step, a leap, anything will do."
4680,1276,7,22,105,134,1.2686567164179106,0.04756933183724331,688,Using us for training following cutbacks on the NASA budget has really helped my job security
4613,1276,3,30,101,134,1.2686567164179106,0.04259058497961232,688,"This isn't going to be another fake moon landing, is it?"
4486,1276,4,28,102,134,1.2686567164179106,0.043888253320673705,688,"Well, I can take as as far as the roof."
4401,1276,6,24,104,134,1.2686567164179106,0.04637478281143451,688,"Yeah, it has its ups and downs."
4356,1276,10,16,108,134,1.2686567164179106,0.05098533007977798,688,"Sorry sir, this is an elevator, that's not how these work."
4309,1276,8,20,106,134,1.2686567164179106,0.04873460969450579,688,"Unfortunately, this elevator doesn’t go that far up."
4211,1276,4,28,102,134,1.2686567164179106,0.043888253320673705,688,"Sorry I spaced out just now, what was the question?"
2845,1276,6,24,104,134,1.2686567164179106,0.04637478281143451,688,"Yes, achieving exit velocity is always a problem."
3563,1276,5,26,103,134,1.2686567164179106,0.045148639294819,688,"Lagrangian L2, sir?"
2732,1276,7,22,105,134,1.2686567164179106,0.04756933183724331,688,He asked for a Uber driver  not a scuba diver
1054,1276,6,24,104,134,1.2686567164179106,0.04637478281143451,688,"Go ahead, sir..It is not a great leap or anything... just one small step..."
1031,1276,5,26,103,134,1.2686567164179106,0.045148639294819,688,I think you're really overreacting to the one time I passed gas.
915,1276,4,28,102,134,1.2686567164179106,0.043888253320673705,688,"Rockets, shuttles and lingerie."
854,1276,5,26,103,134,1.2686567164179106,0.045148639294819,688,I just need some fresh air.
847,1276,9,18,107,134,1.2686567164179106,0.049872668193208444,688,"I only go to the 25th floor, you'll have to transfer"
507,1276,7,22,105,134,1.2686567164179106,0.04756933183724331,688,"You should have enough Tang to get you to nine, sir."
498,1276,3,30,101,134,1.2686567164179106,0.04259058497961232,688,"T minus 5 seconds, sir."
482,1276,4,28,102,134,1.2686567164179106,0.043888253320673705,688,"Taking the rocket ship today, sir?"
439,1276,9,18,107,134,1.2686567164179106,0.049872668193208444,688,You seriously want me to do a T-minus five seconds countdown?
436,1276,6,24,104,134,1.2686567164179106,0.04637478281143451,688,You said you needed more space.
428,1276,4,28,102,134,1.2686567164179106,0.043888253320673705,688,It's literally just one small step down the hall.
406,1276,8,20,106,134,1.2686567164179106,0.04873460969450579,688,The Thousand Mile Club reunion is to the left.
361,1276,3,30,101,134,1.2686567164179106,0.04259058497961232,688,"Going up, up and away, sir?”"
209,1276,6,24,104,134,1.2686567164179106,0.04637478281143451,688,"Welcome to Mars, Mr Musk sir."
189,1276,6,24,104,134,1.2686567164179106,0.04637478281143451,688,Ground floor to Major Tom?
167,1276,8,20,106,134,1.2686567164179106,0.04873460969450579,688,Please take one giant leap off the lift for mankind
100,1276,4,28,102,134,1.2686567164179106,0.043888253320673705,688,"And your wife, Mr  Johnson? Did you leave her on the moon?"
1178,1276,4,28,102,134,1.2686567164179106,0.043888253320673705,688,"11th floor:  please mind the small step, no need to take a giant leap."
1283,1276,5,26,103,134,1.2686567164179106,0.045148639294819,688,"What will it be this morning Mr Armstrong, a small step or a giant leap?"
2822,1276,7,22,105,134,1.2686567164179106,0.04756933183724331,688,Walk straight then turn right and there should be a shuttle waiting
1629,1276,7,22,105,134,1.2686567164179106,0.04756933183724331,688,"Considering it's just an elevator ride, I think we're both a little overdressed."
2699,1276,7,22,105,134,1.2686567164179106,0.04756933183724331,688,"I'm sorry, sir, but this is as high as it goes."
2644,1276,8,20,106,134,1.2686567164179106,0.04873460969450579,688,NASA out of funds? GuessTrump spent them all on 'Space Force?'
2573,1276,5,26,103,134,1.2686567164179106,0.045148639294819,688,"Re-Entry?....dunno but here be the lobby!"""
2547,1276,5,26,103,134,1.2686567164179106,0.045148639294819,688,"No, this isn't the Apollo Theater."
2427,1276,5,26,103,134,1.2686567164179106,0.045148639294819,688,"Our celestial ballroom is to the right."""
2423,1276,8,20,106,134,1.2686567164179106,0.04873460969450579,688,"First floor, again, sir. Will we be riding back up to the top again, sir?"
2241,1276,10,16,108,134,1.2686567164179106,0.05098533007977798,688,Elevator to Houston: we've landed.
2529,1276,3,30,101,134,1.2686567164179106,0.04259058497961232,688,"89408, sir?"
2070,1276,5,26,103,134,1.2686567164179106,0.045148639294819,688,I can only take you to the Moon.  The elevator to Mars is under construction.
1999,1276,4,28,102,134,1.2686567164179106,0.043888253320673705,688,"Very smart, sir. You can't trust the atmosphere down on Earth anymore."
1790,1276,3,30,101,134,1.2686567164179106,0.04259058497961232,688,Did you forget your keys?
1403,1276,9,18,107,134,1.2686567164179106,0.049872668193208444,688,"Like I told the others, the President exaggerated the height of this Tower."
1687,1276,3,30,101,134,1.2686567164179106,0.04259058497961232,688,Yes Sir.  I'll take you up as high as I can.
1660,1276,6,24,104,134,1.2686567164179106,0.04637478281143451,688,"Millionth floor, please."
2136,1276,5,26,103,134,1.2686567164179106,0.045148639294819,688,"Out for a walk, sir?"
875,1360,8,21,109,138,1.2681159420289856,0.047734959617319994,688,"Welcome back, Mrs. Cramden, I think you'll like the changes."
4149,1360,6,25,107,138,1.2681159420289856,0.04546485812221544,688,How's the atmosphere on the 1 per cent floor today ?
2883,1360,5,27,106,138,1.2681159420289856,0.044286191993398845,688,"Buddy, it may be one small step for you, but it’s 38 floors to me ..."
778,1363,4,26,97,127,1.2677165354330708,0.04534143118089715,688,This one goes to eleven...
3348,1363,7,20,100,127,1.2677165354330708,0.049303128829625766,688,Going out for some fresh air?
1060,1363,5,24,98,127,1.2677165354330708,0.04669935501144436,688,It’s time to leave the capsule if you dare.
4448,1363,4,26,97,127,1.2677165354330708,0.04534143118089715,688,I don’t trust elevators and I’m not taking any chances.
3013,1367,7,21,103,131,1.2671755725190839,0.04825118691053638,688,Any suggestions for launch?
2983,1367,4,27,100,131,1.2671755725190839,0.04445061981555055,688,"Low or high stationary orbit, sir?"
1608,1367,7,21,103,131,1.2671755725190839,0.04825118691053638,688,"It is time to leave the capsule, sir, if you dare."
2815,1367,3,29,99,131,1.2671755725190839,0.04310937009387071,688,It's easier if you get vaccinated...
1513,1367,5,25,101,131,1.2671755725190839,0.04575256729499358,688,"My bad. I thought you said 'cosmetology."""
2394,1367,8,19,104,131,1.2671755725190839,0.049453178364709964,688,Guess the Air Quality index is bad today?
2072,1367,6,23,102,131,1.2671755725190839,0.04701847749746068,688,Sorry but this is as high as I go.
2909,1367,8,19,104,131,1.2671755725190839,0.049453178364709964,688,"only 12,813,333 more floors to go"
2631,1367,8,19,104,131,1.2671755725190839,0.049453178364709964,688,"Sorry Neil, we don't  go that high."
4186,1367,7,21,103,131,1.2671755725190839,0.04825118691053638,688,"Welcome back, Mr. President.  How was the moon rally?"
3173,1367,7,21,103,131,1.2671755725190839,0.04825118691053638,688,"Top floor, sir? Or beyond?"
3696,1367,5,25,101,131,1.2671755725190839,0.04575256729499358,688,Our penthouse has tons of space.
3854,1367,6,23,102,131,1.2671755725190839,0.04701847749746068,688,Sorry.  This is a local
3957,1367,5,25,101,131,1.2671755725190839,0.04575256729499358,688,Why Mr. Musk - we weren't expecting you until next Tuesday!
1298,1367,2,31,98,131,1.2671755725190839,0.04172502819404696,688,Dare I ask? Going up?
4210,1367,4,27,100,131,1.2671755725190839,0.04445061981555055,688,"Penthouse, sir.  This is as high as we go.  Have a nice day."
4600,1367,6,23,102,131,1.2671755725190839,0.04701847749746068,688,"I'm sorry sir, but I'm not quite sure how to get to the moon."""
4777,1367,6,23,102,131,1.2671755725190839,0.04701847749746068,688,Top floor. Open that window and jump really high.
4892,1367,5,25,101,131,1.2671755725190839,0.04575256729499358,688,I can get you as far as the roof.
5067,1367,7,21,103,131,1.2671755725190839,0.04825118691053638,688,"Sir, the space elevator is down the hall."
5142,1367,5,25,101,131,1.2671755725190839,0.04575256729499358,688,Budget cuts are killing us.
3031,1367,4,27,100,131,1.2671755725190839,0.04445061981555055,688,Another plumbing problem in the penthouse?
1275,1367,7,21,103,131,1.2671755725190839,0.04825118691053638,688,"Budget cuts, huh?"
680,1367,2,31,98,131,1.2671755725190839,0.04172502819404696,688,"Ready for lift off, Sir?"
5249,1367,4,27,100,131,1.2671755725190839,0.04445061981555055,688,"Floor 121034668, please."
1188,1367,6,23,102,131,1.2671755725190839,0.04701847749746068,688,She said she'll meet you at the outdoor terrace and apologizes for the dress code.
1047,1367,6,23,102,131,1.2671755725190839,0.04701847749746068,688,That's the price I pay for living on the 90th floor.
892,1367,2,31,98,131,1.2671755725190839,0.04172502819404696,688,"Two small steps, sir. No need for a giant leap”."
762,1367,7,21,103,131,1.2671755725190839,0.04825118691053638,688,"It has its ups and downs.""
""Tell me about it."
749,1367,10,15,106,131,1.2671755725190839,0.05177351132156693,688,Would you like a countdown before we launch?
744,1367,3,29,99,131,1.2671755725190839,0.04310937009387071,688,"No, I will not count backwards from 10."
1207,1367,4,27,100,131,1.2671755725190839,0.04445061981555055,688,10? 9? Or did Neil say 8?
451,1367,7,21,103,131,1.2671755725190839,0.04825118691053638,688,Down?
208,1367,6,23,102,131,1.2671755725190839,0.04701847749746068,688,"MR ARMSTRONG, THE STAGE IS SET IN HALL NUMBER 8°"
1518,1401,8,23,115,146,1.2671232876712328,0.045890234702387844,688,"OK, forget it. It's just that since we're both basically in the same business, I thought maybe this year you could be a little more generous."
3783,1402,8,20,107,135,1.2666666666666666,0.04841318388297882,688,"Mind the landing, Sir"
3870,1402,5,26,104,135,1.2666666666666666,0.04485712223433967,688,"You mean the ""honey"" moon suite, right?"
4235,1402,4,28,103,135,1.2666666666666666,0.04360737432628737,688,"No, this one doesn't do weightlessness simulation."
4175,1402,1,34,100,135,1.2666666666666666,0.03962231867385245,688,The air quality improves once we get above the 6th floor”
4546,1402,5,26,104,135,1.2666666666666666,0.04485712223433967,688,"Back to the future, please"
5013,1402,6,24,105,135,1.2666666666666666,0.04607298269767254,688,The hotel's shuttle to the cape won't leave for another 45 minutes.
4003,1402,8,20,107,135,1.2666666666666666,0.04841318388297882,688,Where else would I be going?
3539,1402,4,28,103,135,1.2666666666666666,0.04360737432628737,688,Well this isn't Mars.
2398,1402,7,22,106,135,1.2666666666666666,0.04725757139521219,688,"You're welcome, but again its Bob Smith, not Roger Houston"
1068,1402,5,26,104,135,1.2666666666666666,0.04485712223433967,688,"Yes, I was Naked Cowboy. But I m trying a different angle now"
1161,1402,8,20,107,135,1.2666666666666666,0.04841318388297882,688,6th Floor: Astro-naughty wear.
3520,1402,6,24,105,135,1.2666666666666666,0.04607298269767254,688,I don't think pushing buttons repeatedly is going to help.
3285,1402,6,24,105,135,1.2666666666666666,0.04607298269767254,688,And call up the Rover; I’m headed to the grocery.
1014,1402,5,26,104,135,1.2666666666666666,0.04485712223433967,688,"Going up?""  ""Where else?"
2138,1402,9,18,108,135,1.2666666666666666,0.04954184789852578,688,"11th floor. Colors, women's lingerie,
Apollo spacecraft, cosmetics"
2947,1402,7,22,106,135,1.2666666666666666,0.04725757139521219,688,"No gravity, but there is a Starbucks."
2190,1402,5,26,104,135,1.2666666666666666,0.04485712223433967,688,Welcome to Mars-a-lago!
3536,1402,5,26,104,135,1.2666666666666666,0.04485712223433967,688,5 ... 4 ... 3 ... 2 ... 1 ... Which floor?
3512,1402,2,32,101,135,1.2666666666666666,0.04099373679729453,688,"I’m sorry, but we have only fifty floors. You might want to check the Kennedy Space Center down the way."
2669,1402,7,22,106,135,1.2666666666666666,0.04725757139521219,688,I really wasn't expecting you to be going down.
634,1402,7,22,106,135,1.2666666666666666,0.04725757139521219,688,ISS level needs a code.
4197,1423,5,27,107,139,1.2661870503597121,0.04400872365954917,688,"Take me to the highest floor, and I'll take it from there."
1613,1423,6,25,108,139,1.2661870503597121,0.045177784061393216,688,"Sorry, small steps for women are on the fifth floor."
1286,1425,4,25,95,124,1.2661290322580645,0.045960437164890795,688,"Yes, this is the Richard  Branson wing Sir."
1935,1426,6,24,106,136,1.2647058823529411,0.04577497070560295,688,"Up"" or ""Down"" it is all the same to me"
521,1427,8,17,100,125,1.264,0.050982602978384826,688,"That's one small step for a man, but a 20 floor leap for the elevator."
460,1428,5,24,100,129,1.2635658914728682,0.046065365596917485,688,The millionth floor??
2670,1428,4,26,99,129,1.2635658914728682,0.044731352277456546,688,"Welcome back, Mr. Hollis.  Was it gibbous or harvest this time?"
3272,1430,6,23,104,133,1.263157894736842,0.046395155595813774,688,"I'm afraid that this is as high as I can take you, Sir."
4493,1430,6,23,104,133,1.263157894736842,0.046395155595813774,688,"Welcome home Major Tom. I'm so happy the circuit was fixed."""
1555,1432,6,22,102,130,1.2615384615384615,0.04703979735018118,688,It's been a tough flu season
1662,1432,5,24,101,130,1.2615384615384615,0.04575458392739736,688,Sorry that things didn't work out with you and the deep sea diver.
1678,1432,9,16,105,130,1.2615384615384615,0.050700338143613036,688,What? I’m on my launch break.
1825,1432,7,20,103,130,1.2615384615384615,0.04829081816580638,688,"Whoa, Bro. Last thing I remember is a big black hole."
1914,1432,8,18,104,130,1.2615384615384615,0.0495102383704607,688,I assume that you are going up?
2300,1432,3,28,99,130,1.2615384615384615,0.043069255642691595,688,"The seminar is to your left, Mr. Musk"
3859,1432,4,26,100,130,1.2615384615384615,0.04443221090596759,688,Good night Mr Sinatra.
1484,1432,5,24,101,130,1.2615384615384615,0.04575458392739736,688,So its true that rents are skyrocketing?
2366,1432,6,22,102,130,1.2615384615384615,0.04703979735018118,688,I admire your ambition...but this building only has five floors.
2589,1432,6,22,102,130,1.2615384615384615,0.04703979735018118,688,Eighth floor: environmental disasters and housewares
3374,1432,8,18,104,130,1.2615384615384615,0.0495102383704607,688,"MTV has missed you, too."
3574,1432,5,24,101,130,1.2615384615384615,0.04575458392739736,688,"One small step, Floor 9...one giant leap Floor 99."
4311,1432,10,14,106,130,1.2615384615384615,0.05186313596624838,688,"If you don't like it, you're welcome to use the stairs"
3686,1432,5,24,101,130,1.2615384615384615,0.04575458392739736,688,"You realize this only goes up to the 60th floor, right?"
3687,1432,4,26,100,130,1.2615384615384615,0.04443221090596759,688,"Sorry, 1250 feet is as high as we go."
2362,1432,4,26,100,130,1.2615384615384615,0.04443221090596759,688,May the Force be with you.
1258,1432,4,26,100,130,1.2615384615384615,0.04443221090596759,688,Rooftop Mr.Musk. Your ship is waiting.
601,1432,4,26,100,130,1.2615384615384615,0.04443221090596759,688,Touch Down
1051,1432,3,28,99,130,1.2615384615384615,0.043069255642691595,688,"Are you sure?""  ""We only play  the song 'Fly Me to the Moon'"
5173,1432,4,26,100,130,1.2615384615384615,0.04443221090596759,688,I afraid our Starlight Room will have do.
5002,1432,3,28,99,130,1.2615384615384615,0.043069255642691595,688,"Sorry, one small step won't be quite enough."
4983,1432,6,22,102,130,1.2615384615384615,0.04703979735018118,688,"President Trump, welcome to Mars."
4823,1432,8,18,104,130,1.2615384615384615,0.0495102383704607,688,How long since you changed the kitty litter?
1145,1432,4,26,100,130,1.2615384615384615,0.04443221090596759,688,"‘I’m sorry, this is as high as it goes.”"
4692,1432,4,26,100,130,1.2615384615384615,0.04443221090596759,688,This is as far up as it goes.
4758,1432,8,18,104,130,1.2615384615384615,0.0495102383704607,688,How’s the atmosphere in the lounge?
4536,1432,6,22,102,130,1.2615384615384615,0.04703979735018118,688,"Sir, do you need some space?"
212,1432,4,26,100,130,1.2615384615384615,0.04443221090596759,688,"Long flight, Sir?"
479,1432,2,30,98,130,1.2615384615384615,0.041661735408389536,688,"I'm afraid this is as high as it goes, sir."
4082,1432,3,28,99,130,1.2615384615384615,0.043069255642691595,688,Prepare for liftoff.
751,1432,5,24,101,130,1.2615384615384615,0.04575458392739736,688,I can give you a countdown if you like.
951,1432,7,20,103,130,1.2615384615384615,0.04829081816580638,688,I guess you took them seriously when they said the party would be out of this world.
4592,1432,7,20,103,130,1.2615384615384615,0.04829081816580638,688,Would you like to press the button or should I?
4107,1432,7,20,103,130,1.2615384615384615,0.04829081816580638,688,You can’t get there from here.
4960,1466,3,34,116,153,1.261437908496732,0.03909366407576878,688,Tell the super the laundry room needs his attention.
584,1467,6,21,100,127,1.2598425196850394,0.04771048382553092,688,"There you go, 89,000th Floor!"""
3506,1467,7,19,101,127,1.2598425196850394,0.04900280240781264,688,Welcome to the newly renamed and remodelled Donald J. Trump Space Center.
2058,1467,4,25,98,127,1.2598425196850394,0.04501468108251446,688,Suits?
5243,1470,5,24,102,131,1.2595419847328244,0.045447841681542034,688,"Sorry, sir, this elevator only goes as high as the 12th floor."
3826,1470,4,26,101,131,1.2595419847328244,0.04413690634167973,688,Permission to come aboard Captain.
732,1470,5,24,102,131,1.2595419847328244,0.045447841681542034,688,"Penthouse, sir?"
2719,1470,5,24,102,131,1.2595419847328244,0.045447841681542034,688,"Yes Sir, you do look wonderful Sir, but Adam said nobody, not even you Sir, can testify while wearing a Space Force uniform."
2568,1474,8,20,111,139,1.2589928057553956,0.047167865964530195,688,It's an open space office
5338,1475,4,25,99,128,1.2578125,0.04470773109029495,688,"The shuttle to JFK leaves in 30 minutes, if that's what you're asking about."
4117,1475,6,21,101,128,1.2578125,0.04737978694937442,688,I heard the cost of staying here was sky rocketing.
4059,1475,4,25,99,128,1.2578125,0.04470773109029495,688,I trust this floor will have the atmosphere you desired.
4017,1475,4,25,99,128,1.2578125,0.04470773109029495,688,Fart confidently sir.
3990,1475,4,25,99,128,1.2578125,0.04470773109029495,688,"I’ll need your card to access that floor, sir."
3960,1475,6,21,101,128,1.2578125,0.04737978694937442,688,"The next 238,900 miles are on you."
3742,1475,3,27,98,128,1.2578125,0.043309926381594484,688,Could you count down from 10 before liftoff?
3599,1475,4,25,99,128,1.2578125,0.04470773109029495,688,Are you my mother?
3003,1475,6,21,101,128,1.2578125,0.04737978694937442,688,Habitable? Just barely.
3224,1475,8,17,103,128,1.2578125,0.049908989205293415,688,Per ardua ad astra sir?
4328,1475,5,23,100,128,1.2578125,0.04606313835709762,688,"Floor 10.  No, 9.  No, 8.  No, 7..."
2986,1475,6,21,101,128,1.2578125,0.04737978694937442,688,Did they run out of flu shots?
2960,1475,5,23,100,128,1.2578125,0.04606313835709762,688,Mars again Mr. Musk?
2834,1475,7,19,102,128,1.2578125,0.048660823127348575,688,"Reach for the stars, and you might get past the fifth floor someday."
2791,1475,3,27,98,128,1.2578125,0.043309926381594484,688,Penthouse or Lunar Command Module?
2630,1475,5,23,100,128,1.2578125,0.04606313835709762,688,I believe you. The commute must be hell.
3329,1475,4,25,99,128,1.2578125,0.04470773109029495,688,"Would you also like a countdown, sir?"
4381,1475,4,25,99,128,1.2578125,0.04470773109029495,688,"Top of the Atmosphere, Sir?"
4500,1475,6,21,101,128,1.2578125,0.04737978694937442,688,"Sir, you do know it only goes up to the 7th floor, right?"
5090,1475,5,23,100,128,1.2578125,0.04606313835709762,688,"I think gravitational conditions today will allow you to take a walk without tethering yourself to the building, sir."
5263,1475,6,21,101,128,1.2578125,0.04737978694937442,688,"I see you are prepared to attend the political rally."""
5168,1475,4,25,99,128,1.2578125,0.04470773109029495,688,"Your room key entitles you to infinity, but not beyond"
2459,1475,8,17,103,128,1.2578125,0.049908989205293415,688,Keeping up appearances for the sake of the kids.
5151,1475,6,21,101,128,1.2578125,0.04737978694937442,688,I do not think this elevator goes that high.
5007,1475,5,23,100,128,1.2578125,0.04606313835709762,688,The earth looks like a big blue marble from the penthouse here at the Dubai Marriott Marquis.
5092,1475,4,25,99,128,1.2578125,0.04470773109029495,688,Where shall I beam you?
4971,1475,4,25,99,128,1.2578125,0.04470773109029495,688,"Down the hall and to the right, must hurry sir the hatch is about to close!"
4912,1475,4,25,99,128,1.2578125,0.04470773109029495,688,I'm afraid you've missed the shuttle.
4906,1475,8,17,103,128,1.2578125,0.049908989205293415,688,"No, sir, this is the Apollo Theatre."
4869,1475,5,23,100,128,1.2578125,0.04606313835709762,688,"364,669,235,905th floor, please."
4862,1475,6,21,101,128,1.2578125,0.04737978694937442,688,Hold on tight!
4852,1475,5,23,100,128,1.2578125,0.04606313835709762,688,The star just means ground floor.
4821,1475,7,19,102,128,1.2578125,0.048660823127348575,688,"You have quite a few packages waiting..."""
4683,1475,8,17,103,128,1.2578125,0.049908989205293415,688,"The Halloween party is long over, but glad to take you up!"
4656,1475,4,25,99,128,1.2578125,0.04470773109029495,688,"Sorry, the pool is closed!"
4648,1475,6,21,101,128,1.2578125,0.04737978694937442,688,"Good morning, Mr. Aldrin"
4601,1475,6,21,101,128,1.2578125,0.04737978694937442,688,"Fifth floor, lost and found."
4451,1475,6,21,101,128,1.2578125,0.04737978694937442,688,So let's have a talk about expectations...
2379,1475,5,23,100,128,1.2578125,0.04606313835709762,688,Moon boots? Take one small step out and twenty giant leaps to your right
1204,1475,7,19,102,128,1.2578125,0.048660823127348575,688,"953rd Floor, please, and step on it.  I missed my flight."
2101,1475,4,25,99,128,1.2578125,0.04470773109029495,688,"I’m quite certain they were speaking figuratively, sir!"
968,1475,4,25,99,128,1.2578125,0.04470773109029495,688,"Another small step, Mr. Armstrong?"
961,1475,6,21,101,128,1.2578125,0.04737978694937442,688,"I'm afraid the building doesn't have a millionth floor, sir."
907,1475,6,21,101,128,1.2578125,0.04737978694937442,688,Please watch your one small step for man.
853,1475,6,21,101,128,1.2578125,0.04737978694937442,688,"Sorry, I assumed you'd be going up."
812,1475,10,13,105,128,1.2578125,0.05231606058965142,688,"I see that they're still shampooing your carpet, sir."
777,1475,6,21,101,128,1.2578125,0.04737978694937442,688,Ready to take the training wheels off after today?
737,1475,6,21,101,128,1.2578125,0.04737978694937442,688,10? 9? 8? 7? . . .
698,1475,8,17,103,128,1.2578125,0.049908989205293415,688,Next floor: infinity and beyond.
555,1475,5,23,100,128,1.2578125,0.04606313835709762,688,"Going for a walk again, Buzz?"
370,1475,7,19,102,128,1.2578125,0.048660823127348575,688,"Can I help you, sir?”  
“No. I just need a little space."
334,1475,6,21,101,128,1.2578125,0.04737978694937442,688,"Shall I start the countdown, sir?"
313,1475,5,23,100,128,1.2578125,0.04606313835709762,688,"I'm sorry sir, but that's as far as I can take you."
45,1475,4,25,99,128,1.2578125,0.04470773109029495,688,need some space!
0,1475,5,23,100,128,1.2578125,0.04606313835709762,688,My pitch Is still a bit long.
2287,1475,4,25,99,128,1.2578125,0.04470773109029495,688,Going up Mr. Armstrong?
1024,1475,6,21,101,128,1.2578125,0.04737978694937442,688,I already got my step in for the day.
1202,1475,4,25,99,128,1.2578125,0.04470773109029495,688,It's one small step.
176,1475,7,19,102,128,1.2578125,0.048660823127348575,688,In 3...2...1...
1243,1475,5,23,100,128,1.2578125,0.04606313835709762,688,I hear the view is breathless.
2054,1475,2,29,97,128,1.2578125,0.04186547774857158,688,One giant leap and you're there.
2044,1475,5,23,100,128,1.2578125,0.04606313835709762,688,You’ll find the flannel underwear with a rear flap in the  lingerie department on your left.
2038,1475,5,23,100,128,1.2578125,0.04606313835709762,688,Will this get me there?
1874,1475,4,25,99,128,1.2578125,0.04470773109029495,688,Climate change is a bitch.
1840,1475,5,23,100,128,1.2578125,0.04606313835709762,688,Tonight's food tube special has received excellent reviews.
1951,1475,9,15,104,128,1.2578125,0.05112669263268539,688,Are we there yet?
1600,1475,8,17,103,128,1.2578125,0.049908989205293415,688,Great landing.  It's been a privilege riding with you.
1596,1475,6,21,101,128,1.2578125,0.04737978694937442,688,"Watch your one small step, sir."
1414,1475,6,21,101,128,1.2578125,0.04737978694937442,688,Forgot my wallet.
1299,1475,4,25,99,128,1.2578125,0.04470773109029495,688,Which floor?  Ten … nine … eight … seven …
1814,1475,8,17,103,128,1.2578125,0.049908989205293415,688,What did you expect?  The moon?
4604,1546,7,21,108,136,1.2573529411764706,0.04667171252997456,688,The suit isn't necessary.  The entire store is non-smoking now.
3110,1547,3,26,96,125,1.256,0.04385312730232073,688,Do you want the Aquarium or the Shuttle deck?
3438,1547,5,22,98,125,1.256,0.0467029045169846,688,"Just push the top button really, really hard."
3456,1547,4,24,97,125,1.256,0.04530043081757682,688,So much for one small step.
3420,1547,4,24,97,125,1.256,0.04530043081757682,688,That countdown thing you always do is really annoying.
3330,1547,6,20,99,125,1.256,0.04806447282959729,688,"I’m afraid this is not a skyscraper, sir."
3126,1547,5,22,98,125,1.256,0.0467029045169846,688,"When the door is closed, shall I begin the countdown as usual?"
2274,1547,2,28,95,125,1.256,0.04235639876251322,688,"Floor ""50,446,387"" please."
2924,1547,4,24,97,125,1.256,0.04530043081757682,688,"The 1,000,000th floor, please"
2865,1547,3,26,96,125,1.256,0.04385312730232073,688,I’m sorry sir. You can only go to 12.
2399,1547,8,16,101,125,1.256,0.05067798402182282,688,I’m not taking it off until Trump is out of office.
3571,1547,8,16,101,125,1.256,0.05067798402182282,688,Sorry you feel there isn't enough space in here for you.
2246,1547,3,26,96,125,1.256,0.04385312730232073,688,"Just so you know, this only goes up about 10 floors."
5299,1547,6,20,99,125,1.256,0.04806447282959729,688,You're right. There's a rarefied atmosphere at the top.
2018,1547,7,18,100,125,1.256,0.04938851897406534,688,"11,327th floor. Ladies dresses, hats, and International Space Station."
2957,1547,5,22,98,125,1.256,0.0467029045169846,688,"Skybridge to Saturn, Sir; mind the rings."
3608,1547,7,18,100,125,1.256,0.04938851897406534,688,"I'm sorry sir, this elevator doesn't go UP that high."
4251,1547,4,24,97,125,1.256,0.04530043081757682,688,"Let me guess, Honeymoon suite?"
3702,1547,4,24,97,125,1.256,0.04530043081757682,688,Keeps the ears from popping.
5175,1547,6,20,99,125,1.256,0.04806447282959729,688,I'm not sure 'dress for the job you want' is meant to be taken so literally.
5273,1547,5,22,98,125,1.256,0.0467029045169846,688,One small step for Menswear.
1856,1547,4,24,97,125,1.256,0.04530043081757682,688,"Going up in 3-2-1, liftoff!"
5298,1547,8,16,101,125,1.256,0.05067798402182282,688,"Would you take the stairs when you carry out the litter box"""
4774,1547,6,20,99,125,1.256,0.04806447282959729,688,The government cut NASA's budget again
4688,1547,3,26,96,125,1.256,0.04385312730232073,688,"This is as high as I can take you, sir."
3688,1547,6,20,99,125,1.256,0.04806447282959729,688,"Houston, we’ve got a Porter."
4482,1547,7,18,100,125,1.256,0.04938851897406534,688,Moonlight lounge?
4416,1547,6,20,99,125,1.256,0.04806447282959729,688,What? The guidance counselor said to dress for the job that you want.
4402,1547,4,24,97,125,1.256,0.04530043081757682,688,"How far up is ""up""?"
5106,1547,6,20,99,125,1.256,0.04806447282959729,688,"Charlie, if the government keeps cutting our budget, no more glass elevator space exploration trips for you."
3866,1547,4,24,97,125,1.256,0.04530043081757682,688,The shuttle should arrive any minute now.
3834,1547,7,18,100,125,1.256,0.04938851897406534,688,One small step or one giant leap?
3730,1547,4,24,97,125,1.256,0.04530043081757682,688,Yes it is a rarefied atmosphere we are going for here.
4433,1547,6,20,99,125,1.256,0.04806447282959729,688,"Watch that one small step over there."""
1842,1547,3,26,96,125,1.256,0.04385312730232073,688,"Penthouse... Asteroid chips, Comet particles, Moon dust, Voyager CD... This is the top floor."
2128,1547,4,24,97,125,1.256,0.04530043081757682,688,What floor is Mr. Musk on?
1794,1547,5,22,98,125,1.256,0.0467029045169846,688,"The eagle has landed on the 4th floor: Women’s perfumes, lingerie, assorted confectionery."
1819,1547,3,26,96,125,1.256,0.04385312730232073,688,13th floor please... where no man has gone before.
36,1547,7,18,100,125,1.256,0.04938851897406534,688,"——————————————— Before you ask- no, I’m not going up."
44,1547,8,16,101,125,1.256,0.05067798402182282,688,"Finally, an elevator with  some space."
146,1547,5,22,98,125,1.256,0.0467029045169846,688,Told you earth Is flat.
493,1547,3,26,96,125,1.256,0.04385312730232073,688,Take me with you.
501,1547,6,20,99,125,1.256,0.04806447282959729,688,Going up?   Or is that a dumb question?
520,1547,6,20,99,125,1.256,0.04806447282959729,688,"Watch your short step, sir."
568,1547,7,18,100,125,1.256,0.04938851897406534,688,Shall I send up a drink?
678,1547,6,20,99,125,1.256,0.04806447282959729,688,The top floor?
699,1547,5,22,98,125,1.256,0.0467029045169846,688,I thought the infinity button would go further.
928,1547,6,20,99,125,1.256,0.04806447282959729,688,My wife said she wanted a little space.
925,1547,5,22,98,125,1.256,0.0467029045169846,688,"Infinity, please."
984,1547,3,26,96,125,1.256,0.04385312730232073,688,"Cloud nine, please."
1067,1547,7,18,100,125,1.256,0.04938851897406534,688,"Watch your small step, sir"
1119,1547,4,24,97,125,1.256,0.04530043081757682,688,To Infinity...and H.R.
1143,1547,7,18,100,125,1.256,0.04938851897406534,688,"You're the new tutor for the kid on eight, right?"
1226,1547,6,20,99,125,1.256,0.04806447282959729,688,Take me to your Super.
1459,1547,7,18,100,125,1.256,0.04938851897406534,688,"Mr Armstrong., this is the studio where you will be filming the ""moonwalk""."
1533,1547,4,24,97,125,1.256,0.04530043081757682,688,1969!
1567,1547,6,20,99,125,1.256,0.04806447282959729,688,"Sorry, sir; this is as far up as it goes."
1628,1547,3,26,96,125,1.256,0.04385312730232073,688,"Honestly, I didn't expect rooms this nice on Mars."
964,1547,3,26,96,125,1.256,0.04385312730232073,688,Nice suit.”
1558,1605,5,23,101,129,1.255813953488372,0.04574833966710416,688,We're in Jersey ... there ain't no Final Frontier.
784,1605,4,25,100,129,1.255813953488372,0.044404803245696116,688,"It's right there, next to the 'lift on' button."
3333,1607,6,20,100,126,1.253968253968254,0.04772475040753304,688,These budget cuts are brutal.
1271,1608,4,25,101,130,1.2538461538461538,0.044105822846975215,688,Would you please stop singing 'Fly Me to the Moon'?
2205,1608,4,25,101,130,1.2538461538461538,0.044105822846975215,688,"If you see my ex-wife floating around out there, tell her I said hello."
2374,1610,8,18,108,134,1.2537313432835822,0.04818157494169884,688,"Just a word of advice. Mars ain't the kind of place to raise your kids
In fact it's cold as hell."
700,1611,3,21,83,107,1.2523364485981308,0.048050438482101346,688,The moon please.
4619,1612,6,19,98,123,1.2520325203252032,0.048423770127791824,688,Men's room is on the right.  Put your diapers in the canister
3716,1613,6,20,101,127,1.2519685039370079,0.047389685263170035,688,"Floor 3,874,890,432. Here you are sir."
3626,1614,5,20,95,120,1.25,0.04770650232563333,688,Is this about the cat lady in 6-B?
3567,1614,4,22,94,120,1.25,0.04621530419392146,688,10-9-8-7-6-5-4-3-2-1-liftoff.
3479,1614,2,26,92,120,1.25,0.043078327461947355,688,"Sorry, we're going up!"
5324,1614,2,26,92,120,1.25,0.043078327461947355,688,"Alien Overlords' conference on the 13th, sir."
3275,1614,3,24,93,120,1.25,0.04467435863364723,688,The final frontier sir
3274,1614,4,22,94,120,1.25,0.04621530419392146,688,"I am sorry sir,  I thought you said the honeymoon suite."
3255,1614,5,20,95,120,1.25,0.04770650232563333,688,It appears that you are taking your germophobic approach to new heights.
3238,1614,7,16,97,120,1.25,0.05055712025979709,688,So is it true that you shit in that thing?
2745,1614,3,24,93,120,1.25,0.04467435863364723,688,"8,425,748th floor."
2556,1614,5,20,95,120,1.25,0.04770650232563333,688,"That's one small step for man, two small steps to men's accessories on the second floor."
2626,1614,6,18,96,120,1.25,0.049152480980664874,688,"Have a nice space walk, sir. Your LEM is on Parking Port 3.  You wanted me to  remind you that young Krater needs two space rocks  for her science project, approximately 4xpi/3 in diameter. And the missus needs a quart of Rocky Road for Galileofest"
2737,1614,5,20,95,120,1.25,0.04770650232563333,688,"First thing. We'll get the super to repressurize the penthouse, sir."
3664,1614,5,20,95,120,1.25,0.04770650232563333,688,Not without an executive keycard
3124,1614,5,20,95,120,1.25,0.04770650232563333,688,"I assume you want me to do the '3-2-1 blastoff' thing?""
Tory Hoen, Brooklyn, N"
3079,1614,4,22,94,120,1.25,0.04621530419392146,688,Sir you don’t have to wear that every time you go up
2976,1614,4,22,94,120,1.25,0.04621530419392146,688,"So, have any big travel plans, Mr. Smith?"
2936,1614,6,18,96,120,1.25,0.049152480980664874,688,The 18th floor is the highest we go
3141,1614,3,24,93,120,1.25,0.04467435863364723,688,"Dress for the job you want, right?"
3707,1614,4,22,94,120,1.25,0.04621530419392146,688,"Which floor, sir?"
4968,1614,7,16,97,120,1.25,0.05055712025979709,688,Only the prices go that high.
3954,1614,4,22,94,120,1.25,0.04621530419392146,688,"Enjoy your orbit, Sir."
4738,1614,2,26,92,120,1.25,0.043078327461947355,688,"Yes, I do find it a bit claustrophobic."
4736,1614,10,10,100,120,1.25,0.05455447255899809,688,"I hope your date doesn't prefer down-to-earth types, sir."
5294,1614,4,22,94,120,1.25,0.04621530419392146,688,"Blasting off again, sir?"
5265,1614,5,20,95,120,1.25,0.04770650232563333,688,"Careful, it's one small step, but its tricky."
4999,1614,8,14,98,120,1.25,0.05192377520339357,688,"I would've bet a million dollars you were going ""up."""
2521,1614,4,22,94,120,1.25,0.04621530419392146,688,It's one small step for ground floor.
4838,1614,7,16,97,120,1.25,0.05055712025979709,688,"Going up?""
""To the moon."
4847,1614,5,20,95,120,1.25,0.04770650232563333,688,"It doesn't travel fast, but it certainly shakes like a rocket ship"
4632,1614,6,18,96,120,1.25,0.049152480980664874,688,"I'm sorry sir; the ""Mars"" on the door refers to the candy company."
4455,1614,6,18,96,120,1.25,0.049152480980664874,688,"Burning out the old fuse again, Rocket Man?"
4450,1614,3,24,93,120,1.25,0.04467435863364723,688,I heard the view up there is out of this world.
4408,1614,2,26,92,120,1.25,0.043078327461947355,688,"You DO know this building only has 30 floors, right ?"
4393,1614,4,22,94,120,1.25,0.04621530419392146,688,"What planet, ma'am?"
4119,1614,7,16,97,120,1.25,0.05055712025979709,688,"Yes, I understand why you can't stand it when someone farts in the elevator."
4055,1614,4,22,94,120,1.25,0.04621530419392146,688,"Okay, T-minus 10...9...8..."
4023,1614,8,14,98,120,1.25,0.05192377520339357,688,I already tired the stairway to heaven.
3997,1614,4,22,94,120,1.25,0.04621530419392146,688,Don’t. you get sick of people asking if your job has its ups and downs.?
3781,1614,4,17,79,100,1.25,0.0519809599951771,688,"Take me back to the lobby, it actually said “There’s space on the third floor.”"
2520,1614,6,18,96,120,1.25,0.049152480980664874,688,"I was supposed to fly today, but my cat talked me out of it."
3402,1614,4,22,94,120,1.25,0.04621530419392146,688,The listing said 8F is out of this world.
2340,1614,4,22,94,120,1.25,0.04621530419392146,688,"I'm sorry, this is a down elevator."
893,1614,3,24,93,120,1.25,0.04467435863364723,688,"6984th floor, Final frontier, Ewoks, and Moon buggies"
885,1614,4,22,94,120,1.25,0.04621530419392146,688,Well it's nice work if you can get it
808,1614,6,18,96,120,1.25,0.049152480980664874,688,You'll surely win first prize in that outfit.
791,1614,3,24,93,120,1.25,0.04467435863364723,688,"Thank you, Hal, for opening the pod bay doors."
769,1614,7,16,97,120,1.25,0.05055712025979709,688,Is the missus in need of some space again?
704,1614,4,22,94,120,1.25,0.04621530419392146,688,So you'll be back after the election?
636,1614,6,18,96,120,1.25,0.049152480980664874,688,May the Space Force be with you.
363,1614,6,18,96,120,1.25,0.049152480980664874,688,"Here we are, 57000th floor."
296,1614,7,16,97,120,1.25,0.05055712025979709,688,"For the millionth time, Tommy, this is as close to the moon as I can get you."
97,1614,5,20,95,120,1.25,0.04770650232563333,688,"Oops, wrong world..."
88,1614,5,20,95,120,1.25,0.04770650232563333,688,which floor? the infinity and beyond please
1701,1614,3,25,96,124,1.25,0.043792479657892625,688,"What? Did you think I would say ""Going up""?"
2671,1614,7,18,103,128,1.25,0.04834871689297298,688,Property taxes are lower on Jupiter.
2580,1614,6,20,102,128,1.25,0.04705918538536189,688,That was some serious g's.
2350,1614,1,28,91,120,1.25,0.0414208434789757,688,"With the latest cuts, this is about as high up as we can budget."""
921,1614,5,20,95,120,1.25,0.04770650232563333,688,"We're downsizing at NASA ,take the Macy's escalator to the launch pad, then turn right!"
927,1614,3,24,93,120,1.25,0.04467435863364723,688,Good luck with the in-laws.
2771,1614,5,20,95,120,1.25,0.04770650232563333,688,I realize you're claustrophobic Mr. Davis but I assure you there is plenty of air in the elevator.
1223,1614,5,20,95,120,1.25,0.04770650232563333,688,Which planet sir?
1255,1614,6,18,96,120,1.25,0.049152480980664874,688,Mr. Houston is expecting you sir.
1287,1614,4,22,94,120,1.25,0.04621530419392146,688,"Sure, Mr. Collins, I guess you could call that a giant leap."
1034,1614,1,28,91,120,1.25,0.0414208434789757,688,"Sorry, we don’t go that high up!"
1301,1614,5,20,95,120,1.25,0.04770650232563333,688,That's one small slide for the door and one giant press for the doorman.
2218,1614,5,20,95,120,1.25,0.04770650232563333,688,"Mars Pavilion, Venus Ballroom next."
1460,1614,5,20,95,120,1.25,0.04770650232563333,688,Wait until the conspiracy theorists find out about this!
2184,1614,4,22,94,120,1.25,0.04621530419392146,688,"I hate changing at work,NASA has the worst lorckerrooms."
1604,1614,4,22,94,120,1.25,0.04621530419392146,688,"I think you'll find the climate still to your liking, sir."
1717,1614,7,16,97,120,1.25,0.05055712025979709,688,This elevator doesnt go to Infinity and beyond. Thats the elevator in the toy store down the hall.
2048,1614,4,22,94,120,1.25,0.04621530419392146,688,Is the air quality outside really that bad sir?
1742,1614,3,24,93,120,1.25,0.04467435863364723,688,"Sorry, sir, but this is as high as I go."
1847,1614,3,24,93,120,1.25,0.04467435863364723,688,"You want floors five, four, three, two, AND one?"
1801,1614,2,26,92,120,1.25,0.043078327461947355,688,The weather outside is frightening.
1817,1614,8,14,98,120,1.25,0.05192377520339357,688,"Watch your small step for man, sir"
2633,1689,5,19,93,117,1.2478632478632479,0.048414263331137096,688,Are you sure you want to step out there? Just saying.
5146,1690,3,23,92,118,1.2457627118644068,0.04493212915420019,688,I just get the flu shot.
3827,1690,3,23,92,118,1.2457627118644068,0.04493212915420019,688,"Hold the door, I'll be right back. Forgot my keys."
3814,1690,10,9,99,118,1.2457627118644068,0.05507220798042525,688,"Sir, I believe your a little confused on the meaning of cyber-sale."
3802,1690,6,17,95,118,1.2457627118644068,0.04953271530274072,688,I believe Ground Control is on this floor.
3780,1690,6,17,95,118,1.2457627118644068,0.04953271530274072,688,"Sir, I don’t think this is what it means to ‘dress for the job you want...’"
3695,1690,8,13,97,118,1.2457627118644068,0.05237574809538084,688,"So Space Force didn't get that rocket budget, huh?"
3694,1690,6,17,95,118,1.2457627118644068,0.04953271530274072,688,Why is there a chair in this elevator?
3690,1690,5,19,94,118,1.2457627118644068,0.048048156401865744,688,"Sir, no need for a gas mask in Hong Kong today. Mr. Xi  agreed to the '5 Demands'."
3592,1690,5,19,94,118,1.2457627118644068,0.048048156401865744,688,We had the elevator fixed. It stops at the top floor now.
3532,1690,2,25,91,118,1.2457627118644068,0.043290087533816725,688,"You're down to earth now, Sir."
3459,1690,5,19,94,118,1.2457627118644068,0.048048156401865744,688,Long work commute?
3881,1690,4,21,93,118,1.2457627118644068,0.046516242130829305,688,Are we going to be back by the end of my shift?
3394,1690,6,17,95,118,1.2457627118644068,0.04953271530274072,688,"Sir,this elevator can't go that high!"
3254,1690,4,21,93,118,1.2457627118644068,0.046516242130829305,688,Ground control to Major Tom. Going up?
3246,1690,4,21,93,118,1.2457627118644068,0.046516242130829305,688,"Stratosphere, sir. You're on your own from here."
5322,1690,4,21,93,118,1.2457627118644068,0.046516242130829305,688,"88,173rd Floor, please."
3045,1690,4,21,93,118,1.2457627118644068,0.046516242130829305,688,"Sorry but because of budget cuts, this elevator now only goes up to the Stratosphere"
2874,1690,3,23,92,118,1.2457627118644068,0.04493212915420019,688,"Welcome.  I gather you just came down from our space station, conveniently located just above our penthouse suites."
2820,1690,5,19,94,118,1.2457627118644068,0.048048156401865744,688,"I am sorry, I couldn't get it to blast off, sir. You can try the countdown in Times Square in another couple of weeks though."
2805,1690,5,19,94,118,1.2457627118644068,0.048048156401865744,688,Last off!
2787,1690,5,19,94,118,1.2457627118644068,0.048048156401865744,688,But this is already “As far as she goes.”
2770,1690,4,21,93,118,1.2457627118644068,0.046516242130829305,688,"Hilton, I think we have a problem"
2727,1690,3,23,92,118,1.2457627118644068,0.04493212915420019,688,"I’m afraid the penthouse is as far as I go, Sir."
3379,1690,3,23,92,118,1.2457627118644068,0.04493212915420019,688,"God speed, Mr. Glenn."
5202,1690,7,15,96,118,1.2457627118644068,0.050974056508253075,688,"My friend, we guarantee the service to be stellar."
3939,1690,3,23,92,118,1.2457627118644068,0.04493212915420019,688,It's slightly cheaper to launch from the 57th floor.
4030,1690,5,19,94,118,1.2457627118644068,0.048048156401865744,688,"Diaper duty again, Mr. Barton?"
5206,1690,4,21,93,118,1.2457627118644068,0.046516242130829305,688,"I can get you as far as the roof deck, sir."
5129,1690,3,23,92,118,1.2457627118644068,0.04493212915420019,688,NASA is going green.
5225,1690,5,19,94,118,1.2457627118644068,0.048048156401865744,688,"Observation level, please...."
5276,1690,6,17,95,118,1.2457627118644068,0.04953271530274072,688,Basically the same job only fancier equipment
5124,1690,4,21,93,118,1.2457627118644068,0.046516242130829305,688,"I’ll leave a you message, on the dark side, in the dust."
5121,1690,5,19,94,118,1.2457627118644068,0.048048156401865744,688,How far up do you think this goes?
5093,1690,6,17,95,118,1.2457627118644068,0.04953271530274072,688,"It’s one small staircase for man, but you can take the elevator."
5065,1690,6,17,95,118,1.2457627118644068,0.04953271530274072,688,"Because, sir, this isn't Willie Wonka's elevator."
4972,1690,5,19,94,118,1.2457627118644068,0.048048156401865744,688,You're going to have to take a rocket after the 19th floor.
4863,1690,6,17,95,118,1.2457627118644068,0.04953271530274072,688,Keep your helmet on. You'll find the Park Avenue air is rarified.
3950,1690,6,17,95,118,1.2457627118644068,0.04953271530274072,688,Sorry man. CosmicCon is next week!
4757,1690,4,21,93,118,1.2457627118644068,0.046516242130829305,688,Ground Control to 18th floor?
4660,1690,4,21,93,118,1.2457627118644068,0.046516242130829305,688,Haberdashery.
4654,1690,5,19,94,118,1.2457627118644068,0.048048156401865744,688,"I know, it's a lot more fun going up than coming down."
4621,1690,4,21,93,118,1.2457627118644068,0.046516242130829305,688,This is not my floor.
4576,1690,5,19,94,118,1.2457627118644068,0.048048156401865744,688,I'm used to having a lot more space than this.
2652,1690,3,23,92,118,1.2457627118644068,0.04493212915420019,688,Returns Department please.
4440,1690,4,21,93,118,1.2457627118644068,0.046516242130829305,688,There’s a trampoline on the roof and from there you’re on your own.
4358,1690,7,15,96,118,1.2457627118644068,0.050974056508253075,688,"C’mon, Mr. Aldrin, I told you I quit eating taquitos."
4342,1690,5,19,94,118,1.2457627118644068,0.048048156401865744,688,The moon walk contest is on the fourth floor.
4315,1690,2,25,91,118,1.2457627118644068,0.043290087533816725,688,Top floor and beyond please.
4044,1690,4,21,93,118,1.2457627118644068,0.046516242130829305,688,"Sorry, I can't take you all the way up there."
4673,1690,4,21,93,118,1.2457627118644068,0.046516242130829305,688,This is as far as I go. The stairs are on your right.
4495,1690,3,23,92,118,1.2457627118644068,0.04493212915420019,688,Going down? How ironic!
3109,1690,4,21,93,118,1.2457627118644068,0.046516242130829305,688,I wanted to be an astronaut but dreaded the thought of confined spaces and crash landings.
2591,1690,6,17,95,118,1.2457627118644068,0.04953271530274072,688,I need to practice my space elevator pitch.
1235,1690,8,13,97,118,1.2457627118644068,0.05237574809538084,688,You’re an elevator operator!  You don’t see that much these days.
1177,1690,8,13,97,118,1.2457627118644068,0.05237574809538084,688,"No, sir!  I don't think they'll be able to recognize you."
1123,1690,4,21,93,118,1.2457627118644068,0.046516242130829305,688,The room needs cleaned THAT bad?
1084,1690,6,17,95,118,1.2457627118644068,0.04953271530274072,688,I’m afraid this is as high as it goes.
1015,1690,7,15,96,118,1.2457627118644068,0.050974056508253075,688,I’m afraid this vehicle only goes so far as the Moon Lounge on the top floor.
983,1690,4,21,93,118,1.2457627118644068,0.046516242130829305,688,"This is Mars, sir. For Jupiter, wait for the next stop, please."
956,1690,4,21,93,118,1.2457627118644068,0.046516242130829305,688,"Sir, sorry to disappoint, but M doesn't stand for Moon"
846,1690,4,21,93,118,1.2457627118644068,0.046516242130829305,688,"Yes, sir, it is a high floor, but I assure you that you'll be able to breathe normally."
757,1690,3,23,92,118,1.2457627118644068,0.04493212915420019,688,"Penthouse, then?"
675,1690,6,17,95,118,1.2457627118644068,0.04953271530274072,688,"I can take you to the roof, but you'll have to hitch a ride from there."
644,1690,5,19,94,118,1.2457627118644068,0.048048156401865744,688,My microdose was too big.
596,1690,6,17,95,118,1.2457627118644068,0.04953271530274072,688,We haven't had that spirit here since 1969.
346,1690,4,21,93,118,1.2457627118644068,0.046516242130829305,688,"Okay, okay...you win. You take just one small step and I will do a giant leap for you."
263,1690,3,23,92,118,1.2457627118644068,0.04493212915420019,688,"I understand you, these days all we all need is more space."
217,1690,2,25,91,118,1.2457627118644068,0.043290087533816725,688,"All the way up? Very well, Sir."
110,1690,5,19,94,118,1.2457627118644068,0.048048156401865744,688,Russia is already up?
106,1690,3,23,92,118,1.2457627118644068,0.04493212915420019,688,"Shall | tell your wife you needed some space, sir?"
2619,1690,4,21,93,118,1.2457627118644068,0.046516242130829305,688,I’m not sure I can take you that high sir.
65,1690,1,27,90,118,1.2457627118644068,0.04158325536849299,688,She said she needed space
1248,1690,3,23,92,118,1.2457627118644068,0.04493212915420019,688,Headed to work?
1318,1690,7,15,96,118,1.2457627118644068,0.050974056508253075,688,"An oxygen-nitrogen atmosphere, just as you specified, sir."
942,1690,6,17,95,118,1.2457627118644068,0.04953271530274072,688,What level? Troposphere? Stratosphere? Mesosphere? Thermosphere or Exosphere?
1424,1690,3,23,92,118,1.2457627118644068,0.04493212915420019,688,It only goes to the seventh floor
2582,1690,4,21,93,118,1.2457627118644068,0.046516242130829305,688,"Going up? Yes, but not that far."
1333,1690,3,23,92,118,1.2457627118644068,0.04493212915420019,688,I'm afraid we don't go that high.
2495,1690,4,21,93,118,1.2457627118644068,0.046516242130829305,688,Rents in this building are astronomical.
2437,1690,6,17,95,118,1.2457627118644068,0.04953271530274072,688,Ground?
2199,1690,3,23,92,118,1.2457627118644068,0.04493212915420019,688,Planet?
2093,1690,3,23,92,118,1.2457627118644068,0.04493212915420019,688,Are they done filming the moon landing?
2091,1690,3,23,92,118,1.2457627118644068,0.04493212915420019,688,I believe that there is at least one Sears left in this galaxy.
1969,1690,5,19,94,118,1.2457627118644068,0.048048156401865744,688,What? They said dress for the job you want...
1964,1690,4,21,93,118,1.2457627118644068,0.046516242130829305,688,No.  This is ladies lingerie.
2572,1690,4,21,93,118,1.2457627118644068,0.046516242130829305,688,Exosphere?
1591,1690,5,19,94,118,1.2457627118644068,0.048048156401865744,688,"Sorry sir, we don’t have space in the building."
1907,1690,3,23,92,118,1.2457627118644068,0.04493212915420019,688,You want WHAT floor?
1768,1690,3,23,92,118,1.2457627118644068,0.04493212915420019,688,"I'm sorry, sir.  This elevator only serves floors eleven to thirty."
1744,1690,5,19,94,118,1.2457627118644068,0.048048156401865744,688,The 173rd floor please.
1726,1690,5,19,94,118,1.2457627118644068,0.048048156401865744,688,"Second floor: asteroid belt, Mars and ""The Twilight Zone."""
1718,1690,8,13,97,118,1.2457627118644068,0.05237574809538084,688,I fart before you get in ONE TIME...
1631,1690,3,23,92,118,1.2457627118644068,0.04493212915420019,688,"Hi Buzz, you've just missed Neil. He said to meet him up there."
1601,1690,3,23,92,118,1.2457627118644068,0.04493212915420019,688,Isn’t it obvious?
1493,1784,6,16,92,114,1.2456140350877194,0.05070746735519953,688,"So sorry sir,there is no elevator service to the launch pad. I'm afraid you'll have to walk up."
1554,1784,5,18,91,114,1.2456140350877194,0.04915274000962353,688,I assume you're going to the penthouse?
830,1784,3,22,89,114,1.2456140350877194,0.04588552124803296,688,The work clothes store on 7th and 49th has a huge sale this week. Tell them Larry sent you.
2234,1784,3,22,89,114,1.2456140350877194,0.04588552124803296,688,"Third floor - lingerie, housewares, moon rocks."
477,1788,3,16,71,90,1.2444444444444445,0.0531436493707595,688,I've had my ups and downs as well.
5030,1789,6,17,96,119,1.2436974789915967,0.04915811172084668,688,The sky’s the limit?
4153,1789,5,19,95,119,1.2436974789915967,0.0476874207172289,688,"Good morning, Mr. Musk."
4058,1789,3,23,93,119,1.2436974789915967,0.044600789096914985,688,Which way's Houston?
3044,1792,5,18,92,115,1.2434782608695651,0.048770238182640334,688,"Higher, please."
3339,1792,2,24,89,115,1.2434782608695651,0.043827733554238336,688,"We only go to the 24th floor, sir."
3516,1792,5,18,92,115,1.2434782608695651,0.048770238182640334,688,"Sir, we don't go beyond the penthouse."
3020,1792,6,16,93,115,1.2434782608695651,0.05030995362438918,688,Two million please
3580,1792,5,18,92,115,1.2434782608695651,0.048770238182640334,688,The bedbug infestation on six?
4054,1792,4,20,91,115,1.2434782608695651,0.04718030130356046,688,"Thinking of her holiday indulgences, Lydia was thrilled that the new climate change fashion is so forgiving."
2872,1792,4,20,91,115,1.2434782608695651,0.04718030130356046,688,I'm telling you... The L button won't launch anything!
2813,1792,4,20,91,115,1.2434782608695651,0.04718030130356046,688,"The leader’s office is the third door on the left, but he’s hostile to foreigners.”"
2687,1792,4,20,91,115,1.2434782608695651,0.04718030130356046,688,"No giant leap this time, Sir. A small step will do."
2594,1792,2,24,89,115,1.2434782608695651,0.043827733554238336,688,Will you be going up or down?
2405,1792,7,14,94,115,1.2434782608695651,0.051803925864599386,688,"I'm sorry sir,this goes to the Veterinary Hospital ""spay station""  not the ""space station""."
2107,1792,4,20,91,115,1.2434782608695651,0.04718030130356046,688,The hundred and fiftieth  floor is not that high.
2358,1792,5,18,92,115,1.2434782608695651,0.048770238182640334,688,"Any habitable planet,please."
2994,1792,4,20,91,115,1.2434782608695651,0.04718030130356046,688,"No sir, I'm sorry. We don't have billions and billions of floors."
3659,1792,3,22,90,115,1.2434782608695651,0.04553488256049453,688,"We don't go up that far, sir."
4049,1792,3,22,90,115,1.2434782608695651,0.04553488256049453,688,"Sir, you're already on the top floor."
3701,1792,4,20,91,115,1.2434782608695651,0.04718030130356046,688,That's how I started.
4508,1792,3,22,90,115,1.2434782608695651,0.04553488256049453,688,"We can go up again, if you'd like"
4426,1792,4,20,91,115,1.2434782608695651,0.04718030130356046,688,"You're going up, I suppose."
4389,1792,6,16,93,115,1.2434782608695651,0.05030995362438918,688,"Up to Mars, please."
4512,1792,4,20,91,115,1.2434782608695651,0.04718030130356046,688,"Sorry, there are only eight floors now..."
4565,1792,2,24,89,115,1.2434782608695651,0.043827733554238336,688,Sky Lounge?
4748,1792,7,14,94,115,1.2434782608695651,0.051803925864599386,688,The launching pad is on the penthouse level.
4793,1792,3,22,90,115,1.2434782608695651,0.04553488256049453,688,"I ll try my best, but the ceiling is still out there"
4832,1792,4,20,91,115,1.2434782608695651,0.04718030130356046,688,Do you want me to do the countdown again?
3674,1792,4,20,91,115,1.2434782608695651,0.04718030130356046,688,I'm not really sure living in the world's highest penthouse is worth the effort.
4854,1792,4,20,91,115,1.2434782608695651,0.04718030130356046,688,You might want to be seated. This thing takes off like a rocket ship.
4925,1792,5,18,92,115,1.2434782608695651,0.048770238182640334,688,Back for some reentry?
5018,1792,2,24,89,115,1.2434782608695651,0.043827733554238336,688,"Blast-off in 10, 9, 8..."
267,1792,3,22,90,115,1.2434782608695651,0.04553488256049453,688,"Gravity, am I right?"
2363,1792,3,22,90,115,1.2434782608695651,0.04553488256049453,688,"Up, up, and awayyyyyyyy"
3909,1792,4,20,91,115,1.2434782608695651,0.04718030130356046,688,"10, please. Then 9, 8, 7, 6, 5, 4, 3, 2, 1"
3888,1792,5,18,92,115,1.2434782608695651,0.048770238182640334,688,"Sir, it only goes 12 floors up"
3855,1792,2,24,89,115,1.2434782608695651,0.043827733554238336,688,"Major Tom. Please..,step through the door."
3809,1792,6,16,93,115,1.2434782608695651,0.05030995362438918,688,I think your co-workers might be pulling your leg about our moon deck.
4908,1792,4,20,91,115,1.2434782608695651,0.04718030130356046,688,"You know, there are quicker ways up."
2080,1792,2,24,89,115,1.2434782608695651,0.043827733554238336,688,"""Top floor please. I'll get the rest of the way myself ."""
1961,1792,5,18,92,115,1.2434782608695651,0.048770238182640334,688,"Sorry, we don't have a ''stratosphere.'"
2065,1792,5,18,92,115,1.2434782608695651,0.048770238182640334,688,Now we will see how many G's you can take!
2066,1792,4,20,91,115,1.2434782608695651,0.04718030130356046,688,4G only sir but Lenny down the hall will take you to the moon and back for a $5 tip.
7,1792,3,22,90,115,1.2434782608695651,0.04553488256049453,688,"To the rooftop parking, thanks."
161,1792,5,18,92,115,1.2434782608695651,0.048770238182640334,688,"I need space, Gary."
272,1792,3,22,90,115,1.2434782608695651,0.04553488256049453,688,"Here you are sir, home—where | no one can hear you scream."
282,1792,4,20,91,115,1.2434782608695651,0.04718030130356046,688,Not Star Trek and I am not Scottie!
404,1792,6,16,93,115,1.2434782608695651,0.05030995362438918,688,"The penthouse, please."
409,1792,5,18,92,115,1.2434782608695651,0.048770238182640334,688,"OK, so just imagine doing this 13,411.2 times, 100 times faster than we just did, and you’ve got it."
437,1792,4,20,91,115,1.2434782608695651,0.04718030130356046,688,One of us wore the wrong uniform.
567,1792,5,18,92,115,1.2434782608695651,0.048770238182640334,688,"Oh wow, that was my second career choice!"
630,1792,6,16,93,115,1.2434782608695651,0.05030995362438918,688,Will the Penthouse do?
679,1792,2,24,89,115,1.2434782608695651,0.043827733554238336,688,3...2...1...Blast off!
403,1792,5,18,92,115,1.2434782608695651,0.048770238182640334,688,That was scary. I'll never ride an elevator again.
841,1792,3,22,90,115,1.2434782608695651,0.04553488256049453,688,I will have your car fully charged when you return Mr. Musk.
771,1792,6,16,93,115,1.2434782608695651,0.05030995362438918,688,"Come on now, you can do it. Just a few more small steps."
1953,1792,6,16,93,115,1.2434782608695651,0.05030995362438918,688,"Yes, going up, but not that far up..."
1785,1792,8,12,95,115,1.2434782608695651,0.053256004696950646,688,You know this elevator only goes up to the stratosphere?
1779,1792,4,20,91,115,1.2434782608695651,0.04718030130356046,688,I don't suppose you're going down.
1651,1792,3,22,90,115,1.2434782608695651,0.04553488256049453,688,"Penthouse, please.  I hear the air up there is rarefied."
1672,1792,5,18,92,115,1.2434782608695651,0.048770238182640334,688,I think you’re way overdressed for this ascension.
1447,1792,6,16,93,115,1.2434782608695651,0.05030995362438918,688,"I swear, you say ""Going up"" and then laugh one more time..."""
1410,1792,7,14,94,115,1.2434782608695651,0.051803925864599386,688,"No, sir. You'll have to change at the mezzanine."
934,1792,4,20,91,115,1.2434782608695651,0.04718030130356046,688,"8,654,855th floor sir."
1549,1853,3,21,87,111,1.2432432432432432,0.04652760880417772,688,"Yes I do agree, Mrs. Smith's farts are pungent, but this is a little over the top, Buzz."
1102,1853,2,23,86,111,1.2432432432432432,0.04473274211619977,688,"When you reach the 110th floor, the rocket gantry is on your right. Have a nice trip."
2894,1855,7,17,104,128,1.2421875,0.04802457661863982,688,"The International Space Station? That would be floor 134,112."
4286,1856,2,25,93,120,1.2416666666666667,0.04266315417964886,688,Getting off the lift ?
828,1856,3,23,94,120,1.2416666666666667,0.04427415439017953,688,Take me to the Moon.
3711,1858,5,18,93,116,1.2413793103448276,0.04839351694219841,688,Escape velocity?
3668,1858,7,14,95,116,1.2413793103448276,0.051398273871768915,688,You should consider taking the giant steps.
3689,1858,3,22,91,116,1.2413793103448276,0.04518940591634643,688,"Going out for another buzz, Buzz?"
4005,1858,4,20,92,116,1.2413793103448276,0.046818879146703046,688,"I can only take you to the top floor, your on your own from there."
3796,1858,7,14,95,116,1.2413793103448276,0.051398273871768915,688,"I'm sorry, but 'the Red Planet' is not a floor number!"
3856,1858,3,22,91,116,1.2413793103448276,0.04518940591634643,688,"No, I won't call Uber"
3893,1858,2,24,90,116,1.2413793103448276,0.04349893526962546,688,Gravity awaits you.
4025,1858,5,18,93,116,1.2413793103448276,0.04839351694219841,688,May I suggest taking one small step?
4076,1858,7,14,95,116,1.2413793103448276,0.051398273871768915,688,The great thing about Jupiter is you can ditch the spacesuit after a couple years.
3550,1858,5,18,93,116,1.2413793103448276,0.04839351694219841,688,"I don't think we are quite there yet, sir"
3752,1858,5,18,93,116,1.2413793103448276,0.04839351694219841,688,"Women's Lingerie, we have a problem."
3410,1858,6,16,94,116,1.2413793103448276,0.04991850878698305,688,"To the moon and back, please."
2838,1858,3,22,91,116,1.2413793103448276,0.04518940591634643,688,Sorry.  This is as high as I can take you.
3301,1858,5,18,93,116,1.2413793103448276,0.04839351694219841,688,More budget cuts at NASA?
3273,1858,4,20,92,116,1.2413793103448276,0.046818879146703046,688,"Yes, sir, of course, it's good to be prepared.  But this building only has four floors."
3211,1858,5,18,93,116,1.2413793103448276,0.04839351694219841,688,They say it’s going to be a red one.
3118,1858,5,18,93,116,1.2413793103448276,0.04839351694219841,688,"I'm sorry, this elevator will only get you to the 30th floor..."
3007,1858,5,18,93,116,1.2413793103448276,0.04839351694219841,688,Can I have room service send up your launch?
2981,1858,2,24,90,116,1.2413793103448276,0.04349893526962546,688,"Once again , with feeling. Up, Up,and Away !"
2908,1858,6,16,94,116,1.2413793103448276,0.04991850878698305,688,"You said the 2,000th floor?"
2901,1858,4,20,92,116,1.2413793103448276,0.046818879146703046,688,And we have lift off.
4111,1858,6,16,94,116,1.2413793103448276,0.04991850878698305,688,"Ten, nine, eight, seven, six, five, four, three, two, one? Make up your mind already!"
2807,1858,5,18,93,116,1.2413793103448276,0.04839351694219841,688,Need to go back up. I forgot my wallet.
2784,1858,7,14,95,116,1.2413793103448276,0.051398273871768915,688,"Have a nice day, Miss Maxwell"
2725,1858,5,18,93,116,1.2413793103448276,0.04839351694219841,688,"...5, 4, 3, 2..."
3304,1858,5,18,93,116,1.2413793103448276,0.04839351694219841,688,"I understand your pain, the new directors are not as talented as Mr. Kubrick."
4144,1858,5,18,93,116,1.2413793103448276,0.04839351694219841,688,"Jet-pack been malfunctioning again, sir?"
4652,1858,6,16,94,116,1.2413793103448276,0.04991850878698305,688,"Sir, I have some bad news. First, the Stardust Lounge has a no-hats policy. Second, well, let's just say you're taking the name little bit too literally."
4204,1858,2,24,90,116,1.2413793103448276,0.04349893526962546,688,"This just goes up to the fourth floor, sir."
5286,1858,5,18,93,116,1.2413793103448276,0.04839351694219841,688,Space tourism has given rise to novel fashion trends
5227,1858,7,14,95,116,1.2413793103448276,0.051398273871768915,688,VCThe sign in the window said Space for RenT
5219,1858,5,18,93,116,1.2413793103448276,0.04839351694219841,688,What? It was either one small step or nine flights of stairs.
5197,1858,4,20,92,116,1.2413793103448276,0.046818879146703046,688,"Indeed, Sir. The penthouse atmosphere can be rather inhospitable."
5148,1858,5,18,93,116,1.2413793103448276,0.04839351694219841,688,"Sir, the Eagle has landed."
5126,1858,6,16,94,116,1.2413793103448276,0.04991850878698305,688,"...If I sleep in it, I won’t forget it."
5062,1858,4,20,92,116,1.2413793103448276,0.046818879146703046,688,"I'm sorry to hear about the budget cuts at NASA, but, technically, a skyscraper is only 40 stories high."
5020,1858,4,20,92,116,1.2413793103448276,0.046818879146703046,688,"I swear to God if you say ""going up"""
4993,1858,6,16,94,116,1.2413793103448276,0.04991850878698305,688,"My mom was anti-vaccine, so now I wear this."
4974,1858,4,20,92,116,1.2413793103448276,0.046818879146703046,688,"You know we only go up twenty stories, right
?"
4948,1858,4,20,92,116,1.2413793103448276,0.046818879146703046,688,The very top floor sir .
4916,1858,4,20,92,116,1.2413793103448276,0.046818879146703046,688,"That’s one small step for man, and ladies shoes on floor 5."
4886,1858,6,16,94,116,1.2413793103448276,0.04991850878698305,688,We’re already on the top floor.
4791,1858,4,20,92,116,1.2413793103448276,0.046818879146703046,688,"Yes, recreational is legal, but we don't go that high."
4783,1858,6,16,94,116,1.2413793103448276,0.04991850878698305,688,"Full moon tonight, sir?"
4723,1858,6,16,94,116,1.2413793103448276,0.04991850878698305,688,"To the astronomical savings, please."
4496,1858,4,20,92,116,1.2413793103448276,0.046818879146703046,688,"Sorry, sir, but this is as high as I can go."
4449,1858,4,20,92,116,1.2413793103448276,0.046818879146703046,688,One small step for man and the doctor's office is down the hall to your left.
4424,1858,4,20,92,116,1.2413793103448276,0.046818879146703046,688,I see you noticed the windows are all sealed.
4407,1858,5,18,93,116,1.2413793103448276,0.04839351694219841,688,This always happened when I put on a snow suit too.
4375,1858,2,24,90,116,1.2413793103448276,0.04349893526962546,688,"Oh, sorry. I pressed the wrong floor."
4357,1858,6,16,94,116,1.2413793103448276,0.04991850878698305,688,How was da view!
4335,1858,5,18,93,116,1.2413793103448276,0.04839351694219841,688,Is automation coming for your job too?
4331,1858,6,16,94,116,1.2413793103448276,0.04991850878698305,688,I didn't realize the toilet overflow on four was that serious.
4299,1858,4,20,92,116,1.2413793103448276,0.046818879146703046,688,You’re thinking of that building in Dubai.
4256,1858,2,24,90,116,1.2413793103448276,0.04349893526962546,688,"You know, they’re not all giant leaps."
4221,1858,5,18,93,116,1.2413793103448276,0.04839351694219841,688,Don't complain -- the Russians switched to using stairs.
4200,1858,4,20,92,116,1.2413793103448276,0.046818879146703046,688,"A rooftop launch does shorten the distance, but not by much."
2575,1858,4,20,92,116,1.2413793103448276,0.046818879146703046,688,"Sorry, this elevator goes only to the 3,857th floor."
2541,1858,6,16,94,116,1.2413793103448276,0.04991850878698305,688,I know it looks it but the penthouse doesn't go that high sir.
2504,1858,4,20,92,116,1.2413793103448276,0.046818879146703046,688,2030: A Space Odyssey
1191,1858,6,16,94,116,1.2413793103448276,0.04991850878698305,688,Wait. So that’s what’s on the 13th floor?
1180,1858,3,22,91,116,1.2413793103448276,0.04518940591634643,688,"No,not THAT small a step - you're still in the elevator."
1157,1858,2,24,90,116,1.2413793103448276,0.04349893526962546,688,Stratosphere?
1135,1858,4,20,92,116,1.2413793103448276,0.046818879146703046,688,We will reach a maximum ascent speed of 10 miles per hour.
1128,1858,4,20,92,116,1.2413793103448276,0.046818879146703046,688,"Ok, Mr. Aldrin, one small step..."
1073,1858,2,24,90,116,1.2413793103448276,0.04349893526962546,688,They stopped the countdown at 3 so I could get my lucky socks.
1037,1858,4,20,92,116,1.2413793103448276,0.046818879146703046,688,One small step to the 17th sir.
1003,1858,5,18,93,116,1.2413793103448276,0.04839351694219841,688,"Suit yourself, but may I suggest that your attire to ride up to the 90th floor is a Bit Over the Top."
999,1858,6,16,94,116,1.2413793103448276,0.04991850878698305,688,"I have to ask , your not afraid of heights are you?"
1205,1858,4,20,92,116,1.2413793103448276,0.046818879146703046,688,"Not enough oxygen on the third floor, sir?"
795,1858,3,22,91,116,1.2413793103448276,0.04518940591634643,688,"Right this way, Mr. President."
734,1858,5,18,93,116,1.2413793103448276,0.04839351694219841,688,"Sorry, Sir, this is Hotel Canaveral."
660,1858,3,22,91,116,1.2413793103448276,0.04518940591634643,688,I need to start slow for the high G-training.
2565,1858,2,24,90,116,1.2413793103448276,0.04349893526962546,688,Can I bother you to do a count down?
560,1858,7,14,95,116,1.2413793103448276,0.051398273871768915,688,"Yeah, burrito day is a rough day in the elevator."
468,1858,6,16,94,116,1.2413793103448276,0.04991850878698305,688,Your luggage will be brought up by one of our space cadets.
349,1858,5,18,93,116,1.2413793103448276,0.04839351694219841,688,"I'm your ground control, Major Tom."
321,1858,8,12,96,116,1.2413793103448276,0.05283661225399129,688,"Pardon me, but the notice said tenants must prepare for the lift to be off."
229,1858,4,20,92,116,1.2413793103448276,0.046818879146703046,688,"Yeah, Houston was sick of all my problems."
70,1858,4,20,92,116,1.2413793103448276,0.046818879146703046,688,Psst...it’s flat!
774,1858,4,20,92,116,1.2413793103448276,0.046818879146703046,688,"Third floor, vacuums."
1303,1858,6,16,94,116,1.2413793103448276,0.04991850878698305,688,"The rooftop terrace has plenty of 
outer space."
639,1858,2,24,90,116,1.2413793103448276,0.04349893526962546,688,Are you sure you want to go down?
2364,1858,2,24,90,116,1.2413793103448276,0.04349893526962546,688,Parkade level Mr. Tesla
2486,1858,4,20,92,116,1.2413793103448276,0.046818879146703046,688,"Deplorables, please."
2477,1858,4,20,92,116,1.2413793103448276,0.046818879146703046,688,See you Richard - and please skip your silly To infinity and beyond joke.
2468,1858,4,20,92,116,1.2413793103448276,0.046818879146703046,688,"""The joint needs a little atmosphere."""
2413,1858,2,24,90,116,1.2413793103448276,0.04349893526962546,688,"Not just up, but up, up and away."
2360,1858,3,22,91,116,1.2413793103448276,0.04518940591634643,688,"My name is not Alice, and we don't stop at the moon."
2328,1858,5,18,93,116,1.2413793103448276,0.04839351694219841,688,They really are building them too tall these days.
2302,1858,4,20,92,116,1.2413793103448276,0.046818879146703046,688,Is this a trial run?
2224,1858,4,20,92,116,1.2413793103448276,0.046818879146703046,688,This IS the top floor isn't it?
2197,1858,5,18,93,116,1.2413793103448276,0.04839351694219841,688,One giant lift for mankind
2153,1858,2,24,90,116,1.2413793103448276,0.04349893526962546,688,How far up do you go?
2285,1858,7,14,95,116,1.2413793103448276,0.051398273871768915,688,Psssst...XYZ Mr. Worthington.
1313,1858,4,20,92,116,1.2413793103448276,0.046818879146703046,688,The “Space Force” meeting wasn’t what I thought it would be
2049,1858,3,22,91,116,1.2413793103448276,0.04518940591634643,688,"Sorry, the near space elevator is out of order."
1957,1858,4,20,92,116,1.2413793103448276,0.046818879146703046,688,Have a seat. It's going to be a long ride.
1796,1858,4,20,92,116,1.2413793103448276,0.046818879146703046,688,"Baby steps,right?"
1664,1858,1,26,89,116,1.2413793103448276,0.04174005668551262,688,This floor: One small step for man
1425,1858,5,18,93,116,1.2413793103448276,0.04839351694219841,688,There are three moons orbiting the penthouse. Which one?
2087,1858,2,24,90,116,1.2413793103448276,0.04349893526962546,688,Re-entering Sir?
1577,1858,6,16,94,116,1.2413793103448276,0.04991850878698305,688,"Yes, the penthouse is an excellent start."""
3737,1961,5,17,90,112,1.2410714285714286,0.04952401448452785,688,"I missed my flight, can I get a lift up?"
2902,1962,5,14,81,100,1.24,0.053409037180286764,688,"Wise choice sir, ground level folk are dangerously infectious"
2036,1963,6,11,79,96,1.2395833333333333,0.05686393359981743,688,"Sorry sir, this elevator only goes up to the penthouse."
3779,1964,6,16,95,117,1.2393162393162394,0.04953299836019056,688,"Of course it's real. I got it in Chinatown."""
2882,1965,3,21,89,113,1.238938053097345,0.045800811460775734,688,I take it the  Mrs. is  broiling  kippers tonight  sir.
2827,1965,6,15,92,113,1.238938053097345,0.05071289549168667,688,It's one small step outside
3107,1965,2,23,88,113,1.238938053097345,0.0440418723213541,688,"Third floor, heat shields."
2675,1965,3,21,89,113,1.238938053097345,0.045800811460775734,688,"Bad air quality today, sir?"
3021,1965,7,13,93,113,1.238938053097345,0.05224773279335481,688,Kindly tell management the water has been splashed out of the roof pool.  And there's a few guests who need drinks.
3218,1965,3,21,89,113,1.238938053097345,0.045800811460775734,688,"The lunar rover is apparently still in the shop, sir. Shall I call an Uber?"
3544,1965,4,19,90,113,1.238938053097345,0.047494653839780694,688,It's just one small step for everybody
2208,1965,5,17,91,113,1.238938053097345,0.04913013287439456,688,"We don't have a floor ""Up Up and Away"" sir."
4000,1965,7,13,93,113,1.238938053097345,0.05224773279335481,688,"Third floor. Shoes for a man, giant boots for mankind."
2177,1965,4,19,90,113,1.238938053097345,0.047494653839780694,688,"Sorry, but you'll have to get off on thirty-six and transfer to the express elevator."
2052,1965,3,21,89,113,1.238938053097345,0.045800811460775734,688,"We don't validate on the roof, sir."
4301,1965,5,17,91,113,1.238938053097345,0.04913013287439456,688,"Well, sir, the price of the penthouse is out of this world anyway."
2015,1965,5,17,91,113,1.238938053097345,0.04913013287439456,688,"Which one are you? Sorry, I'm the WORST at remembering faces..."
1943,1965,4,19,90,113,1.238938053097345,0.047494653839780694,688,"5, 4, 3, 2 AND 1?"
2449,1965,6,15,92,113,1.238938053097345,0.05071289549168667,688,Outerwear is on 7.
4326,1965,3,21,89,113,1.238938053097345,0.045800811460775734,688,This is as close as I can get you
4641,1965,4,19,90,113,1.238938053097345,0.047494653839780694,688,"Which floor are looking to touch down on, sir?"
4341,1965,4,19,90,113,1.238938053097345,0.047494653839780694,688,"I'm sorry, there's no ""launch speed"" on this elevator."
3527,1965,3,21,89,113,1.238938053097345,0.045800811460775734,688,Sorry but the sky's not the limit . . . it's the penthouse.
3652,1965,4,19,90,113,1.238938053097345,0.047494653839780694,688,"Sir, this is your floor!  Dod you 'space out' again"
3391,1965,3,21,89,113,1.238938053097345,0.045800811460775734,688,"This is as high as it goes, sir."
3335,1965,3,21,89,113,1.238938053097345,0.045800811460775734,688,"Yes, just one small step sir."
3243,1965,5,17,91,113,1.238938053097345,0.04913013287439456,688,This elevator only goes to the Moon. Express to cookware is across the hall.
4645,1965,5,17,91,113,1.238938053097345,0.04913013287439456,688,"7th floor, where no man has gone before."
3756,1965,5,17,91,113,1.238938053097345,0.04913013287439456,688,This is your floor....one small step for man.
1936,1965,2,23,88,113,1.238938053097345,0.0440418723213541,688,"You may have a leak, sir!"
4728,1965,5,17,91,113,1.238938053097345,0.04913013287439456,688,"I'm sorry sir, that floor requires special club membership."
4746,1965,5,17,91,113,1.238938053097345,0.04913013287439456,688,To the Moon and Back please. Thank you.
4936,1965,3,21,89,113,1.238938053097345,0.045800811460775734,688,"You're right, Sir... I shouldn't introduce myself as an elevator pilot. I clearly don't grasp the gravity of the situation."
4943,1965,7,13,93,113,1.238938053097345,0.05224773279335481,688,The Jones' parties have a limited atmosphere.
3869,1965,0,27,86,113,1.238938053097345,0.040294303465630434,688,"Sir, you don't need to countdown for this."
5184,1965,4,19,90,113,1.238938053097345,0.047494653839780694,688,Welcome to Dubai.
4355,1965,4,19,90,113,1.238938053097345,0.047494653839780694,688,Watch the one small step.
4339,1965,4,19,90,113,1.238938053097345,0.047494653839780694,688,"You know this only goes as far up as the penthouse, right?"
4093,1965,6,15,92,113,1.238938053097345,0.05071289549168667,688,That's one small step for Sherman; one giant leap for the co-op board.
1740,1965,4,19,90,113,1.238938053097345,0.047494653839780694,688,Going waaaaay up sir?
1714,1965,6,15,92,113,1.238938053097345,0.05071289549168667,688,"Yes, there is Tang available in the Milky Way suite. I’ll see you again when you are ready for re-entry."
264,1965,3,21,89,113,1.238938053097345,0.045800811460775734,688,"Moonwalk contest, on the right sir"
578,1965,3,21,89,113,1.238938053097345,0.045800811460775734,688,My last place had a better view.
800,1965,2,23,88,113,1.238938053097345,0.0440418723213541,688,Shall I engage thrusters?
829,1965,7,13,93,113,1.238938053097345,0.05224773279335481,688,You...overdressed? No-o-o.
1090,1965,4,19,90,113,1.238938053097345,0.047494653839780694,688,Its good to be back
1093,1965,3,21,89,113,1.238938053097345,0.045800811460775734,688,"I'm sorry, this only goes to the millionth floor."
665,1965,4,19,90,113,1.238938053097345,0.047494653839780694,688,You’re Greta Thunberg!
1540,1965,2,23,88,113,1.238938053097345,0.0440418723213541,688,"So you guys provide complimentary breakfast, right?"
1689,1965,1,25,87,113,1.238938053097345,0.04220969917774097,688,To infinity and beyond
1929,1965,5,17,91,113,1.238938053097345,0.04913013287439456,688,Watch your step. The gravity of the situation is pretty strong in the Trump Tower.
1699,1965,5,17,91,113,1.238938053097345,0.04913013287439456,688,"So sorry, this elevator doesn't go that high."
1500,1965,3,21,89,113,1.238938053097345,0.045800811460775734,688,"Women. One day they want space, next day the don’t."
2844,1965,2,23,88,113,1.238938053097345,0.0440418723213541,688,How far 'up'?
5032,2015,4,23,103,130,1.2384615384615385,0.0434140061237124,688,You still get out of breath taking the stairs?
4932,2016,4,20,94,118,1.2372881355932204,0.04611200470995581,688,"Been operating the Wonka elevator for years, sir - and never been requested to push that particular button."
2538,2016,4,20,94,118,1.2372881355932204,0.04611200470995581,688,"If you push the button and say ""blast off,""  I will hurt you."
1843,2018,3,17,77,97,1.2371134020618557,0.05028525988543606,688,"Launching floor, Commander."
755,2018,3,17,77,97,1.2371134020618557,0.05028525988543606,688,How far up do you want to go?
5072,2020,5,17,92,114,1.236842105263158,0.04874234413978753,688,"I know we've done it all week, but other passengers get freaked out when I yell 'BLAST OFF' when we get to the lobby."
4012,2020,5,17,92,114,1.236842105263158,0.04874234413978753,688,Your parents will know about your failure to launch. Going up?
3434,2020,6,15,93,114,1.236842105263158,0.05030975558841903,688,"In other words, hold my hand.  In other words, darling, kiss me."
2492,2020,4,19,91,114,1.236842105263158,0.047122825860897805,688,"Watch your step- it may seem small, but it's a giant leap for man."
1176,2020,4,19,91,114,1.236842105263158,0.047122825860897805,688,"The moon? I'm sorry sir, but I don't think we go quite that high."
4284,2025,2,22,86,110,1.2363636363636363,0.04460422328836234,688,A small step for you.
4701,2026,5,16,90,111,1.2342342342342343,0.049493677083499193,688,"‘’We choose to go to 23, not because it is easy but because it is hard.”"
3572,2026,4,18,89,111,1.2342342342342343,0.0478102908111374,688,I'm afraid we only go up 110 stories.  You might try Dubai.
3554,2026,6,14,91,111,1.2342342342342343,0.051121661113913905,688,"Uh, I don't think I can go that far up."
3537,2026,7,12,92,111,1.2342342342342343,0.052699377594484176,688,"Uh, sorry sir, but there's no rocket for  you to enter on this floor.  In fact, you are at the wrong  building."
3518,2026,4,18,89,111,1.2342342342342343,0.0478102908111374,688,"I, uh... I thought you’d appreciate me counting down the floors. Sorry sir.

Anyway, we’re at floor one. I mean, first floor."
3489,2026,4,18,89,111,1.2342342342342343,0.0478102908111374,688,Can I borrow your Netflix account while you're away?
3477,2026,7,12,92,111,1.2342342342342343,0.052699377594484176,688,How far up were you hoping to go?
3430,2026,5,16,90,111,1.2342342342342343,0.049493677083499193,688,The Giuliani cigar club is at the last door on the left.
3398,2026,5,16,90,111,1.2342342342342343,0.049493677083499193,688,Working long hours to pay for Virgin Galactic space tour.
3372,2026,3,20,88,111,1.2342342342342343,0.046065428942378965,688,"I'm not sure that's gonna change their mind on removing you from office, Sir."
3231,2026,4,18,89,111,1.2342342342342343,0.0478102908111374,688,NASA requires I wear it casually”
3214,2026,3,20,88,111,1.2342342342342343,0.046065428942378965,688,I thought I left the lights on.
3197,2026,4,18,89,111,1.2342342342342343,0.0478102908111374,688,"Sorry, Sir, this elevator no longer stops on that floor."
3189,2026,6,14,91,111,1.2342342342342343,0.051121661113913905,688,"Alright, so these Polack astronauts were gonna launch a rocket and go fly to the sun, right? Everyone goes, Whoa, bad idea! You guys'll melt, right? Get this: The Polacks say, Relax! We'll just go when it's dar— hang on...you're not Polish are you?"
3121,2026,6,14,91,111,1.2342342342342343,0.051121661113913905,688,"I'm afraid that's as high as it goes, sir."
3086,2026,3,20,88,111,1.2342342342342343,0.046065428942378965,688,We don’t go that far up sir.
3058,2026,1,24,86,111,1.2342342342342343,0.0423606352176763,688,The restroom is down the hall on the right
3051,2026,4,18,89,111,1.2342342342342343,0.0478102908111374,688,"I said ""ground control,"" not ""ground floor."""
3030,2026,3,20,88,111,1.2342342342342343,0.046065428942378965,688,"Sorry, Mr. Peterson, we’re not going past the 9th floor today."
2942,2026,3,20,88,111,1.2342342342342343,0.046065428942378965,688,"No, we don't have the Willy Wonka ejection feature in this particular elevator."
2781,2026,4,18,89,111,1.2342342342342343,0.0478102908111374,688,Really not necessary for the Starlight Room.
2777,2026,2,22,87,111,1.2342342342342343,0.04425182007381393,688,I didn't realize the budget cuts at NASA had been that bad!
2706,2026,3,20,88,111,1.2342342342342343,0.046065428942378965,688,"The 126,427,013th floor, please."
2656,2026,4,18,89,111,1.2342342342342343,0.0478102908111374,688,"Going down, sir?"
2512,2026,5,16,90,111,1.2342342342342343,0.049493677083499193,688,"I can assure you, sir, no man has gone here before. The only thing down here is the hotel gym."
2371,2026,6,14,91,111,1.2342342342342343,0.051121661113913905,688,"Now, wasn't that a better landing than when you came down in the water?"
2167,2026,3,20,88,111,1.2342342342342343,0.046065428942378965,688,"Express, Please."
2132,2026,4,18,89,111,1.2342342342342343,0.0478102908111374,688,"We no longer go to Pluto, just a heads up."
2098,2026,2,22,87,111,1.2342342342342343,0.04425182007381393,688,"I’m sorry, but this only goes to floor 5, sir, or madam"
3680,2026,2,22,87,111,1.2342342342342343,0.04425182007381393,688,"Yes Sir , You can drain your suit at the washroom down the hall ."
3717,2026,4,18,89,111,1.2342342342342343,0.0478102908111374,688,"I'm sorry, this is the top floor."
3768,2026,4,18,89,111,1.2342342342342343,0.0478102908111374,688,It doesn't go that far.
3896,2026,2,22,87,111,1.2342342342342343,0.04425182007381393,688,Have a nice day and please watch your one small step.
4762,2026,2,22,87,111,1.2342342342342343,0.04425182007381393,688,"May I remind you, sir, that this is restricted airspace?"
4672,2026,2,22,87,111,1.2342342342342343,0.04425182007381393,688,"Oh, I'm sorry.  I didn't realize you wanted to go up."
4507,2026,4,18,89,111,1.2342342342342343,0.0478102908111374,688,"Time for your daily orbit around the block, Sir?"
4818,2026,3,20,88,111,1.2342342342342343,0.046065428942378965,688,Don’t ask.  Just do me a favor and say ‘3 2 1 liftoff’ before you hit the button.
4454,2026,4,18,89,111,1.2342342342342343,0.0478102908111374,688,I'm afraid you have the wrong elevator sir.
4351,2026,1,24,86,111,1.2342342342342343,0.0423606352176763,688,I parked pretty far.
4975,2026,3,20,88,111,1.2342342342342343,0.046065428942378965,688,"It's just one small step, but still, let's be careful."
4330,2026,3,20,88,111,1.2342342342342343,0.046065428942378965,688,"Going  up to cruise wear on the 6th floor, sir?”"
4296,2026,5,16,90,111,1.2342342342342343,0.049493677083499193,688,It's a small step sir.  Just a little gap.  You can do it.
4294,2026,3,20,88,111,1.2342342342342343,0.046065428942378965,688,I believe you are taking the space for rent ad a bit too literally sir.
4285,2026,4,18,89,111,1.2342342342342343,0.0478102908111374,688,"Beam me up, Smithers."
5022,2026,6,14,91,111,1.2342342342342343,0.051121661113913905,688,"Don’t mind me saying it, sir, but adult diapers are easier."
4226,2026,2,22,87,111,1.2342342342342343,0.04425182007381393,688,"Sorry, Buzz, you're on your own beyond the 10th floor"
4704,2026,3,20,88,111,1.2342342342342343,0.046065428942378965,688,"This floor is lace, not space."
4217,2026,6,14,91,111,1.2342342342342343,0.051121661113913905,688,"Mrs Saltzman trying her hand at curry, sir?"
5120,2026,5,16,90,111,1.2342342342342343,0.049493677083499193,688,"The ad said, “Open Space Loft for Rent”"
4171,2026,6,14,91,111,1.2342342342342343,0.051121661113913905,688,"It’s just exiting an elevator, Sir. Not a giant leap for mankind."
2085,2026,5,16,90,111,1.2342342342342343,0.049493677083499193,688,Space suits are on 5.
5138,2026,6,14,91,111,1.2342342342342343,0.051121661113913905,688,"It’s just a few small steps down the corridor on your right, sir...if you get to the giant leap you’ve gone to far"
5190,2026,3,20,88,111,1.2342342342342343,0.046065428942378965,688,"No sir, I had no idea the penthouse was that high up."
5220,2026,4,18,89,111,1.2342342342342343,0.0478102908111374,688,"Okay, remember to jump right before we get to the top."
5301,2026,4,18,89,111,1.2342342342342343,0.0478102908111374,688,You may feel a slight weightlessness when the elevator starts.
4121,2026,3,20,88,111,1.2342342342342343,0.046065428942378965,688,"Trust me, sir you can only look at the moon from the 115th floor!"
4099,2026,2,22,87,111,1.2342342342342343,0.04425182007381393,688,Plenty of time to explain on the way up.
4074,2026,3,20,88,111,1.2342342342342343,0.046065428942378965,688,Alice Kramden doesn't live here anymore.
3999,2026,5,16,90,111,1.2342342342342343,0.049493677083499193,688,I was told this is a skyscraper... is this really as high as we can go?
3917,2026,4,18,89,111,1.2342342342342343,0.0478102908111374,688,"I told you when you got on sir, twelfth is the highest floor we get to."
3900,2026,3,20,88,111,1.2342342342342343,0.046065428942378965,688,"The penthouse, Mr. Musk?"
5033,2026,4,18,89,111,1.2342342342342343,0.0478102908111374,688,"Sir, your wife decided not to make the pickled herring tonight."
2010,2026,4,18,89,111,1.2342342342342343,0.0478102908111374,688,Damn the Wall.
1437,2026,4,18,89,111,1.2342342342342343,0.0478102908111374,688,Is this the space you were interested in?
1722,2026,5,16,90,111,1.2342342342342343,0.049493677083499193,688,Roof Garden. The Final Frontier. Please Go Boldly...
822,2026,4,18,89,111,1.2342342342342343,0.0478102908111374,688,"Sir, this floor is the Moon. For Mars, please take the express elevator."
753,2026,4,18,89,111,1.2342342342342343,0.0478102908111374,688,"Another Space Force gravity test to the basement, Mr. Vice-President?"
727,2026,6,14,91,111,1.2342342342342343,0.051121661113913905,688,"Pardon me sir, perhaps you haven’t heard but the sanitation workers strike is over."
668,2026,4,18,89,111,1.2342342342342343,0.0478102908111374,688,'Going up?' Like I haven't heard that one before.
615,2026,5,16,90,111,1.2342342342342343,0.049493677083499193,688,"I'd actually like to go further than the ""sky lounge"""
583,2026,4,18,89,111,1.2342342342342343,0.0478102908111374,688,"One small step for man, one hopefully giant tip for Manuel."
481,2026,6,14,91,111,1.2342342342342343,0.051121661113913905,688,"Lobby, Sir, the eagle has landed."
476,2026,5,16,90,111,1.2342342342342343,0.049493677083499193,688,"Diaper duty again, sir?"
860,2026,3,20,88,111,1.2342342342342343,0.046065428942378965,688,"They launch from roof level on the half hours. Frankly, this whole commercialization of space thing isn’t quite what I imagined."
471,2026,3,20,88,111,1.2342342342342343,0.046065428942378965,688,I must of gotten off on the wrong planet.
348,2026,6,14,91,111,1.2342342342342343,0.051121661113913905,688,To the penthouse and beyond!
342,2026,4,18,89,111,1.2342342342342343,0.0478102908111374,688,"I'm not sure how to tell you this sir, but space suits are in the lower basement."
1898,2026,4,18,89,111,1.2342342342342343,0.0478102908111374,688,"If you think you might actually not come back this time, my Great Aunt Vera would like to rent your apartment."
308,2026,2,22,87,111,1.2342342342342343,0.04425182007381393,688,"Which floor? Ten, nine, eight…?"
190,2026,1,24,86,111,1.2342342342342343,0.0423606352176763,688,"Good Evening, Commander. Nice night for a walk."
172,2026,3,20,88,111,1.2342342342342343,0.046065428942378965,688,Budget cuts?
85,2026,5,16,90,111,1.2342342342342343,0.049493677083499193,688,- So how much have I missed? - Uhmm flat-earthers are a thing again! - Uh!!!
84,2026,3,20,88,111,1.2342342342342343,0.046065428942378965,688,to infinity and beyond please
454,2026,4,18,89,111,1.2342342342342343,0.0478102908111374,688,"Watch your one small step, please."
869,2026,4,18,89,111,1.2342342342342343,0.0478102908111374,688,This is a To Go order from the new oxygen bar around the corner.
333,2026,4,18,89,111,1.2342342342342343,0.0478102908111374,688,Think carefully about what you’ll say.  “One small step for man . . . “ has already been used.
926,2026,1,24,86,111,1.2342342342342343,0.0423606352176763,688,"Try one small step, sir. It doesn't have to be a giant leap for mankind."
874,2026,5,16,90,111,1.2342342342342343,0.049493677083499193,688,I can take you as far as the glass ceiling.
1589,2026,1,24,86,111,1.2342342342342343,0.0423606352176763,688,You're going to love your new apartment. It has more space than you can imagine.
1582,2026,4,18,89,111,1.2342342342342343,0.0478102908111374,688,Of course I'm going up!
1468,2026,3,20,88,111,1.2342342342342343,0.046065428942378965,688,"Sadly, this is not my first space walk of shame."
1432,2026,6,14,91,111,1.2342342342342343,0.051121661113913905,688,"It's overkill sir. This is the penthouse floor, but Trump is not in today."
1400,2026,4,18,89,111,1.2342342342342343,0.0478102908111374,688,When you get to your floor take one small step off the elevator and then a giant leap into your room.
1238,2026,2,22,87,111,1.2342342342342343,0.04425182007381393,688,In case the Clean Air Act is repealed.
1579,2026,2,22,87,111,1.2342342342342343,0.04425182007381393,688,"No Sir, B is for Basement not Blast off"
1190,2026,6,14,91,111,1.2342342342342343,0.051121661113913905,688,"Air pretty thin up there in the penthouse, eh, Mr. Aldrin?"
1002,2026,3,20,88,111,1.2342342342342343,0.046065428942378965,688,"One hundred fifty fourth floor, Madam. Air lock to your right."
1234,2026,6,14,91,111,1.2342342342342343,0.051121661113913905,688,"Jupiter?  What you want to do is go all the way back down, make a left at the end of the corridor, turn right there and you’ll see the ‘B’ elevator on your left just past the Starbucks."
996,2026,5,16,90,111,1.2342342342342343,0.049493677083499193,688,The Building Management calls it outer space but its really just a patio.
937,2026,2,22,87,111,1.2342342342342343,0.04425182007381393,688,"The sky desk, please."
979,2026,3,20,88,111,1.2342342342342343,0.046065428942378965,688,Watch your small step for man.
2298,2127,2,21,84,107,1.233644859813084,0.04518704490270077,688,"Floor 309283, please."
1594,2128,4,20,96,120,1.2333333333333334,0.0454256762579498,688,This way if I fart no one will know.
1753,2128,4,20,96,120,1.2333333333333334,0.0454256762579498,688,Dressin' for the job you want. eh?
3800,2130,3,21,92,116,1.2327586206896552,0.04475111687849267,688,"Whew, major head-rush.  Let's do it again!!"
4485,2130,5,17,94,116,1.2327586206896552,0.04798450309042525,688,"I’m sorry.  This building is only 40
stories up.  This is it."
3994,2130,2,23,91,116,1.2327586206896552,0.04304343648445431,688,T-minus tenth floor?
2879,2130,2,23,91,116,1.2327586206896552,0.04304343648445431,688,"I'm sorry, sir, you will have to walk the rest of the way."
5330,2134,6,14,92,112,1.2321428571428572,0.050706309304391906,688,The anti gravity room is next to the bar.
3920,2134,3,20,89,112,1.2321428571428572,0.045700156680772756,688,"This is as far as I can take you, but I can sing a few bars of ""Fly Me to the Moon""."
5049,2136,3,19,86,108,1.2314814814814814,0.046709818132625494,688,"Well, 'dress for the job you want' I suppose."
1270,2136,3,19,86,108,1.2314814814814814,0.046709818132625494,688,I forgot my ID
1514,2136,2,21,85,108,1.2314814814814814,0.04481893398391732,688,"Top floor, sir. You can walk to the moon from here."
5122,2136,3,19,86,108,1.2314814814814814,0.046709818132625494,688,"Good evening, Mr. Bowie."
5316,2136,4,17,87,108,1.2314814814814814,0.0485270787963912,688,"Just bought the penthouse, did you?"
5044,2136,4,17,87,108,1.2314814814814814,0.0485270787963912,688,"What, the atmosphere wasn't good enough?"
1880,2136,5,15,88,108,1.2314814814814814,0.0502786996951927,688,"Yes, sir, I'm sure. This elevator will NOT take you to the orbiter cockpit."
1875,2136,1,23,84,108,1.2314814814814814,0.04284467968052193,688,"Due to budget cuts, the reentry program was cancelled."
1295,2136,2,21,85,108,1.2314814814814814,0.04481893398391732,688,"I swear, if I hear ""going up?"" one more time..."
5104,2136,3,19,86,108,1.2314814814814814,0.046709818132625494,688,"I will watch you take your step, Sir. But one can not simply summon the paparazzi."
5314,2136,4,17,87,108,1.2314814814814814,0.0485270787963912,688,"Just so we’re clear - -the only MOONs’  
I can take you Near, live on Floor 24"
3872,2136,4,17,87,108,1.2314814814814814,0.0485270787963912,688,I'm sorry you missed your shuttle but we just don't go high enough
4506,2136,6,13,89,108,1.2314814814814814,0.051971318143448894,688,"I am afraid we do not bave a 2,567,000 floor in this building."
2075,2136,4,17,87,108,1.2314814814814814,0.0485270787963912,688,I’m sorry sir but this car does not go to infinity or beyond.
2915,2136,3,19,86,108,1.2314814814814814,0.046709818132625494,688,"The air quality today is not so good , I agree"
2293,2136,4,17,87,108,1.2314814814814814,0.0485270787963912,688,"168,364, please."
2523,2136,8,9,91,108,1.2314814814814814,0.0552010728394295,688,You want to go down?
1100,2136,1,23,84,108,1.2314814814814814,0.04284467968052193,688,I can only take so many small steps.
2011,2136,5,15,88,108,1.2314814814814814,0.0502786996951927,688,"Sir, I don't think we go up that high."
4790,2136,4,17,87,108,1.2314814814814814,0.0485270787963912,688,"Some welcome home, they broke into my locker and took my street clothes."
2339,2136,4,17,87,108,1.2314814814814814,0.0485270787963912,688,"Mr. Lucas's office is the third down on the left. If you find yourself in Sigourney Weaver's room, you've gone too far."
3134,2136,1,23,84,108,1.2314814814814814,0.04284467968052193,688,That's one too many steps for man
3322,2136,4,17,87,108,1.2314814814814814,0.0485270787963912,688,"Top floor. Lift off,  actually I meant off the lift."
3370,2136,5,15,88,108,1.2314814814814814,0.0502786996951927,688,This elevator only goes down.
3991,2136,4,17,87,108,1.2314814814814814,0.0485270787963912,688,You'll have to change at floor 52 for an elevator to Mars.
4015,2136,3,19,86,108,1.2314814814814814,0.046709818132625494,688,Do you ever regret moving into the stratosphere penthouse?
4207,2136,2,21,85,108,1.2314814814814814,0.04481893398391732,688,"I understand ma’am. Now that NASA has finally made a suit for you, you never want to take it off."
3073,2136,2,21,85,108,1.2314814814814814,0.04481893398391732,688,"Sorry, but we have a no alien policy in effect now."
931,2136,3,19,86,108,1.2314814814814814,0.046709818132625494,688,"I assure you, sir:  Saks has never had a gantry department"
1890,2136,5,15,88,108,1.2314814814814814,0.0502786996951927,688,Not necessary today. Mr. Jenks didn't have fiber last night.
801,2136,2,21,85,108,1.2314814814814814,0.04481893398391732,688,Platinum floor. I hope you enjoy your anti-gravity mattress
2843,2136,3,19,86,108,1.2314814814814814,0.046709818132625494,688,"Sorry, this elevator only goes as far as the penthouse"
134,2136,2,21,85,108,1.2314814814814814,0.04481893398391732,688,Blind date. Her friend said she loves men in uniform.
302,2136,4,17,87,108,1.2314814814814814,0.0485270787963912,688,"Seventh heaven, please, fantasy suite."
898,2136,5,15,88,108,1.2314814814814814,0.0502786996951927,688,"You're a little overdressed, we only go to the 10th floor."
447,2136,2,21,85,108,1.2314814814814814,0.04481893398391732,688,If this things stops at every floor I’m never gonna get there.
554,2136,2,21,85,108,1.2314814814814814,0.04481893398391732,688,I'd like some space please!
616,2136,3,19,86,108,1.2314814814814814,0.046709818132625494,688,Welcome home Sir.
419,2136,4,17,87,108,1.2314814814814814,0.0485270787963912,688,"264,000 please."
3678,2175,4,22,104,130,1.2307692307692308,0.04304795004868802,688,"Sir, we don't go up that far."
4487,2176,3,20,90,113,1.2300884955752212,0.04534049011486548,688,I get seasick if you go up to quickly.
2022,2176,3,20,90,113,1.2300884955752212,0.04534049011486548,688,Bad hair day?
598,2176,2,22,89,113,1.2300884955752212,0.043562968573791494,688,"I’m sorry sir, but we’re back on the ground floor.  I know you must be disappointed."
3142,2179,2,18,76,96,1.2291666666666667,0.047938114955607895,688,"UP, RETURNS, please"
3531,2180,3,21,94,118,1.228813559322034,0.044076988978739455,688,"You expect me to say ""Up"" don't you."
3195,2180,2,23,93,118,1.228813559322034,0.0424018443677596,688,"I'll notify facilities, the Tesla is on the roof."
1673,2182,5,14,86,105,1.2285714285714286,0.051099885767817904,688,"You want floors 10, 9, 8, 7, 6, 5, 4, 3, 2, AND 1?"
1265,2182,3,18,84,105,1.2285714285714286,0.047380354147934275,688,"One giant step for Casual Sportswear, Activewear, and Footwear"
2338,2182,2,20,83,105,1.2285714285714286,0.04540647284290523,688,No giant leap for mankind??
4411,2185,5,16,93,114,1.2280701754385965,0.04831437140849907,688,Your Uber Earth Rover is waiting.
1324,2185,4,18,92,114,1.2280701754385965,0.04668000738510451,688,Is this the launch pad you had in mind?
2676,2185,3,20,91,114,1.2280701754385965,0.04498630563125218,688,Have we landed?
2169,2188,2,21,87,110,1.2272727272727273,0.04409991481761522,688,"Dr. Bowman, they are sending you back to Earth, on the ground floor. HAL persuaded them."
4032,2188,2,21,87,110,1.2272727272727273,0.04409991481761522,688,So that MTV moonman  money got you a penthouse?
1242,2188,2,21,87,110,1.2272727272727273,0.04409991481761522,688,"Ground floor please, Tom"
2950,2191,4,16,86,106,1.2264150943396226,0.048855764148690535,688,Can you get me one of those flu suits?
2956,2191,4,16,86,106,1.2264150943396226,0.048855764148690535,688,"One small step to get past the gap, sir."""
5295,2191,6,12,88,106,1.2264150943396226,0.05240491130788026,688,"Up or down Sir? Blast Off Please!
I wanna land on tonight's full moon!
This is a lift! Not Lift Off!"
3043,2191,5,14,87,106,1.2264150943396226,0.05066142723877443,688,I don't think this elevator goes up that many floors !
4803,2191,4,16,86,106,1.2264150943396226,0.048855764148690535,688,T-minus 2...
3112,2191,4,16,86,106,1.2264150943396226,0.048855764148690535,688,Can you get me a Moon Pie while you’re out?”
3168,2191,4,16,86,106,1.2264150943396226,0.048855764148690535,688,Roof please
3233,2191,4,16,86,106,1.2264150943396226,0.048855764148690535,688,Casual dress day sir????
3349,2191,5,14,87,106,1.2264150943396226,0.05066142723877443,688,You'll want to take the express elevator.
3366,2191,5,14,87,106,1.2264150943396226,0.05066142723877443,688,"I am sorry sir, but your spaceship was towed away."
3097,2191,3,18,85,106,1.2264150943396226,0.046980753199957474,688,Up--how far?
2921,2191,2,20,84,106,1.2264150943396226,0.045027732031695245,688,Maybe you should use the express?
2767,2191,1,22,83,106,1.2264150943396226,0.042986069052670925,688,"Going way, way up?"
3376,2191,5,14,87,106,1.2264150943396226,0.05066142723877443,688,MTV missed you too.
2720,2191,2,20,84,106,1.2264150943396226,0.045027732031695245,688,I am told the sky top restaurant is out of this world.
2645,2191,5,14,87,106,1.2264150943396226,0.05066142723877443,688,Any higher than this and you'll need a rocket.
5343,2191,3,18,85,106,1.2264150943396226,0.046980753199957474,688,Watch your step for mankind.
2635,2191,3,18,85,106,1.2264150943396226,0.046980753199957474,688,"Ohhh, you mean HOW-ston Street."
2555,2191,2,20,84,106,1.2264150943396226,0.045027732031695245,688,"Back to the stratosphere, shall we?"
2544,2191,2,20,84,106,1.2264150943396226,0.045027732031695245,688,Your shuttle will be here in a jiffy sir.
2420,2191,3,18,85,106,1.2264150943396226,0.046980753199957474,688,"Oh yea, well your uniform is nothing to rave about."""
2409,2191,1,22,83,106,1.2264150943396226,0.042986069052670925,688,One small ride for man.
2389,2191,5,14,87,106,1.2264150943396226,0.05066142723877443,688,Missed the Shuttle Launch
2900,2191,4,16,86,106,1.2264150943396226,0.048855764148690535,688,"One small step for the ground floor, Mr. Armstrong..."
3469,2191,3,18,85,106,1.2264150943396226,0.046980753199957474,688,I think a tip would be another giant step...
3649,2191,5,14,87,106,1.2264150943396226,0.05066142723877443,688,"I apologize, but this is as high as we go."
3573,2191,4,16,86,106,1.2264150943396226,0.048855764148690535,688,"I know it’s only a small step Mr. Armstrong, but mankind only makes so many giant leaps."
4938,2191,5,14,87,106,1.2264150943396226,0.05066142723877443,688,"Since Rudolph died, I'm trying everything."
4947,2191,2,20,84,106,1.2264150943396226,0.045027732031695245,688,"No sir, it's not THAT tall......."
5045,2191,5,14,87,106,1.2264150943396226,0.05066142723877443,688,Mind the step
4721,2191,5,14,87,106,1.2264150943396226,0.05066142723877443,688,"You're lucky.  In my line of work, I have to hold it until my break."
4626,2191,3,18,85,106,1.2264150943396226,0.046980753199957474,688,Say hi to Sam at the elevator to the capsule.
4593,2191,2,20,84,106,1.2264150943396226,0.045027732031695245,688,They are waiting for you on the roof.
5213,2191,7,10,89,106,1.2264150943396226,0.05409222909535119,688,"Sorry sir, ‘Fly Me to the Moon’ is just a song."
4581,2191,5,14,87,106,1.2264150943396226,0.05066142723877443,688,"The 3.89 x 10 28 floor please, Walter. (28 in superscript but I couldn't get that to move to your template)"
4572,2191,3,18,85,106,1.2264150943396226,0.046980753199957474,688,"""I pressed Moon. I think you're letting me off early."""
4501,2191,3,18,85,106,1.2264150943396226,0.046980753199957474,688,"Up, Up, and Away?"
4400,2191,1,22,83,106,1.2264150943396226,0.042986069052670925,688,"105,116,000th please.""

Moon floor, going up"
3558,2191,3,18,85,106,1.2264150943396226,0.046980753199957474,688,This is the roof. Your spaceship awaits.
4376,2191,3,18,85,106,1.2264150943396226,0.046980753199957474,688,"Welcome to the""O"" Zone Mr.President"
2376,2191,1,22,83,106,1.2264150943396226,0.042986069052670925,688,"No, No, it's cable CARS that climb halfway to the STARS!"
4156,2191,3,18,85,106,1.2264150943396226,0.046980753199957474,688,"My wife said we needed some space because I took things too literally."""
3956,2191,5,14,87,106,1.2264150943396226,0.05066142723877443,688,Seems like the elevator's out of order--so the second floor is 45 steps for man...
3932,2191,1,22,83,106,1.2264150943396226,0.042986069052670925,688,"I'm sorry, I can only take you as high as the 68th floor."
3878,2191,2,20,84,106,1.2264150943396226,0.045027732031695245,688,"We don't have a floor for a ""galaxy far, far away""."
3824,2191,3,18,85,106,1.2264150943396226,0.046980753199957474,688,Do you mind if I press the button and step out?
3801,2191,3,18,85,106,1.2264150943396226,0.046980753199957474,688,Sorry bud Penthouse M doesn't stand for moon.
3792,2191,2,20,84,106,1.2264150943396226,0.045027732031695245,688,"I'm not sure that's what she meant by, ""I need more space."""
3698,2191,5,14,87,106,1.2264150943396226,0.05066142723877443,688,"I'm sorry sir, but I only go up to the tenth floor."
3691,2191,3,18,85,106,1.2264150943396226,0.046980753199957474,688,I can take you to the 15th floor and that's it.
4926,2191,3,18,85,106,1.2264150943396226,0.046980753199957474,688,This is  going to take a wile by your standards.
4290,2191,1,22,83,106,1.2264150943396226,0.042986069052670925,688,Congress cut NASA's budget and we have to economize.
4263,2191,3,18,85,106,1.2264150943396226,0.046980753199957474,688,Nobody at the escalator would say “ LIFT OFF’
2862,2191,5,14,87,106,1.2264150943396226,0.05066142723877443,688,I told Houston that we had a problem and this is the best that they could do.
2322,2191,3,18,85,106,1.2264150943396226,0.046980753199957474,688,"It looks like one small step, but it's really a giant leap."
750,2191,7,10,89,106,1.2264150943396226,0.05409222909535119,688,"Finally, some elevator music I like: 'Fly Me to the Moon' 
by Percy Faith

John Canning
Sea Cliff, NY"
720,2191,4,16,86,106,1.2264150943396226,0.048855764148690535,688,"Sir, it’s just a prostate exam..."
594,2191,2,20,84,106,1.2264150943396226,0.045027732031695245,688,"Don't forget to turn on the gravity, sir."
586,2191,4,16,86,106,1.2264150943396226,0.048855764148690535,688,Glad I'm not the only one with a sense of fashion.
585,2191,5,14,87,106,1.2264150943396226,0.05066142723877443,688,Last time I swear...I forgot to clean Major Tomcat’s litter this morning.
575,2191,6,12,88,106,1.2264150943396226,0.05240491130788026,688,I'm sorry sir but this elevator does not go to the moon.
566,2191,4,16,86,106,1.2264150943396226,0.048855764148690535,688,You might consider trying the escalator.
556,2191,5,14,87,106,1.2264150943396226,0.05066142723877443,688,Ground Floor ~ “Planet Earth
803,2191,3,18,85,106,1.2264150943396226,0.046980753199957474,688,Thank you for observing our new vaping policy.
503,2191,3,18,85,106,1.2264150943396226,0.046980753199957474,688,"Housewares, fine linens, moon departures, 10th floor!..."
430,2191,4,16,86,106,1.2264150943396226,0.048855764148690535,688,The lingerie Department please
374,2191,2,20,84,106,1.2264150943396226,0.045027732031695245,688,I can take you as far as the sixteenth floor.
366,2191,2,20,84,106,1.2264150943396226,0.045027732031695245,688,Wait … you said you landed WHERE on the building?
236,2191,3,18,85,106,1.2264150943396226,0.046980753199957474,688,All engines running. Lift. We have lift.
225,2191,5,14,87,106,1.2264150943396226,0.05066142723877443,688,"Going up?” “Yeah ,why"
37,2191,3,18,85,106,1.2264150943396226,0.046980753199957474,688,Does this elevator go any higher?
15,2191,2,20,84,106,1.2264150943396226,0.045027732031695245,688,"One small step for woman, one giant leap for humanity."
2329,2191,2,20,84,106,1.2264150943396226,0.045027732031695245,688,Space Cadet just touched down from the Red Planet.
495,2191,1,22,83,106,1.2264150943396226,0.042986069052670925,688,"Sorry sir, only one zero-g descent per day."
827,2191,3,18,85,106,1.2264150943396226,0.046980753199957474,688,Expecting rain sir?
383,2191,5,14,87,106,1.2264150943396226,0.05066142723877443,688,‘I envy your commute.’
944,2191,4,16,86,106,1.2264150943396226,0.048855764148690535,688,"Is this as high as it goes?"""
2025,2191,4,16,86,106,1.2264150943396226,0.048855764148690535,688,I hope this ride was not too fast for you.
1877,2191,3,18,85,106,1.2264150943396226,0.046980753199957474,688,"Sorry Sir, this is as high as it goes."
1846,2191,6,12,88,106,1.2264150943396226,0.05240491130788026,688,You're damn right I'm going up.
1781,2191,3,18,85,106,1.2264150943396226,0.046980753199957474,688,You ready? 5....4....3....2....
1693,2191,3,18,85,106,1.2264150943396226,0.046980753199957474,688,Lobby. Please watch your small step for mankind.
2265,2191,4,16,86,106,1.2264150943396226,0.048855764148690535,688,"5,647,394,647,346,473,946,754th floor please!"
1647,2191,4,16,86,106,1.2264150943396226,0.048855764148690535,688,I'm afraid we only blast off to the penthouse.
1531,2191,5,14,87,106,1.2264150943396226,0.05066142723877443,688,The roof is closed this time of year
2050,2191,3,18,85,106,1.2264150943396226,0.046980753199957474,688,"To the moon, Mrs. Cramden"""
1503,2191,4,16,86,106,1.2264150943396226,0.048855764148690535,688,"Sorry sir, Mr. Musk's crew has already left for the launch."
1436,2191,3,18,85,106,1.2264150943396226,0.046980753199957474,688,"Oh, Sorry, wrong floor."
1348,2191,5,14,87,106,1.2264150943396226,0.05066142723877443,688,"To the submarine, please"
1332,2191,1,22,83,106,1.2264150943396226,0.042986069052670925,688,"I’m sorry sir, this is as high as it goes."
1210,2191,3,18,85,106,1.2264150943396226,0.046980753199957474,688,"I presume you don’t require a cab this morning, Mr. Musk."
1208,2191,2,20,84,106,1.2264150943396226,0.045027732031695245,688,"How was your trip back from Earth, sir?
Year 2100"
1118,2191,4,16,86,106,1.2264150943396226,0.048855764148690535,688,"I’m afraid you’ll have to transfer on the 9,756th floor."
1049,2191,5,14,87,106,1.2264150943396226,0.05066142723877443,688,Sorry. This car is going down.
1483,2191,3,18,85,106,1.2264150943396226,0.046980753199957474,688,"I'm sorry, Mr. Musk. Floor ""M"" is the mezzanine, not Mars."
4707,2286,2,22,91,115,1.2260869565217392,0.042894633585358666,688,"And when you're ready to explore the night life here on Mars, lemme know."
2825,2287,2,17,74,93,1.2258064516129032,0.04865904566594242,688,"Did you forget your gloves, sir?"
3,2288,2,19,81,102,1.2254901960784315,0.04601550038301792,688,Gravity is losing its force
2998,2288,3,17,82,102,1.2254901960784315,0.04807872020202308,688,Prepare to be underwhelmed.
3776,2288,1,21,80,102,1.2254901960784315,0.043855321395865086,688,"Spatial Reality and Cultural Reentry is on your left, sir."
1212,2291,4,17,90,111,1.2252252252252251,0.04734504824060214,688,We don't go that high.
2464,2292,3,14,72,89,1.2247191011235956,0.0524010059162293,688,You might be slightly overdressed for the observation deck.
3146,2293,6,12,89,107,1.2242990654205608,0.05195594354493409,688,Your wife giving you space again?
5305,2293,2,20,85,107,1.2242990654205608,0.044655090377511794,688,"Sir, I don't think the elevator goes that high."
4684,2293,1,22,84,107,1.2242990654205608,0.042634978050523124,688,Obviously you are going up.
2290,2293,5,14,88,107,1.2242990654205608,0.05023031282392356,688,"Straight to the Moon, Alice?"
315,2293,2,20,85,107,1.2242990654205608,0.044655090377511794,688,Who farted?
3498,2298,4,18,94,116,1.2241379310344827,0.04595514222515574,688,"The Usual Test Spin, Tonight"
546,2299,2,26,106,134,1.2238805970149254,0.0391266328121487,688,"It's my first day on the job, just how tall is the building?"
2780,2300,4,15,84,103,1.2233009708737863,0.049616919769214105,688,"I'm sorry sir, it looks like they launched without you."
3561,2300,2,19,82,103,1.2233009708737863,0.045619117803674204,688,Shall I call you a Soyuz?
3510,2300,4,15,84,103,1.2233009708737863,0.049616919769214105,688,"Just so you know, I'm assuming ""the outermost reaches of human inquiry"" is floor twelve."
3288,2300,5,13,85,103,1.2233009708737863,0.051499574138862456,688,"Headed up to Capitol Hill again today, sir?"
3166,2300,3,17,83,103,1.2233009708737863,0.047659955080602695,688,"That's one small step for lobby, one giant leap for poolside"
3029,2300,4,15,84,103,1.2233009708737863,0.049616919769214105,688,"Mr. Clooney, it's been 6 years... We know what you did to save Sandra Bullock on Gravity... Maybe it's time to let go..."
3002,2300,2,19,82,103,1.2233009708737863,0.045619117803674204,688,"What floor is the ""moon landing"" audition on?"
2488,2300,3,17,83,103,1.2233009708737863,0.047659955080602695,688,Does he know that this lift won't take him to the place where he wants to go?
2912,2300,1,21,81,103,1.2233009708737863,0.043482599969251405,688,"Countdown to liftoff, please."
2673,2300,3,17,83,103,1.2233009708737863,0.047659955080602695,688,"The stars look very different today, Barry."
2866,2300,3,17,83,103,1.2233009708737863,0.047659955080602695,688,"10, 9, 8, 7, 6, 5, 4, 3, 2, or 1?"
2577,2300,2,19,82,103,1.2233009708737863,0.045619117803674204,688,Watch your one small step for man
2306,2300,2,19,82,103,1.2233009708737863,0.045619117803674204,688,One less step for mankind.
2861,2300,2,19,82,103,1.2233009708737863,0.045619117803674204,688,"Sorry, this building doesn't have a 26,400th floor."
5333,2300,2,19,82,103,1.2233009708737863,0.045619117803674204,688,Moon deck please.
3677,2300,4,15,84,103,1.2233009708737863,0.049616919769214105,688,Don't tell me you dropped your keys down there.
2609,2300,4,15,84,103,1.2233009708737863,0.049616919769214105,688,"26th Floor for Space Force General Interviews, please."
2642,2300,3,17,83,103,1.2233009708737863,0.047659955080602695,688,"How ""up"" do you need to be?"
2511,2300,4,15,84,103,1.2233009708737863,0.049616919769214105,688,"Which floor, sir? 10? 9? 8? 7..."
2260,2300,2,19,82,103,1.2233009708737863,0.045619117803674204,688,"Sub basement, I presume."
2514,2300,0,23,80,103,1.2233009708737863,0.04123553189891432,688,Good luck with humans.
5200,2300,4,15,84,103,1.2233009708737863,0.049616919769214105,688,I'm assuming the 400th floor?
3940,2300,4,15,84,103,1.2233009708737863,0.049616919769214105,688,Good morning. Going up?
4813,2300,4,15,84,103,1.2233009708737863,0.049616919769214105,688,"I hope your allergies clear up soon, sir.”"
4858,2300,2,19,82,103,1.2233009708737863,0.045619117803674204,688,Do you really have to count down every time?
4905,2300,4,15,84,103,1.2233009708737863,0.049616919769214105,688,"Sir, did you say you wanted to see outer space or the rental space?"
4910,2300,4,15,84,103,1.2233009708737863,0.049616919769214105,688,Ascent into orbit or reentry?
5319,2300,1,21,81,103,1.2233009708737863,0.043482599969251405,688,"Tell me, does living scent-free have it's moments?"
5275,2300,4,15,84,103,1.2233009708737863,0.049616919769214105,688,"Yes, alternate side parking is suspended today."
5268,2300,7,9,87,103,1.2233009708737863,0.0550721431822234,688,"That's one small step for man, one giant leap to my bed!"
5081,2300,4,15,84,103,1.2233009708737863,0.049616919769214105,688,Hosiery and handbags department—where no man has gone before.
4945,2300,0,23,80,103,1.2233009708737863,0.04123553189891432,688,I'm glad I chose a profession that isn't so easily automated.
4744,2300,6,11,86,103,1.2233009708737863,0.053315790771438,688,"But this is as high as it goes, sir."
3846,2300,3,17,83,103,1.2233009708737863,0.047659955080602695,688,"Sir, you of all people should know it's one small step."
2225,2300,3,17,83,103,1.2233009708737863,0.047659955080602695,688,The mens room? To the right and down the hall.
4623,2300,4,15,84,103,1.2233009708737863,0.049616919769214105,688,I’ll try my best.
4412,2300,4,15,84,103,1.2233009708737863,0.049616919769214105,688,"I don’t know, sir. I don’t think ’One small elevator for man’’ has the right ring to it."
4368,2300,2,19,82,103,1.2233009708737863,0.045619117803674204,688,"20,000 leagues please."
4137,2300,2,19,82,103,1.2233009708737863,0.045619117803674204,688,Take me to 1969 please
4132,2300,5,13,85,103,1.2233009708737863,0.051499574138862456,688,"After 30 years of pushing these buttons, I too am arm strong."
4096,2300,5,13,85,103,1.2233009708737863,0.051499574138862456,688,"Bud, it’s nice to dream but this is way above my pay grade."
4091,2300,1,21,81,103,1.2233009708737863,0.043482599969251405,688,We just did the floors. A giant leap would probably be a bad idea. Just stick to small steps.
4077,2300,1,21,81,103,1.2233009708737863,0.043482599969251405,688,"What space: office, loft, or outer?"
4006,2300,2,19,82,103,1.2233009708737863,0.045619117803674204,688,We've talked about this before.  I cannot simulate G-forces.
3983,2300,4,15,84,103,1.2233009708737863,0.049616919769214105,688,So you say you’re on your way to a designation wedding?
4630,2300,6,11,86,103,1.2233009708737863,0.053315790771438,688,"I'm sorry, sir, this elevator doesn't stop at Neptune."
2051,2300,4,15,84,103,1.2233009708737863,0.049616919769214105,688,"Yeah, Bolivia was great!"
1650,2300,3,17,83,103,1.2233009708737863,0.047659955080602695,688,Really? They told us the asbestos was nothing to worry about.
591,2300,2,19,82,103,1.2233009708737863,0.045619117803674204,688,"I'm sorry,you want me to countdown?"
783,2300,4,15,84,103,1.2233009708737863,0.049616919769214105,688,Rainbow Room;  final frontier.
776,2300,3,17,83,103,1.2233009708737863,0.047659955080602695,688,You're on your own after the rooftop.
746,2300,4,15,84,103,1.2233009708737863,0.049616919769214105,688,This suit is basically useless on earth.
650,2300,2,19,82,103,1.2233009708737863,0.045619117803674204,688,This is the lounge floor. I’m sorry there isn’t more atmosphere.
638,2300,4,15,84,103,1.2233009708737863,0.049616919769214105,688,"Hey Buddy, rumor has it Ivanka likes Cosmonauts better."
619,2300,3,17,83,103,1.2233009708737863,0.047659955080602695,688,I hope you enjoyed your stay on Earth.
512,2300,3,17,83,103,1.2233009708737863,0.047659955080602695,688,"Ah, today is your NASA interview. Good
luck!"
387,2300,3,17,83,103,1.2233009708737863,0.047659955080602695,688,Are you sure you want to go out there?
354,2300,3,17,83,103,1.2233009708737863,0.047659955080602695,688,"Sorry, sir, this the local--the elevator to the ionosphere is across the hall."
288,2300,3,17,83,103,1.2233009708737863,0.047659955080602695,688,Will it be a step or a leap?
271,2300,6,11,86,103,1.2233009708737863,0.053315790771438,688,‘Well you don’t SOUND sure you didn’t leave the oven on’
186,2300,3,17,83,103,1.2233009708737863,0.047659955080602695,688,Which floor is the moon?
35,2300,2,19,82,103,1.2233009708737863,0.045619117803674204,688,"Just promise me, don’t take me to the stars”"
9,2300,3,17,83,103,1.2233009708737863,0.047659955080602695,688,"I can get you to the 20th,but for anything above that I should  really speak to my manager..."
2006,2300,3,17,83,103,1.2233009708737863,0.047659955080602695,688,You've got about 60'000 floors to go
868,2300,2,19,82,103,1.2233009708737863,0.045619117803674204,688,Welcome to the International Space Station 2050
872,2300,4,15,84,103,1.2233009708737863,0.049616919769214105,688,They said they're changing the Muzak tunes on Monday.
775,2300,3,17,83,103,1.2233009708737863,0.047659955080602695,688,Fifth floor...moon landing conspiracies to your left.
1028,2300,3,17,83,103,1.2233009708737863,0.047659955080602695,688,"Do you really want floors 10, 9, 8, 7, 6, 5, 4, 3, 2, 1?"
1916,2300,3,17,83,103,1.2233009708737863,0.047659955080602695,688,No. I can' t go horizontally.
1838,2300,3,17,83,103,1.2233009708737863,0.047659955080602695,688,10?  9?  8? ...
1836,2300,4,15,84,103,1.2233009708737863,0.049616919769214105,688,You'll appreciate our chef's dark matter special.
1810,2300,3,17,83,103,1.2233009708737863,0.047659955080602695,688,Up please waaaaay up!
989,2300,4,15,84,103,1.2233009708737863,0.049616919769214105,688,You have to walk across to the express elevator.
1738,2300,1,21,81,103,1.2233009708737863,0.043482599969251405,688,Our best restaurant - it's out of this world!
1724,2300,2,19,82,103,1.2233009708737863,0.045619117803674204,688,"It's the highest we go, sir. The costume party's on ten."
1627,2300,4,15,84,103,1.2233009708737863,0.049616919769214105,688,"Sorry, I’ll take the stairs—I’m claustrophobic."
1751,2300,1,21,81,103,1.2233009708737863,0.043482599969251405,688,"Sorry, sir, but you’re going to be disappointed."
1599,2300,3,17,83,103,1.2233009708737863,0.047659955080602695,688,The bus to the space launch left hours ago.
1538,2300,3,17,83,103,1.2233009708737863,0.047659955080602695,688,"Who are you calling ""Alice?"""
1467,2300,3,17,83,103,1.2233009708737863,0.047659955080602695,688,"Good luck on your first day at Space Force, sir."
1307,2300,3,17,83,103,1.2233009708737863,0.047659955080602695,688,"Mars Bar, Sir?"
1179,2300,3,17,83,103,1.2233009708737863,0.047659955080602695,688,"I hope you like,  All I Want for Christmas is You"
1206,2300,3,17,83,103,1.2233009708737863,0.047659955080602695,688,Upper penthouse sir?
1211,2300,3,17,83,103,1.2233009708737863,0.047659955080602695,688,"I know you need the practice, but I can’t get to the top floor any faster."
4825,2384,4,14,81,99,1.2222222222222223,0.050874754873893785,688,I don't know if the elevator goes to that floor.
2659,2385,1,21,82,104,1.2211538461538463,0.043115963718089116,688,". . . eight, seven, six, five, four . . ."
1956,2386,4,16,89,109,1.2201834862385321,0.047638415680113844,688,Just drive!
653,2387,3,16,81,100,1.22,0.048367281703584904,688,"Good afternoon sir, how's all looking?"
211,2387,4,14,82,100,1.22,0.05041244034376972,688,Thats not what she meant by ‘other side of  the moon Sir
289,2389,3,19,92,114,1.219298245614035,0.044506945270085925,688,"It's one small step for man, one giant leap for ladies undergarments"
1342,2390,4,15,86,105,1.2190476190476192,0.04875924328817289,688,I'll tell you when to stop.
1988,2391,2,15,70,87,1.2183908045977012,0.05019418948109651,688,"your golf club, Sir?"
3198,2392,2,18,81,101,1.2178217821782178,0.04582351075408372,688,"""Get out of the way.  I need some space."""
3229,2392,3,16,82,101,1.2178217821782178,0.04793551856202062,688,Bad air quality forecast today?
3239,2392,3,16,82,101,1.2178217821782178,0.04793551856202062,688,I think I'm a couple floors up.
3755,2392,3,16,82,101,1.2178217821782178,0.04793551856202062,688,"I know climate change is scary, Sir, but don’t you think this is a bit of an overreaction?"
3378,2392,4,14,83,101,1.2178217821782178,0.04995832004571433,688,Watch the small step for man sir!
3400,2392,4,14,83,101,1.2178217821782178,0.04995832004571433,688,I don't blame you Fred.  I would join you if I had the gear.
3419,2392,4,14,83,101,1.2178217821782178,0.04995832004571433,688,"Have you always been an introvert, Mr. Reynolds?"
3428,2392,5,12,84,101,1.2178217821782178,0.051902346226063996,688,To the moon Alice..to the moon
3447,2392,4,14,83,101,1.2178217821782178,0.04995832004571433,688,Christmas with the kids?
3501,2392,4,14,83,101,1.2178217821782178,0.04995832004571433,688,"One small lift for man, one giant elevator for mankind."
3570,2392,4,14,83,101,1.2178217821782178,0.04995832004571433,688,Floor 42. This is how high it goes...
3179,2392,4,14,83,101,1.2178217821782178,0.04995832004571433,688,"Look, the invite said 'Suit & Tie' and I'm wearing a suit. Ties are for ground-people."
3331,2392,3,16,82,101,1.2178217821782178,0.04793551856202062,688,Let’s start out with the third floor and take it from there.
3158,2392,2,18,81,101,1.2178217821782178,0.04582351075408372,688,"Street level, please."
2531,2392,3,16,82,101,1.2178217821782178,0.04793551856202062,688,"To the 1,234,034,356,232,525,235,565,565,562,230,000,000,000,000,000,000th floor please"""
3119,2392,3,16,82,101,1.2178217821782178,0.04793551856202062,688,"We have a race to win. The moon, please."
2428,2392,3,16,82,101,1.2178217821782178,0.04793551856202062,688,How's No Nut November going?
3685,2392,2,18,81,101,1.2178217821782178,0.04582351075408372,688,The rest of your party is already in space.
2545,2392,3,16,82,101,1.2178217821782178,0.04793551856202062,688,"When you said you wanted to attend an AA meeting, I assumed you meant Astronaut Apparel."
2566,2392,5,12,84,101,1.2178217821782178,0.051902346226063996,688,Welcome to The Trump Mars hotel
2595,2392,3,16,82,101,1.2178217821782178,0.04793551856202062,688,"1st floor- housewares, lingerie, and final frontier"
2622,2392,8,6,87,101,1.2178217821782178,0.057340325685426775,688,I dont know why it always lands on the roof of the Ritz Carlton
2646,2392,2,18,81,101,1.2178217821782178,0.04582351075408372,688,Are you going up to outer space?
2654,2392,3,16,82,101,1.2178217821782178,0.04793551856202062,688,Could you hail me a comet?
2682,2392,1,20,80,101,1.2178217821782178,0.04360933771395099,688,To the moon? How about gossamer wings on Floor Three?
2811,2392,4,14,83,101,1.2178217821782178,0.04995832004571433,688,"Mars? 6th floor, 'candy'."
2836,2392,3,16,82,101,1.2178217821782178,0.04793551856202062,688,SpaceX  1.2*10e9 suite?
2852,2392,2,18,81,101,1.2178217821782178,0.04582351075408372,688,It will be much easier than talking to my mother
2914,2392,3,16,82,101,1.2178217821782178,0.04793551856202062,688,"Yes, it IS the express elevator. Yes, I'm sure I don't need one."
2932,2392,2,18,81,101,1.2178217821782178,0.04582351075408372,688,"6th Floor - moon rocks, oxygen kits, and now plumbing supplies"
3024,2392,3,16,82,101,1.2178217821782178,0.04793551856202062,688,Floor 10...9...8...7...?
3145,2392,1,20,80,101,1.2178217821782178,0.04360933771395099,688,What floor? No pressure.
3914,2392,4,14,83,101,1.2178217821782178,0.04995832004571433,688,"On the top floor, no one can hear you snore."
4750,2392,6,10,85,101,1.2178217821782178,0.053776141045545636,688,It is indeed a small step for a man.
3951,2392,5,12,84,101,1.2178217821782178,0.051902346226063996,688,Floor eighteen thousand eight hundred and fifty seven please
5290,2392,1,20,80,101,1.2178217821782178,0.04360933771395099,688,"Launchpad Bar, please."
5255,2392,5,12,84,101,1.2178217821782178,0.051902346226063996,688,Mr. Trump dislikes the word “toxic.”
5237,2392,5,12,84,101,1.2178217821782178,0.051902346226063996,688,"I'm sorry, but this IS the highest floor."
5212,2392,5,12,84,101,1.2178217821782178,0.051902346226063996,688,It's straight ahead for the infinity pool
5185,2392,3,16,82,101,1.2178217821782178,0.04793551856202062,688,Fine. But you'll need to do your own playing among the stars.
5179,2392,4,14,83,101,1.2178217821782178,0.04995832004571433,688,Have you ever seen the movie Trading Places?
5169,2392,4,14,83,101,1.2178217821782178,0.04995832004571433,688,What floor is the audition for the Space Force
5127,2392,3,16,82,101,1.2178217821782178,0.04793551856202062,688,I must be high.
5068,2392,2,18,81,101,1.2178217821782178,0.04582351075408372,688,Wait...WHAT floor?
4930,2392,3,16,82,101,1.2178217821782178,0.04793551856202062,688,"Scotty, I really do hope that someday you can just, “beam me up”."
4928,2392,4,14,83,101,1.2178217821782178,0.04995832004571433,688,"I’m sorry, but the Penthouse will be our last stop."
4899,2392,2,18,81,101,1.2178217821782178,0.04582351075408372,688,"Up to to the moon, Sir?"
4833,2392,5,12,84,101,1.2178217821782178,0.051902346226063996,688,"What floor sir?""
""Infinity and beyond, please.""
"" what?"
2416,2392,5,12,84,101,1.2178217821782178,0.051902346226063996,688,"10th floor: hardware, appliances, extra-vehicular activities."
4733,2392,2,18,81,101,1.2178217821782178,0.04582351075408372,688,"Lift-off floor as usual, Mr. Aldrin?"
4584,2392,4,14,83,101,1.2178217821782178,0.04995832004571433,688,"Are you going up or down, Sir?"
4430,2392,4,14,83,101,1.2178217821782178,0.04995832004571433,688,"Remember, none of that One Small Step crap. MAKE AN ENTRANCE!"
3984,2392,3,16,82,101,1.2178217821782178,0.04793551856202062,688,"Dress for the job you want, not the job you have"", they said. 
Well here I am. Are you happy now, Bob"
4007,2392,2,18,81,101,1.2178217821782178,0.04582351075408372,688,So they put you on the smoking floor.
4022,2392,2,18,81,101,1.2178217821782178,0.04582351075408372,688,Now that I turned 18-yrs could you please call me “bubble man?
4100,2392,5,12,84,101,1.2178217821782178,0.051902346226063996,688,Clarke Bar?
4103,2392,3,16,82,101,1.2178217821782178,0.04793551856202062,688,"Don't worry, I'm a professional."
4146,2392,2,18,81,101,1.2178217821782178,0.04582351075408372,688,"This is a skyscraper, not a skypenetrator.... Sir."
3927,2392,4,14,83,101,1.2178217821782178,0.04995832004571433,688,"Where no man has gone before, please."
4161,2392,3,16,82,101,1.2178217821782178,0.04793551856202062,688,"I can only take you to the penthouse level, buddy."
4212,2392,4,14,83,101,1.2178217821782178,0.04995832004571433,688,I'll walk Tiny.  Don't even worry about it.
4304,2392,2,18,81,101,1.2178217821782178,0.04582351075408372,688,"Lobby level, we've landed. Please watch your 
one small step for man."""
4366,2392,3,16,82,101,1.2178217821782178,0.04793551856202062,688,My penthouse has a lot of space.
4377,2392,4,14,83,101,1.2178217821782178,0.04995832004571433,688,We’re called The Stratosphere Hotel but a spacesuit is not required!
4403,2392,2,18,81,101,1.2178217821782178,0.04582351075408372,688,You can't be too careful out there.  None of the antibiotics work well any more.
4417,2392,3,16,82,101,1.2178217821782178,0.04793551856202062,688,The 2001 floor please
4183,2392,1,20,80,101,1.2178217821782178,0.04360933771395099,688,There’s one small step.
2402,2392,2,18,81,101,1.2178217821782178,0.04582351075408372,688,All the right stuff on your shopping list?
1614,2392,3,16,82,101,1.2178217821782178,0.04793551856202062,688,"But sir, in the air, there’s a feeling of Christmas."
752,2392,4,14,83,101,1.2178217821782178,0.04995832004571433,688,"Sorry to bring you back to earth, but the Stratosphere is closed for repairs."
818,2392,4,14,83,101,1.2178217821782178,0.04995832004571433,688,"Please sit down, sir. We are about ready to blast off."
788,2392,5,12,84,101,1.2178217821782178,0.051902346226063996,688,Penthouse not all it’s cracked up to be?
782,2392,4,14,83,101,1.2178217821782178,0.04995832004571433,688,"Oh, I thought you said you wanted to ""get off the lift."""
766,2392,1,20,80,101,1.2178217821782178,0.04360933771395099,688,You may want to hold your breath when the doors open to let me off.
764,2392,5,12,84,101,1.2178217821782178,0.051902346226063996,688,This car doesn't go all the way up to the launch pad.
2278,2392,3,16,82,101,1.2178217821782178,0.04793551856202062,688,So this is mars?
742,2392,3,16,82,101,1.2178217821782178,0.04793551856202062,688,"Sir, this is the tallest building in the world, but it's not THAT tall.."
631,2392,3,16,82,101,1.2178217821782178,0.04793551856202062,688,After this elevator broke down last week I'm not taking any chances.
529,2392,2,18,81,101,1.2178217821782178,0.04582351075408372,688,"What atmosphere, sir?"
443,2392,3,16,82,101,1.2178217821782178,0.04793551856202062,688,"Turn left for the pet fish department, sir."
423,2392,5,12,84,101,1.2178217821782178,0.051902346226063996,688,Anywhere but here
395,2392,2,18,81,101,1.2178217821782178,0.04582351075408372,688,Don't worry - it's a small step for mankind.
1001,2392,3,16,82,101,1.2178217821782178,0.04793551856202062,688,"Sky Lounge, please."
273,2392,2,18,81,101,1.2178217821782178,0.04582351075408372,688,Thats the wrong pianet...take me to planet 9!
252,2392,5,12,84,101,1.2178217821782178,0.051902346226063996,688,Going down.
230,2392,4,14,83,101,1.2178217821782178,0.04995832004571433,688,My wife has just left me because I said I needed  space.
207,2392,4,14,83,101,1.2178217821782178,0.04995832004571433,688,Your plan to reach the moon in  an elevator is wrong on so many levels.
103,2392,4,14,83,101,1.2178217821782178,0.04995832004571433,688,Take me to your C-level | execs
89,2392,4,14,83,101,1.2178217821782178,0.04995832004571433,688,Wrong floor. This is not the Mars landing studio.’
62,2392,4,14,83,101,1.2178217821782178,0.04995832004571433,688,I will vote for your President!
53,2392,3,16,82,101,1.2178217821782178,0.04793551856202062,688,"Apologies sir, but the elevator doesnt go any higher."
42,2392,3,16,82,101,1.2178217821782178,0.04793551856202062,688,THE FORECAST IN FLORIDA...
40,2392,5,12,84,101,1.2178217821782178,0.051902346226063996,688,We choose to go to the sixth floor!
30,2392,2,18,81,101,1.2178217821782178,0.04582351075408372,688,spaced out
13,2392,2,18,81,101,1.2178217821782178,0.04582351075408372,688,Travel pillows are on the third floor.
10,2392,4,14,83,101,1.2178217821782178,0.04995832004571433,688,"Sorry, no hidden figures.”"
260,2392,5,12,84,101,1.2178217821782178,0.051902346226063996,688,"Here we are, sir, Mars... or floor 7"
1013,2392,3,16,82,101,1.2178217821782178,0.04793551856202062,688,"It's fast for a prewar, but no one's ever asked about the G-forces."
906,2392,3,16,82,101,1.2178217821782178,0.04793551856202062,688,"One small step, sir."
1058,2392,3,16,82,101,1.2178217821782178,0.04793551856202062,688,I forgot my briefs.
2230,2392,3,16,82,101,1.2178217821782178,0.04793551856202062,688,Ten Nine Eight Seven Six ......
2211,2392,3,16,82,101,1.2178217821782178,0.04793551856202062,688,"I can't tell by the look of you, are you coming or going?"
2173,2392,1,20,80,101,1.2178217821782178,0.04360933771395099,688,"I'm sorry sir, we only go to tenth floor."
2134,2392,4,14,83,101,1.2178217821782178,0.04995832004571433,688,This is one very small step.....
2130,2392,2,18,81,101,1.2178217821782178,0.04582351075408372,688,Are you with new Space Force?
2062,2392,4,14,83,101,1.2178217821782178,0.04995832004571433,688,I'm late for my porn shoot
2060,2392,3,16,82,101,1.2178217821782178,0.04793551856202062,688,I’m looking for HAL
2007,2392,4,14,83,101,1.2178217821782178,0.04995832004571433,688,Send me to the top of the Stratosphere please. I'm going to ride the roller coaster.
1945,2392,2,18,81,101,1.2178217821782178,0.04582351075408372,688,You look well Mister Trump.
1879,2392,4,14,83,101,1.2178217821782178,0.04995832004571433,688,So the suit really is just for vapeing?
1798,2392,6,10,85,101,1.2178217821782178,0.053776141045545636,688,How are you enjoying the penthouse?
1043,2392,0,22,79,101,1.2178217821782178,0.04127656155579374,688,You’re on your own now.
1669,2392,3,16,82,101,1.2178217821782178,0.04793551856202062,688,Pluto was an inside job.
1675,2392,3,16,82,101,1.2178217821782178,0.04793551856202062,688,How many floors do you think this building has?
1220,2392,3,16,82,101,1.2178217821782178,0.04793551856202062,688,You could say that convincing a co-op board is the final frontier.
1499,2392,4,14,83,101,1.2178217821782178,0.04995832004571433,688,I think you want the lunar service elevator.
1470,2392,4,14,83,101,1.2178217821782178,0.04995832004571433,688,I'm a staunch anti-vaccer and all the predictions say that it's going to be a severe flu season.
1455,2392,5,12,84,101,1.2178217821782178,0.051902346226063996,688,Fourth Four Space Apparel
1380,2392,4,14,83,101,1.2178217821782178,0.04995832004571433,688,"3, 2,1, Off lift."
1351,2392,3,16,82,101,1.2178217821782178,0.04793551856202062,688,"Sorry, sir, but one G is the lowest I can go"
1340,2392,4,14,83,101,1.2178217821782178,0.04995832004571433,688,"One small step for a man,a giant leap for Otis!"
1527,2392,1,20,80,101,1.2178217821782178,0.04360933771395099,688,This one only goes as far as the troposphere.
1113,2392,1,20,80,101,1.2178217821782178,0.04360933771395099,688,"I'm sorry, *which* floor??"
1199,2392,4,14,83,101,1.2178217821782178,0.04995832004571433,688,She said dress for the Bahamas.
1163,2392,1,20,80,101,1.2178217821782178,0.04360933771395099,688,"Sorry.  I tried, but we never really achieved escape velocity."
3725,2517,4,19,101,124,1.217741935483871,0.043695780716468284,688,I think you are looking for the second elevator bank
4549,2518,2,21,92,115,1.2173913043478262,0.04239692700687835,688,"Alice, we no longer go to the moon."
465,2519,4,15,87,106,1.2169811320754718,0.04834124912308584,688,"Oh, I thought this was going up"
3310,2520,4,16,91,111,1.2162162162162162,0.04685944516544137,688,The soundstage is to your right Mr. Armstrong.
1671,2520,2,20,89,111,1.2162162162162162,0.04322276337316575,688,"You know, Walter. Sometimes I feel like the East Side is another planet."
1017,2522,3,13,72,88,1.2159090909090908,0.05224546106377937,688,"I'm afraid the top floor is out of service, sir."
276,2522,3,13,72,88,1.2159090909090908,0.05224546106377937,688,"Welcome to the Apollo 11, sir. A bit overdressed for the party if I may say so"
2540,2522,1,17,70,88,1.2159090909090908,0.04698001875328986,688,"The air is so bad outside, I’m moving to the moon."
4236,2522,1,17,70,88,1.2159090909090908,0.04698001875328986,688,Do you really think you need an elevator ?
1800,2522,2,15,71,88,1.2159090909090908,0.04968254403624251,688,Projected landing on the surface of the fourth floor in T-minus fifteen seconds.
4732,2522,2,15,71,88,1.2159090909090908,0.04968254403624251,688,It's a start
4741,2522,2,15,71,88,1.2159090909090908,0.04968254403624251,688,"I am sorry sir, there is no 90 thousandth floor."
4291,2522,1,17,70,88,1.2159090909090908,0.04698001875328986,688,Enjoy your day sir.
2240,2530,7,8,87,102,1.2156862745098038,0.05508055374250415,688,"With two other billionaires with space programs, wouldn't your money be better spent by not working your workers to death?"
4392,2530,2,18,82,102,1.2156862745098038,0.04542226432881113,688,"Ladies Lingerie, where no man has gone before..."
4773,2530,3,16,83,102,1.2156862745098038,0.04751125295676055,688,Stop staring - this is my 1st day on your planet.
4969,2530,1,20,81,102,1.2156862745098038,0.043232453504184656,688,Astro.  Not!
63,2530,2,18,82,102,1.2156862745098038,0.04542226432881113,688,"Sorry, 13 just sends us up and back down."
765,2530,6,10,86,102,1.2156862745098038,0.0532891202762439,688,"Yes, I'm absolutely sure.  This is the Mars room."
1878,2530,3,16,83,102,1.2156862745098038,0.04751125295676055,688,Here for Elevator Operator-Con?
1595,2530,2,18,82,102,1.2156862745098038,0.04542226432881113,688,"Sorry sir, this car only goes to 28"
3948,2530,3,16,83,102,1.2156862745098038,0.04751125295676055,688,"No sir, in fact, my mother is not an astronaut."
1855,2530,6,10,86,102,1.2156862745098038,0.0532891202762439,688,"Sir, this is the Empire State Building--the top floor is only 1250 feet up!"
3632,2540,0,23,84,107,1.2149532710280373,0.03989944463395409,688,"Sorry, the 2,771st floor isn’t in service."
558,2541,3,15,80,98,1.2142857142857142,0.04865106526998212,688,"And a very happy holidays to you, too, Mr. Musk."
4046,2541,2,17,79,98,1.2142857142857142,0.04643848313822551,688,"Any bags, sir?"
1922,2543,3,16,84,103,1.2135922330097086,0.0470942961235598,688,We practice in a safe space.
2310,2543,3,16,84,103,1.2135922330097086,0.0470942961235598,688,"Another bad hair day, huh"
4163,2545,2,15,72,89,1.2134831460674158,0.04918100989726316,688,"Sorry sir, but we discontinued carrying moon rocks last year."
3973,2545,4,11,74,89,1.2134831460674158,0.054124827614885296,688,The express elevator is across the hall.
3129,2545,4,11,74,89,1.2134831460674158,0.054124827614885296,688,"'Please, not too fast'"
3072,2545,3,13,73,89,1.2134831460674158,0.05171203292685246,688,"I see you bought your ticket for SpaceX's starship, sir"
2851,2545,4,11,74,89,1.2134831460674158,0.054124827614885296,688,"Wow, this must be a tall building!"
2012,2545,3,13,73,89,1.2134831460674158,0.05171203292685246,688,Forgot your toenail clipper? Again?
1700,2545,1,17,71,89,1.2134831460674158,0.04651246198172614,688,"Sorry, this is not the floor for NASA."
693,2545,2,15,72,89,1.2134831460674158,0.04918100989726316,688,"- Bit overdressed,aren't we?
- You are, indeed."
240,2545,1,17,71,89,1.2134831460674158,0.04651246198172614,688,Going all the way up?”
3226,2554,2,16,76,94,1.2127659574468086,0.04752472998434697,688,"No, Ma'am, the costume party is on seven."
3427,2555,4,13,82,99,1.2121212121212122,0.050298485015680724,688,I found you through Orbitz.
3363,2555,2,17,80,99,1.2121212121212122,0.046017947241275524,688,You've got some shmutz on the side of  your mouth there
3313,2555,0,21,78,99,1.2121212121212122,0.041296069325408885,688,The Met Gala was truly out of this world this year.
4265,2555,4,13,82,99,1.2121212121212122,0.050298485015680724,688,"Looking good Mr. Smith, but Halloween is still 10 months away.
John Kavanagh
Bellaire, MI"
4370,2555,4,13,82,99,1.2121212121212122,0.050298485015680724,688,You must live in the pent house apartment.
3222,2555,4,13,82,99,1.2121212121212122,0.050298485015680724,688,"I don't care what Houston says, we don't have a floor 239,875"
3201,2555,4,13,82,99,1.2121212121212122,0.050298485015680724,688,"Sorry, this the Moon elevator, Mars' is on the other side of the building."
4374,2555,3,15,81,99,1.2121212121212122,0.048205752059134375,688,Can’t do it Govn’r; take her any higher I could lose me job.
2997,2555,1,19,79,99,1.2121212121212122,0.04372080059897002,688,"I'm sorry, sir. The penthouse IS the last stop."
2993,2555,2,17,80,99,1.2121212121212122,0.046017947241275524,688,I take it ma'am would like a courtesy countdown.
2979,2555,3,15,81,99,1.2121212121212122,0.048205752059134375,688,"Sir, this elevator doesn’t go all the way to the top."
3458,2555,3,15,81,99,1.2121212121212122,0.048205752059134375,688,One small step.
3463,2555,4,13,82,99,1.2121212121212122,0.050298485015680724,688,Watch that first step for mankind
3251,2555,4,13,82,99,1.2121212121212122,0.050298485015680724,688,Checking out early. Would've liked a room with more space.
3583,2555,1,19,79,99,1.2121212121212122,0.04372080059897002,688,You did say you wanted to go up sir?
3625,2555,3,15,81,99,1.2121212121212122,0.048205752059134375,688,Thanks for the reentry.
3642,2555,3,15,81,99,1.2121212121212122,0.048205752059134375,688,"Are you sure going in black face is a good idea, Sir?"
2772,2555,3,15,81,99,1.2121212121212122,0.048205752059134375,688,"Yes Sir, this is the Stratosphere Hotel but I can't take you to that stratosphere."
3732,2555,1,19,79,99,1.2121212121212122,0.04372080059897002,688,"I'm sorry, sir. We don't go that high."
3821,2555,2,17,80,99,1.2121212121212122,0.046017947241275524,688,Heading up?
3966,2555,4,13,82,99,1.2121212121212122,0.050298485015680724,688,I'm taking a walk on the wild side.
4034,2555,0,21,78,99,1.2121212121212122,0.041296069325408885,688,"Floor five, four, three, two, one?"
4041,2555,4,13,82,99,1.2121212121212122,0.050298485015680724,688,Mr. Pence’s suite is the fourth door on the right.
4051,2555,0,21,78,99,1.2121212121212122,0.041296069325408885,688,"An excellent choice sir, the CO2 level is a little elevated"
4056,2555,4,13,82,99,1.2121212121212122,0.050298485015680724,688,Mission control says this is the last liftoff to Alpha Centauri this evening
4110,2555,3,15,81,99,1.2121212121212122,0.048205752059134375,688,I’m taking the long way up.
4112,2555,2,17,80,99,1.2121212121212122,0.046017947241275524,688,When I overheard someone saying the new guy was a real 'space cadet' I didn't think they were being literal.
4178,2555,4,13,82,99,1.2121212121212122,0.050298485015680724,688,The moon landing studio is this way. Have a nice shoot!
3534,2555,4,13,82,99,1.2121212121212122,0.050298485015680724,688,"Turn left, walk two blocks, spacecraft will be hovering on your right."
2517,2555,3,15,81,99,1.2121212121212122,0.048205752059134375,688,Mr. Musk believes it will work.
1844,2555,2,17,80,99,1.2121212121212122,0.046017947241275524,688,"It's a small step, but please use caution."
4388,2555,2,17,80,99,1.2121212121212122,0.046017947241275524,688,I’m sorry but this only goes to the penthouse.
5277,2555,1,19,79,99,1.2121212121212122,0.04372080059897002,688,"I'm sorry, sir, but condo rules prohibit breaking the law of gravity."
5215,2555,3,15,81,99,1.2121212121212122,0.048205752059134375,688,I stay in this hotel every year for the Bed Bugs Without Borders annual meeting.
5172,2555,2,17,80,99,1.2121212121212122,0.046017947241275524,688,"Yes sir, this rooftop dining experience was described as ""out of this world"" but..."
5123,2555,3,15,81,99,1.2121212121212122,0.048205752059134375,688,Do you have permission to be on the roof?
4920,2555,3,15,81,99,1.2121212121212122,0.048205752059134375,688,"Going Up, Please!"
4903,2555,1,19,79,99,1.2121212121212122,0.04372080059897002,688,"I'm sorry, Sir, you'll find that the Halloween party was on a different floor in a different month."
12,2555,3,15,81,99,1.2121212121212122,0.048205752059134375,688,"Since Wonka’s Factory, Charlie had been playing it safe"
17,2555,1,19,79,99,1.2121212121212122,0.04372080059897002,688,Oops. Forgot my wallet.
57,2555,0,21,78,99,1.2121212121212122,0.041296069325408885,688,"‘Lobby or Houston, Sir?"
2475,2555,4,13,82,99,1.2121212121212122,0.050298485015680724,688,I'm the captain on this ship!
4843,2555,3,15,81,99,1.2121212121212122,0.048205752059134375,688,Don't space out on me
353,2555,4,13,82,99,1.2121212121212122,0.050298485015680724,688,T minus 30 seconds to mezzanine launch.
114,2555,2,17,80,99,1.2121212121212122,0.046017947241275524,688,How far do you go up?
4702,2555,5,11,83,99,1.2121212121212122,0.05230755832724922,688,Huston... We have a problem.. there is a man here and he is pushing all The wrong buttons!
2204,2555,3,15,81,99,1.2121212121212122,0.048205752059134375,688,"One small step for man, one giant step for conquering agoraphobia"
2045,2555,2,17,80,99,1.2121212121212122,0.046017947241275524,688,"Don’t worry , word is that Mr. Johnson is not having lentil soup  for lunch again today"
1889,2555,1,19,79,99,1.2121212121212122,0.04372080059897002,688,Top floor.  This lift doesn't go to the moon.
4184,2555,2,17,80,99,1.2121212121212122,0.046017947241275524,688,What planet are you looking for?
438,2555,1,19,79,99,1.2121212121212122,0.04372080059897002,688,I used the stairs on my last trip.
1396,2555,2,17,80,99,1.2121212121212122,0.046017947241275524,688,"That's right sir, it is one small step."
1293,2555,6,9,84,99,1.2121212121212122,0.05424226877117604,688,This car doesn't go that far sir.
1266,2555,1,19,79,99,1.2121212121212122,0.04372080059897002,688,"I missed the first shuttle"""
4472,2555,3,15,81,99,1.2121212121212122,0.048205752059134375,688,I'm afraid our free shuttle won't be of much help.
895,2555,1,19,79,99,1.2121212121212122,0.04372080059897002,688,The Eagle has landed in the lower lobby.
726,2555,2,17,80,99,1.2121212121212122,0.046017947241275524,688,"Well, of course she used the stairs, she's been using the peloton bike"
4240,2555,3,15,81,99,1.2121212121212122,0.048205752059134375,688,"Welcome to your own little private space, sir."
4682,2613,5,10,80,95,1.2105263157894737,0.05373973370975062,688,"I don't have the special key for that floor, sir!"
3718,2613,2,16,77,95,1.2105263157894737,0.04707511531578504,688,These NASA budget cuts have gotten ridiculous.
1020,2613,4,12,79,95,1.2105263157894737,0.05161390135865942,688,"Yes, but it’s a giant leap from the roof."
2509,2613,5,10,80,95,1.2105263157894737,0.05373973370975062,688,"Watch your ‘first step for a man’, Sir."
1521,2617,3,15,82,100,1.21,0.047768380565162374,688,Well the building is named the Stratosphere.
3933,2617,3,15,82,100,1.21,0.047768380565162374,688,"80,000th floor, please. Is this elevator pressurized?"
1377,2619,5,9,77,91,1.2087912087912087,0.05528587822630302,688,"Housewares, women's lingerie, lunar surface."
3172,2620,6,8,82,96,1.2083333333333333,0.05524400949239042,688,Have you seen a milk maid? The missus and I are trying something.
3753,2620,3,14,79,96,1.2083333333333333,0.04892857905103333,688,"So sorry, madam, this elevator does not go that high."
3721,2620,2,16,78,96,1.2083333333333333,0.046633760328105456,688,"No, sir, batteries are on the second floor, in electronics."
3200,2620,2,16,78,96,1.2083333333333333,0.046633760328105456,688,It's just one small step to the mankind department.
3665,2620,2,16,78,96,1.2083333333333333,0.046633760328105456,688,"Sorry, sir—you'll have to take the express elevator on your left."
3551,2620,1,18,77,96,1.2083333333333333,0.04422001081778641,688,Wanting to get high?
3521,2620,3,14,79,96,1.2083333333333333,0.04892857905103333,688,"Sorry, this one doesn’t go fast enough to simulate weightlessness."
3492,2620,1,18,77,96,1.2083333333333333,0.04422001081778641,688,How high would you like to go?
3486,2620,2,16,78,96,1.2083333333333333,0.046633760328105456,688,Is this the moon?
3440,2620,4,12,80,96,1.2083333333333333,0.05112048604588235,688,"What are you, some kind of astronaut? Fuck off."
3418,2620,3,14,79,96,1.2083333333333333,0.04892857905103333,688,"Your floor, sir. The 4,398th."
3351,2620,6,8,82,96,1.2083333333333333,0.05524400949239042,688,My girlfriend likes to make us role-play. She'll be dressed up in a sexy Stanley Kubrick costume.
3169,2620,2,16,78,96,1.2083333333333333,0.046633760328105456,688,Mr. Musk isn’t a little early to be practicing for the Mars colony?
3098,2620,5,10,81,96,1.2083333333333333,0.053222197804875436,688,You might need to take a giant leap over the gap.
3050,2620,4,12,80,96,1.2083333333333333,0.05112048604588235,688,I would assume you're going up.
3034,2620,1,18,77,96,1.2083333333333333,0.04422001081778641,688,We only go up to Floor 50.
2934,2620,1,18,77,96,1.2083333333333333,0.04422001081778641,688,How high is this building?
2840,2620,2,16,78,96,1.2083333333333333,0.046633760328105456,688,"Sir, I'm afraid the 'M' stands for mezzanine."
3223,2620,3,14,79,96,1.2083333333333333,0.04892857905103333,688,Forgot your keys to the rover again sir?
2810,2620,5,10,81,96,1.2083333333333333,0.053222197804875436,688,"Sorry, sir, this is the top floor"
3268,2620,0,20,76,96,1.2083333333333333,0.04166666666666668,688,It is flu season...you can't be too careful.
3283,2620,4,12,80,96,1.2083333333333333,0.05112048604588235,688,"I was born in 1981 and I don’t think I’ve ever seen an elevator operator in my life.That was a thing you’d see I guess? Anyways, there’s one in this cartoon with an astronaut. They’re exchanging words about going up or using the stairs or something."
3287,2620,3,14,79,96,1.2083333333333333,0.04892857905103333,688,"I’m sorry, this elevator stops at the Penthouse."
3344,2620,3,14,79,96,1.2083333333333333,0.04892857905103333,688,"Neil, this time I’m sure it is no more than one small step for man."
3769,2620,1,18,77,96,1.2083333333333333,0.04422001081778641,688,Too many small steps for this man.
4841,2620,3,14,79,96,1.2083333333333333,0.04892857905103333,688,"Are you sure this is the space elevator?"""
4014,2620,2,16,78,96,1.2083333333333333,0.046633760328105456,688,I'm actually headed downstairs
5107,2620,5,10,81,96,1.2083333333333333,0.053222197804875436,688,International Space Station breakfast is on Wednesdays.
5159,2620,4,12,80,96,1.2083333333333333,0.05112048604588235,688,"First day of training at NASA, Lieutenant?"
5267,2620,1,18,77,96,1.2083333333333333,0.04422001081778641,688,"I'm sorry, Sir, this elevator is going down."
2735,2620,4,12,80,96,1.2083333333333333,0.05112048604588235,688,"1,863,753,925th floor, sir."
5088,2620,3,14,79,96,1.2083333333333333,0.04892857905103333,688,I'm renting space.
4961,2620,2,16,78,96,1.2083333333333333,0.046633760328105456,688,"Going up?""  David Sivak, Coquitlam, BC, Canad"
4955,2620,2,16,78,96,1.2083333333333333,0.046633760328105456,688,"Sir, yes. I see what you mean. The top floor is ‘spacey.’"
4871,2620,1,18,77,96,1.2083333333333333,0.04422001081778641,688,"No, I didn’t feel any Gs."
4776,2620,3,14,79,96,1.2083333333333333,0.04892857905103333,688,This is Apollo 10 - Apollo 11 is next floor up.
4724,2620,6,8,82,96,1.2083333333333333,0.05524400949239042,688,This elevator only goes to the 75th floor.
4675,2620,3,14,79,96,1.2083333333333333,0.04892857905103333,688,"Sorry, it’s going down."
4612,2620,3,14,79,96,1.2083333333333333,0.04892857905103333,688,One very small step for infidelity?
4594,2620,3,14,79,96,1.2083333333333333,0.04892857905103333,688,"Yes Sir,  I know it’s one small step ..but is this your floor?"
4480,2620,1,18,77,96,1.2083333333333333,0.04422001081778641,688,"Top floor, ground control. Please tell my wife I love her so."
4444,2620,1,18,77,96,1.2083333333333333,0.04422001081778641,688,Can you get me to Alpha Centauri?
4419,2620,1,18,77,96,1.2083333333333333,0.04422001081778641,688,"My escape velocity is 6.951 miles per second. Let's crank this baby up and see what it can do."""
4398,2620,3,14,79,96,1.2083333333333333,0.04892857905103333,688,Want to join the 100 mile high club?
4346,2620,3,14,79,96,1.2083333333333333,0.04892857905103333,688,Outer space was filled to capacity!
4300,2620,3,14,79,96,1.2083333333333333,0.04892857905103333,688,"Starlight Suite, Sir?"
4222,2620,1,18,77,96,1.2083333333333333,0.04422001081778641,688,Sky deck please
4219,2620,3,14,79,96,1.2083333333333333,0.04892857905103333,688,"Long story short, never trust a man with the last name Armstrong."
4180,2620,3,14,79,96,1.2083333333333333,0.04892857905103333,688,One small step for man is a few floors up sir...
4173,2620,4,12,80,96,1.2083333333333333,0.05112048604588235,688,Can I level with you?
4122,2620,4,12,80,96,1.2083333333333333,0.05112048604588235,688,There wasn’t a gift receipt
4094,2620,5,10,81,96,1.2083333333333333,0.053222197804875436,688,"Once I went into space, my wife won’t look at me any other way."
4072,2620,4,12,80,96,1.2083333333333333,0.05112048604588235,688,"Mr Armstrong arrived a few minutes ago, Mr Aldrin."
4061,2620,2,16,78,96,1.2083333333333333,0.046633760328105456,688,I'll press the close door button in ten... nine...
3891,2620,2,16,78,96,1.2083333333333333,0.046633760328105456,688,"Lunar floor, Sir. Your rocket is to the right"
2722,2620,3,14,79,96,1.2083333333333333,0.04892857905103333,688,"Sorry, it only goes to 40."
2708,2620,3,14,79,96,1.2083333333333333,0.04892857905103333,688,"And, by the way, you can take off the suit. Studies have shown that there's virtually no risk of running out of air in an elevator."
2665,2620,2,16,78,96,1.2083333333333333,0.046633760328105456,688,Am I over dressed?
1438,2620,1,18,77,96,1.2083333333333333,0.04422001081778641,688,You realize that the top floor is still sub-orbital?
1355,2620,4,12,80,96,1.2083333333333333,0.05112048604588235,688,It’s very simple really. This astronauts go up and the aquanauts go down. What’ll it be today?
1282,2620,3,14,79,96,1.2083333333333333,0.04892857905103333,688,"I could never make it at NASA Mission Control, but this the next best thing."
1227,2620,3,14,79,96,1.2083333333333333,0.04892857905103333,688,"Let me guess, the Armstrongs, not the Bernsteins"
1124,2620,4,12,80,96,1.2083333333333333,0.05112048604588235,688,The elevator doesn't go up any higher huh?
1016,2620,2,16,78,96,1.2083333333333333,0.046633760328105456,688,I'll take you to the top floor after that you're on your own.
832,2620,4,12,80,96,1.2083333333333333,0.05112048604588235,688,"Apologies, what floor was that again sir?"
781,2620,6,8,82,96,1.2083333333333333,0.05524400949239042,688,"Sorry, this elevator is going down."
1495,2620,2,16,78,96,1.2083333333333333,0.046633760328105456,688,I'm afraid we do not have a Moon Roof!
569,2620,3,14,79,96,1.2083333333333333,0.04892857905103333,688,"Would that be the fancy dress party on the 10th or the launch pad on the 120th, sir?"
548,2620,2,16,78,96,1.2083333333333333,0.046633760328105456,688,My therapist told me to challenge myself.
524,2620,1,18,77,96,1.2083333333333333,0.04422001081778641,688,"Yes, we have bathrooms."
519,2620,4,12,80,96,1.2083333333333333,0.05112048604588235,688,"Sir, the elevator doesn't go that high."
385,2620,4,12,80,96,1.2083333333333333,0.05112048604588235,688,"You'll fit, there's plenty of space"
364,2620,4,12,80,96,1.2083333333333333,0.05112048604588235,688,"Ground floor, Major Tom. Before Bloomberg, this was Davy Jones’ locker."
351,2620,2,16,78,96,1.2083333333333333,0.046633760328105456,688,"Eighty-six floors is a good first step. Now, shall we shoot for the roof?"
166,2620,5,10,81,96,1.2083333333333333,0.053222197804875436,688,"The potatoes are this way, Mr. Damon."
147,2620,4,12,80,96,1.2083333333333333,0.05112048604588235,688,You seem a little  Spaced out today. Hope  you have a great day!
562,2620,4,12,80,96,1.2083333333333333,0.05112048604588235,688,"Ma’am, it’s been a privilege riding with you."
1502,2620,2,16,78,96,1.2083333333333333,0.046633760328105456,688,"We don't have floor 48,450!"
139,2620,1,18,77,96,1.2083333333333333,0.04422001081778641,688,Today I am working from home.
1552,2620,2,16,78,96,1.2083333333333333,0.046633760328105456,688,"Yes, Sir, Mr. President. Rocket Man and his entourage await."
2537,2620,4,12,80,96,1.2083333333333333,0.05112048604588235,688,Low gravity at the penthouse sir?
2479,2620,2,16,78,96,1.2083333333333333,0.046633760328105456,688,"We're birds of a feather. My job, your job -- we both have our ups and downs."
2280,2620,4,12,80,96,1.2083333333333333,0.05112048604588235,688,"Ninth floor:lingerie, sports wear, and space shuttle."
2253,2620,2,16,78,96,1.2083333333333333,0.046633760328105456,688,"Be careful of the small step for man"""
2212,2620,3,14,79,96,1.2083333333333333,0.04892857905103333,688,Lift-off is in precisely ten seconds.
2159,2620,3,14,79,96,1.2083333333333333,0.04892857905103333,688,"You know, we really don't have a problem with lack of oxygen or depressurization on this elevator."
2144,2620,4,12,80,96,1.2083333333333333,0.05112048604588235,688,"Won't get you as high, but it's much safer..."
2605,2620,3,14,79,96,1.2083333333333333,0.04892857905103333,688,"So, it'll be the penthouse then?"
2115,2620,1,18,77,96,1.2083333333333333,0.04422001081778641,688,"Penthouse in 3, 2, 1..."
2043,2620,2,16,78,96,1.2083333333333333,0.046633760328105456,688,Your final frontier is the penthouse.
2020,2620,2,16,78,96,1.2083333333333333,0.046633760328105456,688,"After space, you've got nowhere to go but down!"
1968,2620,4,12,80,96,1.2083333333333333,0.05112048604588235,688,You're only a little late. Just gimme the lunch code.
1892,2620,2,16,78,96,1.2083333333333333,0.046633760328105456,688,Sorry sir the applicants for the Space Force are at the hotel next door.
1655,2620,5,10,81,96,1.2083333333333333,0.053222197804875436,688,"One small step for man, one giant tip for operator?"
1653,2620,2,16,78,96,1.2083333333333333,0.046633760328105456,688,"Fly me to the moon, Frank"
1620,2620,3,14,79,96,1.2083333333333333,0.04892857905103333,688,It's a connecting flight.
2053,2620,2,16,78,96,1.2083333333333333,0.046633760328105456,688,Complaints are the 5th floor.
1522,2620,3,14,79,96,1.2083333333333333,0.04892857905103333,688,"You like cheese, Earthling?"
2325,2718,1,19,81,101,1.2079207920792079,0.04295249893759181,688,They said I can decompress in their penthouse.
2470,2718,2,17,82,101,1.2079207920792079,0.04519886023965674,688,"Sir, the penthouse is not THAT high up"
4313,2718,4,13,84,101,1.2079207920792079,0.04938599569639575,688,I think no matter what you say I'm going to disappoint you.
816,2721,2,18,86,106,1.2075471698113207,0.04388374155720299,688,Miss your bus?
941,2721,3,16,87,106,1.2075471698113207,0.04588548019119496,688,Ready for takeoff.
2949,2723,5,9,78,92,1.2065217391304348,0.05472871783373013,688,"Ralph in a bad mood again , Mrs Kramden ?"
5125,2723,2,15,75,92,1.2065217391304348,0.047734242698569566,688,"I'm sorry, sir, but the top floor is only 59 storeys."
112,2723,3,13,76,92,1.2065217391304348,0.050174191266479935,688,"Sir, please take a seat  and fasten your seatbelt For lift off ."
2299,2723,2,15,75,92,1.2065217391304348,0.047734242698569566,688,"Sleep with the fishes, sir?"
4890,2727,3,14,80,97,1.2061855670103092,0.04846914279015989,688,"Oh, SPACIOUS elevators. I see it now."
4542,2728,3,15,84,102,1.2058823529411764,0.046916646025273935,688,Was your last place a walk up?
237,2729,1,16,71,88,1.2045454545454546,0.04616734730784048,688,"Let me explain the buttons to you, then you can take it from there"
4891,2730,4,11,78,93,1.2043010752688172,0.0519807292144392,688,It’s my elevator car; they are my controls.
2510,2730,2,15,76,93,1.2043010752688172,0.04727037156900375,688,It's gonna be a long day at work today...
4092,2732,4,12,82,98,1.2040816326530612,0.050161077954179,688,"Keep going up, I assume?"
1654,2732,1,18,79,98,1.2040816326530612,0.043416050423211075,688,"The Eagle has landed, sir."
355,2732,2,16,80,98,1.2040816326530612,0.045774958984969194,688,"Elevate me up, Scotty"
182,2732,5,10,83,98,1.2040816326530612,0.05221615820079095,688,"They tell me the stairs lead to heaven, but my cardio is not great."
4045,2736,3,12,74,89,1.202247191011236,0.050985625768042275,688,"I'm going to Floor 10, 9, 8, 7, 6..."
4727,2736,3,12,74,89,1.202247191011236,0.050985625768042275,688,Santa will be down the hall on your right.
3350,2736,2,14,73,89,1.202247191011236,0.04841664403947964,688,"Skyscrapers might be overdoing it, if you ask me sir."
1070,2736,3,12,74,89,1.202247191011236,0.050985625768042275,688,Sorry sir. We only go to the 40th floor.”
2920,2736,2,14,73,89,1.202247191011236,0.04841664403947964,688,"Oh, my space is a lot less hostile than yours."
2689,2736,4,10,75,89,1.202247191011236,0.05343123290615736,688,"Musk penthouse, lunch and launch."""
1835,2736,1,16,72,89,1.202247191011236,0.0457034878880431,688,"10,9,8,7...6 please."
4957,2736,2,14,73,89,1.202247191011236,0.04841664403947964,688,"If you come back at three am, I will let you shoot yourself to the moon...and back."
4470,2736,2,14,73,89,1.202247191011236,0.04841664403947964,688,"No, I'm not blasting off anywhere. I just like that feeling of pulling a few Gs for a while."
694,2736,1,16,72,89,1.202247191011236,0.0457034878880431,688,Watch the drop.
3035,2746,5,9,80,94,1.202127659574468,0.05364709930456415,688,I like floor for Trump apartment.  I have Christmas surprise for Dotard.
3321,2746,2,15,77,94,1.202127659574468,0.046815269577118276,688,"Womens, 5th floor please."
2551,2746,2,15,77,94,1.202127659574468,0.046815269577118276,688,Floor 10? 9? ... 8?
3337,2746,3,13,78,94,1.202127659574468,0.04919806972822639,688,going up? ...up & away?
2385,2746,1,17,76,94,1.202127659574468,0.04430450164682011,688,Rooftop Level.  To Infinity and Beyond!
2415,2746,2,15,77,94,1.202127659574468,0.046815269577118276,688,I'm sorry. This goes to the parking lot.
2309,2746,5,9,80,94,1.202127659574468,0.05364709930456415,688,"Good morning Mister Musk, your Cyber truck will around in a minute."
2417,2746,3,13,78,94,1.202127659574468,0.04919806972822639,688,"Sorry... ""M"" is for mezzanine."
3004,2746,3,13,78,94,1.202127659574468,0.04919806972822639,688,Did you remember to unplug the iron?
2918,2746,2,15,77,94,1.202127659574468,0.046815269577118276,688,How’s the new penthouse sir?
2715,2746,2,15,77,94,1.202127659574468,0.046815269577118276,688,"I'm sorry sir. The coop board has replaced the  launch pad  with a
 Media room."
2678,2746,1,17,76,94,1.202127659574468,0.04430450164682011,688,I am sorry but this elevator does not go that high.
2561,2746,4,11,79,94,1.202127659574468,0.05147067771448707,688,"Wow Greta, this is really next level"
2308,2746,4,11,79,94,1.202127659574468,0.05147067771448707,688,I'm running late. How far up does this thing go?
2382,2746,2,15,77,94,1.202127659574468,0.046815269577118276,688,I'm afraid this won't count as simulator training.
3373,2746,1,17,76,94,1.202127659574468,0.04430450164682011,688,"No, I don't think you'll need an umbrella."
4465,2746,2,15,77,94,1.202127659574468,0.046815269577118276,688,"Go sit down, we'll try it again."
3448,2746,4,11,79,94,1.202127659574468,0.05147067771448707,688,Twelth floor is as high as we go.
5311,2746,3,13,78,94,1.202127659574468,0.04919806972822639,688,Mind the small step.
5232,2746,4,11,79,94,1.202127659574468,0.05147067771448707,688,One small step to penthouse living.
5218,2746,3,13,78,94,1.202127659574468,0.04919806972822639,688,"Miss, there is no glass ceiling here."
4753,2746,3,13,78,94,1.202127659574468,0.04919806972822639,688,"You know this isn't Cape Canaveral, right?"
4747,2746,2,15,77,94,1.202127659574468,0.046815269577118276,688,It’s just a small step. The giant leap comes at the cellar door.
4714,2746,1,17,76,94,1.202127659574468,0.04430450164682011,688,This is inner space
4638,2746,1,17,76,94,1.202127659574468,0.04430450164682011,688,"No, Sir. You're in no danger. I'm completely quarantined."
3417,2746,3,13,78,94,1.202127659574468,0.04919806972822639,688,"Yes sir,the penthouse is another world. Rarified air indeed, sir."
4585,2746,1,17,76,94,1.202127659574468,0.04430450164682011,688,Space capsule or submarine?
4404,2746,5,9,80,94,1.202127659574468,0.05364709930456415,688,"It was a giant leap for mankind too, until we got it serviced."
4379,2746,3,13,78,94,1.202127659574468,0.04919806972822639,688,One small step at a time man.
4266,2746,1,17,76,94,1.202127659574468,0.04430450164682011,688,"We only go up to the 32nd floor, sir."
3790,2746,1,17,76,94,1.202127659574468,0.04430450164682011,688,I'm just so tired of floating.
3589,2746,2,15,77,94,1.202127659574468,0.046815269577118276,688,"Fourth floor, lingerie."
3557,2746,4,11,79,94,1.202127659574468,0.05147067771448707,688,I am just passing through going up and up and up and up.
3481,2746,3,13,78,94,1.202127659574468,0.04919806972822639,688,"How many fathoms do you wish to descend to today, sir?"
2215,2746,4,11,79,94,1.202127659574468,0.05147067771448707,688,The rental on the 5th floor? I am afraid it’s not THAT  spacious.
2055,2746,0,19,75,94,1.202127659574468,0.04164262559887302,688,"Yes, the bar on the top floor is called Outer Space, but we do have oxygen up there."
3943,2746,2,15,77,94,1.202127659574468,0.046815269577118276,688,"Rovers, Rudder Gages, Ladies Lingerie…watch your step."
1839,2746,1,17,76,94,1.202127659574468,0.04430450164682011,688,I'm going up...all the way up
5,2746,4,11,79,94,1.202127659574468,0.05147067771448707,688,"Operator, I am trying to reach commander P.R. |  Johnson” “Ground floor for major | Tom it is then”"
47,2746,3,13,78,94,1.202127659574468,0.04919806972822639,688,"Houston, is there a problem?"
69,2746,0,19,75,94,1.202127659574468,0.04164262559887302,688,I’m sorry ma’am. It only goes up to the 30th floor.
113,2746,1,17,76,94,1.202127659574468,0.04430450164682011,688,| parked it on top’
126,2746,2,15,77,94,1.202127659574468,0.046815269577118276,688,Wait. Sorry. | forgot my umbrella.
145,2746,4,11,79,94,1.202127659574468,0.05147067771448707,688,Going up. High up.
278,2746,3,13,78,94,1.202127659574468,0.04919806972822639,688,"Wow, so you drove 500 miles to get here *and* you didn't even stop to use the bathroom?"
533,2746,3,13,78,94,1.202127659574468,0.04919806972822639,688,Please watch your step or leap before exiting the elevator.
552,2746,5,9,80,94,1.202127659574468,0.05364709930456415,688,"I'm sorry, sir. We don't have a 126-millionth floor."
570,2746,1,17,76,94,1.202127659574468,0.04430450164682011,688,"Good luck on your re-entry, Sir."
574,2746,2,15,77,94,1.202127659574468,0.046815269577118276,688,We will be going up in 10...9...8...7...
2002,2746,3,13,78,94,1.202127659574468,0.04919806972822639,688,I’ve got to find a new dry cleaner.
1330,2746,2,15,77,94,1.202127659574468,0.046815269577118276,688,It’s one small step to the penthouse.
1421,2746,3,13,78,94,1.202127659574468,0.04919806972822639,688,"“One small elevator for man and seventy floors for all mankind, sir.”"
1422,2746,1,17,76,94,1.202127659574468,0.04430450164682011,688,"Sorry, what line of work did you say you were in?"
620,2746,1,17,76,94,1.202127659574468,0.04430450164682011,688,I hear LA has more space.
1494,2746,3,13,78,94,1.202127659574468,0.04919806972822639,688,To the moonroof?
1602,2746,3,13,78,94,1.202127659574468,0.04919806972822639,688,Dressed for the penthouse party sir?
1630,2746,2,15,77,94,1.202127659574468,0.046815269577118276,688,"Your right ,it’s all alien out there now"
1674,2746,2,15,77,94,1.202127659574468,0.046815269577118276,688,So this building is not really as tall as Mr. Trump claims?
1731,2746,2,15,77,94,1.202127659574468,0.046815269577118276,688,"sir this is the naval submarine base, I think you're in the wrong place."
1823,2746,1,17,76,94,1.202127659574468,0.04430450164682011,688,I already called down to valet for my Shuttle.
3135,2806,2,16,81,99,1.202020202020202,0.045357095658013595,688,"I hope, I get back"
1158,2806,5,10,84,99,1.202020202020202,0.051727123604429784,688,"I'm sorry, sir, but this only elevator only goes to the 30th floor."
3257,2806,1,18,80,99,1.202020202020202,0.0430246796994966,688,How far up does this go?
5303,2809,6,9,89,104,1.2019230769230769,0.05181508976462935,688,"One small step for man; one giant leap for mankind.""
""Ok boomer."
3810,2810,1,17,77,95,1.2,0.043887262677318455,688,"Pardon me, sir.  But may I suggest that your first step off be one small step for man, one giant leap for mankind?"
3804,2810,1,17,77,95,1.2,0.043887262677318455,688,"Due to budget cuts, this is as close to space as we can get you."
3595,2810,0,19,76,95,1.2,0.04125684985035172,688,This is earth lobby floor .
3538,2810,5,9,81,95,1.2,0.053122015099597644,688,"I'm sorry, sir.  We don't go that far up."
3525,2810,1,17,77,95,1.2,0.043887262677318455,688,"And in the back of the elevator, Cyclops awaits the next floor."
3443,2810,2,15,78,95,1.2,0.04636869624047491,688,"Your Uber SpaceX is waiting out front, sir."
3345,2810,2,15,78,95,1.2,0.04636869624047491,688,The president's bathroom is the second door on the right.
3180,2810,1,17,77,95,1.2,0.043887262677318455,688,And she says I'M the impulsive shopper!
3114,2810,4,11,80,95,1.2,0.0509704259596523,688,"Don't worry, i'm vaccinated."
2965,2810,1,17,77,95,1.2,0.043887262677318455,688,"Liftoff at your pleasure, sir."
2928,2810,3,13,79,95,1.2,0.04872391770757884,688,"Going down, for a change?"
2889,2810,2,15,78,95,1.2,0.04636869624047491,688,"I'm sorry, sir. The Skylight Room is closed for the night."
2875,2810,2,15,78,95,1.2,0.04636869624047491,688,One final leap for mankind
2831,2810,3,13,79,95,1.2,0.04872391770757884,688,NASA has had severe cut backs.  Can you make the elevator drop fast enough to experience weightlessness?
2829,2810,4,11,80,95,1.2,0.0509704259596523,688,Mr Kubrick will be with you shortly
2754,2810,2,15,78,95,1.2,0.04636869624047491,688,"Back from Mars so soon, Captain?"
2728,2810,2,15,78,95,1.2,0.04636869624047491,688,I‘m sorry it’s not as nice as the moon Mr Armstrong.
2688,2810,1,17,77,95,1.2,0.043887262677318455,688,I’ll get out here.
2503,2810,3,13,79,95,1.2,0.04872391770757884,688,"Mr. Musk likes his gantries first-class."""
2446,2810,4,11,80,95,1.2,0.0509704259596523,688,"Go, sir, where no man has gone before."
2430,2810,3,13,79,95,1.2,0.04872391770757884,688,The next elevator down isn't due for at least six months.
2284,2810,2,15,78,95,1.2,0.04636869624047491,688,The internet said this place had 5 stars?
2250,2810,2,15,78,95,1.2,0.04636869624047491,688,"Penthouse, we have a problem."
3820,2810,2,15,78,95,1.2,0.04636869624047491,688,"Wait, what did you do to the elevator motor?"
5328,2810,3,13,79,95,1.2,0.04872391770757884,688,"And your shuttle service is on a first come, first serve basis?"
3913,2810,2,15,78,95,1.2,0.04636869624047491,688,Management's response to the recall on our windows.
3971,2810,3,13,79,95,1.2,0.04872391770757884,688,What floor are the moon landing auditions?
5250,2810,2,15,78,95,1.2,0.04636869624047491,688,I'd say your trajectory is more than a little off.
5143,2810,2,15,78,95,1.2,0.04636869624047491,688,I don't think this elevator will reach as high as you're anticipating... This building is only 23 stories... Seriously why are you doing this to me? My lunch break is in five minutes...
5099,2810,3,13,79,95,1.2,0.04872391770757884,688,The air quality is terrible today
5087,2810,3,13,79,95,1.2,0.04872391770757884,688,"Hypersonic speed,102nd floor.Training."
5029,2810,3,13,79,95,1.2,0.04872391770757884,688,"That's one small step for you, Mr. Musk, one giant leap for the other 99% of us."
4944,2810,2,15,78,95,1.2,0.04636869624047491,688,"Floor 281 ...  Have a good day, sir."
5340,2810,2,15,78,95,1.2,0.04636869624047491,688,It's hot in the city tonight.
4942,2810,2,15,78,95,1.2,0.04636869624047491,688,"One small step for man, one giant leap from the tenth floor."
4934,2810,3,13,79,95,1.2,0.04872391770757884,688,"Forget your protein pill again, Major Tom?"
4876,2810,3,13,79,95,1.2,0.04872391770757884,688,Surface transportation is on this floor.
129,2810,3,12,75,90,1.2,0.05046599329648382,688,You don’t need to hold the door. Buzz and Neil will be at least two more hours.
4835,2810,2,15,78,95,1.2,0.04636869624047491,688,This doesn't go to the Moon
2148,2810,4,11,80,95,1.2,0.0509704259596523,688,"Unless that's a bullshit suit, it won't help you on the top floor."
4789,2810,3,13,79,95,1.2,0.04872391770757884,688,Continue walking up the stairs until you see a giant rock.
4694,2810,5,9,81,95,1.2,0.053122015099597644,688,NASA hopes if we stay at a Trump hotel he'll remember we already have a Space Force.
4505,2810,1,17,77,95,1.2,0.043887262677318455,688,Meeting with HR are you? I see you're well prepared.
4464,2810,2,15,78,95,1.2,0.04636869624047491,688,"Yesiree, tallest building in Dubai."
4336,2810,1,17,77,95,1.2,0.043887262677318455,688,Give me a countdown
319,2810,2,14,74,90,1.2,0.04792836935744237,688,I'm afraid this one will take three small steps.
4131,2810,3,13,79,95,1.2,0.04872391770757884,688,"Sir, this floor is actually above the smog level."
4127,2810,2,15,78,95,1.2,0.04636869624047491,688,"So, you like the Astros chances this season?"
4104,2810,3,13,79,95,1.2,0.04872391770757884,688,"That's one small step for man, one giant leap for maniacs."
4068,2810,2,15,78,95,1.2,0.04636869624047491,688,Sorry.  This one's going down.
3961,2810,1,17,77,95,1.2,0.043887262677318455,688,I'm here for the Space Force interview.
4177,2810,2,15,78,95,1.2,0.04636869624047491,688,Mmm...sure Frank...I’ll fly you to the moon
2099,2810,1,17,77,95,1.2,0.043887262677318455,688,"Shoot me up to the 151st floor, please."
1923,2810,4,11,80,95,1.2,0.0509704259596523,688,But does yours play music?
623,2810,3,13,79,95,1.2,0.04872391770757884,688,Is this the Bezos or Musk floor?
622,2810,3,13,79,95,1.2,0.04872391770757884,688,"No, sir. Going down."
440,2810,4,11,80,95,1.2,0.0509704259596523,688,I believe this is your space sir
429,2810,3,13,79,95,1.2,0.04872391770757884,688,"Your first trip to the lobby and beyond, sir?"
352,2810,2,15,78,95,1.2,0.04636869624047491,688,You are go for lunch.
311,2810,2,15,78,95,1.2,0.04636869624047491,688,Would you like a countdown?
195,2810,2,15,78,95,1.2,0.04636869624047491,688,"Suite 4 please, 3rd bachelorette party of the night."
181,2810,4,11,80,95,1.2,0.0509704259596523,688,I started to feel like work was a ferocious void so they sent me home
159,2810,3,13,79,95,1.2,0.04872391770757884,688,"Rooftop please, they are waiting for me...I lost track of time"
141,2810,3,13,79,95,1.2,0.04872391770757884,688,DOWNSTAIRS?
120,2810,1,17,77,95,1.2,0.043887262677318455,688,"slower than Apollo, Faster than the stairs, safer than both!"
119,2810,2,15,78,95,1.2,0.04636869624047491,688,"10 years from now at Tesla Tower, Planet Mars."
87,2810,3,13,79,95,1.2,0.04872391770757884,688,You just have  to push the right button and you go up.
74,2810,2,15,78,95,1.2,0.04636869624047491,688,hopefully there will be enough space for you in this room sir
5165,2810,3,12,75,90,1.2,0.05046599329648382,688,"hey man, I get that you were, like, just in space and all that, but a Christmas gift still would've been appreciated."
4848,2810,4,10,76,90,1.2,0.0528819853025402,688,"Due to budgetary restraints, this is the highest we go."
3620,2810,3,12,75,90,1.2,0.05046599329648382,688,I'm guessing you are going to the top floor.
624,2810,2,15,78,95,1.2,0.04636869624047491,688,Watch the landing. It’s one small step.
656,2810,3,13,79,95,1.2,0.04872391770757884,688,Sorry the Musk expedition is full; try the Branson elevator.
4423,2810,2,15,78,95,1.2,0.04636869624047491,688,This is as close to the moon as I can take you.
877,2810,2,15,78,95,1.2,0.04636869624047491,688,Does this mean I'm not getting a holiday tip?
817,2810,1,17,77,95,1.2,0.043887262677318455,688,"Floor 102,437 next!"
1694,2810,4,11,80,95,1.2,0.0509704259596523,688,"Up, up and away, please."
1376,2810,3,13,79,95,1.2,0.04872391770757884,688,Going Up- Up and Away... ?
1360,2810,2,15,78,95,1.2,0.04636869624047491,688,There is plenty to do Major Tom
1354,2810,2,15,78,95,1.2,0.04636869624047491,688,Beam me up Scotty!
1335,2810,1,17,77,95,1.2,0.043887262677318455,688,"Step out, sir.  And watch the ozone hole."
1305,2810,1,17,77,95,1.2,0.043887262677318455,688,"I take it you're going up, sir?"
1253,2810,2,15,78,95,1.2,0.04636869624047491,688,No casual Friday this week?
1741,2810,3,13,79,95,1.2,0.04872391770757884,688,The lengths I'll go to just to avoid my being with in-laws on the holidays.
1149,2810,4,11,80,95,1.2,0.0509704259596523,688,Take me to the floor with the most space
1146,2810,2,15,78,95,1.2,0.04636869624047491,688,Bubble got your tongue?  I repeat - going up or down?
1134,2810,5,9,81,95,1.2,0.053122015099597644,688,Had to come back down ASAP. The Space Force showed up and it’s only Trump supporters who think the Earth is flat.
1032,2810,3,13,79,95,1.2,0.04872391770757884,688,To the 71st floor and beyond!
973,2810,2,15,78,95,1.2,0.04636869624047491,688,So you'll pass along my resume?
914,2810,2,15,78,95,1.2,0.04636869624047491,688,"Houston, we have lift off."
1734,2900,1,18,82,101,1.198019801980198,0.04226226924834268,688,I can only go up.
4987,2900,4,12,85,101,1.198019801980198,0.04878687126635613,688,I think the affair is 'bow-tie' was optional...just go with your look!
1217,2900,3,14,84,101,1.198019801980198,0.046713370740932486,688,"I beg your pardon Sir, this is not a dive."
206,2900,2,16,83,101,1.198019801980198,0.0445434529869386,688,Do you think he will remember my elevator pitch?
449,2904,2,15,79,96,1.1979166666666667,0.04593041950246607,688,Not sure what your job is but it seems your regulators are as silly as mine.
5048,2904,2,15,79,96,1.1979166666666667,0.04593041950246607,688,"Off to meet the voters, Mr. Bloomberg?"
4428,2904,2,15,79,96,1.1979166666666667,0.04593041950246607,688,Black Friday sales are out of this world
3845,2904,2,15,79,96,1.1979166666666667,0.04593041950246607,688,"So, I take it Nassau isn’t NASA’s sister school?"
3545,2904,2,15,79,96,1.1979166666666667,0.04593041950246607,688,I hear the penthouse is very space-ious.
3431,2904,1,17,78,96,1.1979166666666667,0.043477640116023786,688,"I’m sorry, but this elevator stops just below the stratosphere"
3271,2904,2,15,79,96,1.1979166666666667,0.04593041950246607,688,Every journey starts with the first floor.
1546,2904,1,17,78,96,1.1979166666666667,0.043477640116023786,688,what floor are your space heaters on?
3182,2912,2,14,75,91,1.1978021978021978,0.047449684731754656,688,"Are you joining the ""Space Force"
3213,2912,2,14,75,91,1.1978021978021978,0.047449684731754656,688,"I'm here for the open house at 432 Park, Apt: PH"
3526,2912,2,14,75,91,1.1978021978021978,0.047449684731754656,688,Do you mind if we do a countdown before you push the button?
3507,2912,5,8,78,91,1.1978021978021978,0.054626672182585344,688,And you are
3596,2912,1,16,74,91,1.1978021978021978,0.044802592971196056,688,"75834023rd Floor: Jupiter, Europa, Ganymede and Io, watch your step and oxygen levels!"
3256,2912,4,10,77,91,1.1978021978021978,0.05234379685830403,688,I'm hoping my flu shot will be enough.
3387,2912,2,14,75,91,1.1978021978021978,0.047449684731754656,688,Forgot the rocks again?
3562,2912,3,12,76,91,1.1978021978021978,0.049956709512768704,688,Technology has come a long way since we had to splash down.
3549,2912,2,14,75,91,1.1978021978021978,0.047449684731754656,688,"One small step for man, one giant leap for Men's Haberdashery."
3578,2912,2,14,75,91,1.1978021978021978,0.047449684731754656,688,High Rise
3548,2912,2,14,75,91,1.1978021978021978,0.047449684731754656,688,Godspeed with the air quality out there.
3429,2912,2,14,75,91,1.1978021978021978,0.047449684731754656,688,"Sir, Deep Space 9 isn't a floor in this building."
3165,2912,3,12,76,91,1.1978021978021978,0.049956709512768704,688,Need a booster?”
2593,2912,2,14,75,91,1.1978021978021978,0.047449684731754656,688,"The Smith’s apartment is on the left, one giant leap down the hall."
2711,2912,3,12,76,91,1.1978021978021978,0.049956709512768704,688,I lost their scent in the asteroids.
2505,2912,2,14,75,91,1.1978021978021978,0.047449684731754656,688,"What floor sir, 3...2...1."
3093,2912,1,16,74,91,1.1978021978021978,0.044802592971196056,688,"I’m sorry Mrs. Kramden, the highest I can “bang zoom” to, is the 39th floor."
3022,2912,2,14,75,91,1.1978021978021978,0.047449684731754656,688,"Uranus, 7th Floor Please"
2888,2912,3,12,76,91,1.1978021978021978,0.049956709512768704,688,through the roof please
2539,2912,3,12,76,91,1.1978021978021978,0.049956709512768704,688,Epstein didn't kill himself.
2763,2912,5,8,78,91,1.1978021978021978,0.054626672182585344,688,I'm sorry. It's the next elevator that will take you to the moon.
2455,2912,2,14,75,91,1.1978021978021978,0.047449684731754656,688,"Sure, but I’ll have to stand on your shoulders to reach the button."
2453,2912,2,14,75,91,1.1978021978021978,0.047449684731754656,688,"Actually, sir, we've cleaned the lobby after the Meyers baby."
2388,2912,3,12,76,91,1.1978021978021978,0.049956709512768704,688,Going waaaaaaaaay up?
2859,2912,2,14,75,91,1.1978021978021978,0.047449684731754656,688,"A long ride, huh?"
2375,2912,4,10,77,91,1.1978021978021978,0.05234379685830403,688,I was forewarned the atmosphere at this convention would be quite toxic...
2744,2912,1,16,74,91,1.1978021978021978,0.044802592971196056,688,"Sir, space suits are not needed for the planetarium."
2759,2912,1,16,74,91,1.1978021978021978,0.044802592971196056,688,The Germ Free Club meeting is in Room 837
2758,2912,3,12,76,91,1.1978021978021978,0.049956709512768704,688,I don’t think it’s much of an anti-gravity experience either but I’m not the one who cut your funding.
2869,2912,1,16,74,91,1.1978021978021978,0.044802592971196056,688,"We don't go down that far,"
3162,2912,1,16,74,91,1.1978021978021978,0.044802592971196056,688,Would you like to control liftoff?
3628,2912,3,12,76,91,1.1978021978021978,0.049956709512768704,688,It didn't work. My ears still popped when we passed the 20th floor.
4782,2912,0,18,73,91,1.1978021978021978,0.0419889520319622,688,"All the way to the top, please."
3666,2912,3,12,76,91,1.1978021978021978,0.049956709512768704,688,Driving the Tesla again today sir?
2419,2912,2,14,75,91,1.1978021978021978,0.047449684731754656,688,"First visit to the Big Apple, sir?"
5152,2912,2,14,75,91,1.1978021978021978,0.047449684731754656,688,I'm a British astronaut. I'm here for the lift off.
5097,2912,2,14,75,91,1.1978021978021978,0.047449684731754656,688,"6th Floor: Cosmetics, Rockets, Lingerie, Launchpads"
5086,2912,2,14,75,91,1.1978021978021978,0.047449684731754656,688,I guess you’re going up.
5059,2912,2,14,75,91,1.1978021978021978,0.047449684731754656,688,"NASA budget cuts are no joke, huh?"
5021,2912,2,14,75,91,1.1978021978021978,0.047449684731754656,688,The lunar elevator is still just an idea.
4996,2912,3,12,76,91,1.1978021978021978,0.049956709512768704,688,Easy does it.  One step at a time.
4870,2912,2,14,75,91,1.1978021978021978,0.047449684731754656,688,This is your stop: 432 Park Penthouse.
2370,2912,3,12,76,91,1.1978021978021978,0.049956709512768704,688,Which galaxy?
4730,2912,2,14,75,91,1.1978021978021978,0.047449684731754656,688,"Yes, there is life on other elevators."
4716,2912,1,16,74,91,1.1978021978021978,0.044802592971196056,688,They told me I needed to get used to heights to qualify.
4685,2912,3,12,76,91,1.1978021978021978,0.049956709512768704,688,I see you’re here to apply for a “Space Force” position.
4616,2912,3,12,76,91,1.1978021978021978,0.049956709512768704,688,Just practicing the ups and downs.
4603,2912,2,14,75,91,1.1978021978021978,0.047449684731754656,688,They have elevator attendants on Mars?!!!
4577,2912,3,12,76,91,1.1978021978021978,0.049956709512768704,688,Men's space ware is on the tenth floor.
4540,2912,0,18,73,91,1.1978021978021978,0.0419889520319622,688,"Sorry, you want the express elevator."
4534,2912,2,14,75,91,1.1978021978021978,0.047449684731754656,688,You're wearing THAT business suit to the dining room?
3675,2912,2,14,75,91,1.1978021978021978,0.047449684731754656,688,"Odd, but not as concerning as Mrs. Foster's parachute."
3692,2912,3,12,76,91,1.1978021978021978,0.049956709512768704,688,The Mar-a-lago launch pad has the classy elevator.  Much better than Elon Musk's.
3703,2912,1,16,74,91,1.1978021978021978,0.044802592971196056,688,You’ll take another elevator for that sir.
3706,2912,4,10,77,91,1.1978021978021978,0.05234379685830403,688,Not only is there no oxygen in the penthouse but sleeping in this suit is ruining my marriage.
3709,2912,2,14,75,91,1.1978021978021978,0.047449684731754656,688,The Oval Office is on fhe right
3803,2912,2,14,75,91,1.1978021978021978,0.047449684731754656,688,Damn. Would you mind holding the door open while I go back and get my Depends?
3640,2912,2,14,75,91,1.1978021978021978,0.047449684731754656,688,"I'm sorry, sir. That floor is restricted to our frequent guest loyalty club members only."
3848,2912,2,14,75,91,1.1978021978021978,0.047449684731754656,688,This is as high as we go Mr. Musk.
4064,2912,3,12,76,91,1.1978021978021978,0.049956709512768704,688,Now if you'll just direct me to the airport shuttle...
4083,2912,1,16,74,91,1.1978021978021978,0.044802592971196056,688,This car only goes up to the 42nd floor.
4138,2912,5,8,78,91,1.1978021978021978,0.054626672182585344,688,I quit.
4140,2912,1,16,74,91,1.1978021978021978,0.044802592971196056,688,How high does this bad boy go?
4206,2912,3,12,76,91,1.1978021978021978,0.049956709512768704,688,I’m beginning to regret having eaten all of that cheese.
4445,2912,2,14,75,91,1.1978021978021978,0.047449684731754656,688,"You're at the wrong address, buddy. This is NASA office
headquarters in Washington not Cape Canaveral, Florida.
I hope you have a better chance at finding Mars."
3880,2912,4,10,77,91,1.1978021978021978,0.05234379685830403,688,"Lost and Found, Public Restrooms and Black Holes"
2369,2912,2,14,75,91,1.1978021978021978,0.047449684731754656,688,Which way to the bachelorette party?
3343,2912,2,14,75,91,1.1978021978021978,0.047449684731754656,688,"Look, I'm sorry you missed your flight but I just don't go that high"
2294,2912,2,14,75,91,1.1978021978021978,0.047449684731754656,688,I prefer personal space.
1104,2912,3,12,76,91,1.1978021978021978,0.049956709512768704,688,"If you think about it, we’re in the same line of work."
986,2912,3,12,76,91,1.1978021978021978,0.049956709512768704,688,Let's hope we'll never have to take the emergency staircase again
861,2912,2,14,75,91,1.1978021978021978,0.047449684731754656,688,My therapist says I need to be more grounded.
838,2912,4,10,77,91,1.1978021978021978,0.05234379685830403,688,Mr. Aldrin has been looking to relive his glory days
826,2912,1,16,74,91,1.1978021978021978,0.044802592971196056,688,"You may like to take a seat, sir. This baby goes up like a rocket!"
809,2912,3,12,76,91,1.1978021978021978,0.049956709512768704,688,"This IS the tallest building in the city, the party IS in the penthouse and YOU'RE overdressed."
706,2912,2,14,75,91,1.1978021978021978,0.047449684731754656,688,"5th floor women’s shoes, houseware, Kubrick’s moon landing set."
688,2912,1,16,74,91,1.1978021978021978,0.044802592971196056,688,Top floor?
681,2912,1,16,74,91,1.1978021978021978,0.044802592971196056,688,"I apologize for my latest bout of IBS, but isn't this a bit much?"
670,2912,0,18,73,91,1.1978021978021978,0.0419889520319622,688,This is the basement. I presume you want to go up.
633,2912,2,14,75,91,1.1978021978021978,0.047449684731754656,688,"Houston, we have a problem."
1125,2912,3,12,76,91,1.1978021978021978,0.049956709512768704,688,"I can get you as high as the 102nd floor, but you're on your own from there."
610,2912,3,12,76,91,1.1978021978021978,0.049956709512768704,688,Up or Down!
506,2912,3,12,76,91,1.1978021978021978,0.049956709512768704,688,"Sorry. Not higher than the penthouse."""
441,2912,1,16,74,91,1.1978021978021978,0.044802592971196056,688,"For the last time sir, I understand this is a giant leap for mankind, but can you please get off?"
347,2912,2,14,75,91,1.1978021978021978,0.047449684731754656,688,Our safeword is Buzz Aldrin.
322,2912,3,12,76,91,1.1978021978021978,0.049956709512768704,688,"Well, this is where your journey ends."
275,2912,2,14,75,91,1.1978021978021978,0.047449684731754656,688,Have a good monday sir
168,2912,1,16,74,91,1.1978021978021978,0.044802592971196056,688,Are you a visitor of Mr .Dogg?
138,2912,0,18,73,91,1.1978021978021978,0.0419889520319622,688,I will take a break from social media for couple of months. Please spare me some memes and good news about climate change when I’m back.
34,2912,2,14,75,91,1.1978021978021978,0.047449684731754656,688,Allergy season strikes again
29,2912,4,10,77,91,1.1978021978021978,0.05234379685830403,688,My therapist said I need to ‘face my fears’
18,2912,3,12,76,91,1.1978021978021978,0.049956709512768704,688,"Hotel bar, sir. Stay here long enough and perhaps you’ ll be transported somewhere else."
2351,2912,3,12,76,91,1.1978021978021978,0.049956709512768704,688,This is the roof...it’s as high as I go. Perhaps your buddies can meet you here?
581,2912,3,12,76,91,1.1978021978021978,0.049956709512768704,688,The SPACE FORCE arranged everything
1233,2912,3,12,76,91,1.1978021978021978,0.049956709512768704,688,"Down?  I can't do that, Dave."
953,2912,4,10,77,91,1.1978021978021978,0.05234379685830403,688,Mens Wear...one giant step to your right.
1805,2912,0,18,73,91,1.1978021978021978,0.0419889520319622,688,"Lunar garage level 3, please."
1952,2912,2,14,75,91,1.1978021978021978,0.047449684731754656,688,I've been told the views are phenomenal...
1873,2912,0,18,73,91,1.1978021978021978,0.0419889520319622,688,"Sorry to disappoint you, but the twelfth floor is as far as we go."
2027,2912,2,14,75,91,1.1978021978021978,0.047449684731754656,688,"Mrs. Kramden, I presume?"
1257,2912,3,12,76,91,1.1978021978021978,0.049956709512768704,688,"No need to apologize, sir. I can't smell anything."
2121,2912,1,16,74,91,1.1978021978021978,0.044802592971196056,688,Budget cuts. This is as high as you go.
1865,2912,2,14,75,91,1.1978021978021978,0.047449684731754656,688,To the penthouse and not beyond.
1859,2912,2,14,75,91,1.1978021978021978,0.047449684731754656,688,I love banking here. Just push the Vacuum Canister button and jump out quickly.
2209,2912,5,8,78,91,1.1978021978021978,0.054626672182585344,688,"Sir, this elevator only goes to the 7th floor."
1782,2912,1,16,74,91,1.1978021978021978,0.044802592971196056,688,So....is it flat?
1778,2912,2,14,75,91,1.1978021978021978,0.047449684731754656,688,"I am not a pessimist.
One good thing about the climate change ?
My costume is no longer limited to just Halloween now!"
1752,2912,3,12,76,91,1.1978021978021978,0.049956709512768704,688,"I'm sorry, but I can only take you as far as the 94th floor."
1709,2912,3,12,76,91,1.1978021978021978,0.049956709512768704,688,"I""ve had faster rides."
1632,2912,3,12,76,91,1.1978021978021978,0.049956709512768704,688,"Sorry sir, we only go to ten."
2161,2912,3,12,76,91,1.1978021978021978,0.049956709512768704,688,"Top floor, but really punch it this time."
1551,2912,1,16,74,91,1.1978021978021978,0.044802592971196056,688,Sorry!  I was going upstairs!
1548,2912,0,18,73,91,1.1978021978021978,0.0419889520319622,688,Can you give me a little space?
1464,2912,1,16,74,91,1.1978021978021978,0.044802592971196056,688,"No sir, orbital boom sensor systems and logistics modules are on the 5th floor."
2207,2912,3,12,76,91,1.1978021978021978,0.049956709512768704,688,I think your method acting class has gone too far.
1454,2912,0,18,73,91,1.1978021978021978,0.0419889520319622,688,"Starlight Roof, please."
1412,2912,3,12,76,91,1.1978021978021978,0.049956709512768704,688,"Let’s try it again today, Charlie."
1365,2912,2,14,75,91,1.1978021978021978,0.047449684731754656,688,"Respectfully sir, I don’t think you can blast off on this floor."
1997,2912,0,18,73,91,1.1978021978021978,0.0419889520319622,688,"Good luck on the Mars acquisition, Sir."
2004,2912,1,16,74,91,1.1978021978021978,0.044802592971196056,688,It's one small step for menswear.
4075,3032,4,10,78,92,1.1956521739130435,0.0518163411891826,688,"Activewear in on floor 4, sir. Uh, but if sir is a lady, then Activewear on the lower level."
1121,3032,0,18,74,92,1.1956521739130435,0.041585659081903516,688,I guess the Space Force is still underfunded?
970,3032,2,14,76,92,1.1956521739130435,0.046980316386280786,688,My son has one of those.  How do you like it?
663,3032,1,16,75,92,1.1956521739130435,0.044365060402479714,688,Do you think you can look over my Space Force application when you have a minute?
1888,3032,3,12,77,92,1.1956521739130435,0.0494574733583754,688,I think I’ve made a mistake.. The dress code said ‘suit’ so I just figured...
2026,3032,2,14,76,92,1.1956521739130435,0.046980316386280786,688,"Sorry Commander, this car only goes down!!!"
3705,3032,5,8,79,92,1.1956521739130435,0.054072402919355736,688,"Sir your playtime outfit is best left upstairs...
What do you say we go back up and fly to the moon?"
3295,3032,2,14,76,92,1.1956521739130435,0.046980316386280786,688,"Yes, sir!  The flu IS really bad this year!"
3441,3032,1,16,75,92,1.1956521739130435,0.044365060402479714,688,"Fourth Floor, Mars."
4927,3032,0,18,74,92,1.1956521739130435,0.041585659081903516,688,Parking Deck?
4278,3032,3,12,77,92,1.1956521739130435,0.0494574733583754,688,You'll have to walk up the rest of the way.
485,3032,1,16,75,92,1.1956521739130435,0.044365060402479714,688,"This elevator is going down, sir."
2621,3032,5,8,79,92,1.1956521739130435,0.054072402919355736,688,One small step for the third floor.
362,3032,2,14,76,92,1.1956521739130435,0.046980316386280786,688,Are the stars really just like us?
2499,3032,3,12,77,92,1.1956521739130435,0.0494574733583754,688,Sorry just going to the 68th floor
3188,3032,2,14,76,92,1.1956521739130435,0.046980316386280786,688,It's time for your extra-vehicular activity.
4678,3048,3,14,86,103,1.1941747572815533,0.04588170510924863,688,"That’s One Small Step for Man, One Giant Leap to The Menswear Department."
502,3049,2,13,73,88,1.1931818181818181,0.04810395218312092,688,Let's blow the roof off.
5334,3049,1,15,72,88,1.1931818181818181,0.045307363593374915,688,The 64th Floor is high as I  can take you
1680,3049,2,13,73,88,1.1931818181818181,0.04810395218312092,688,I'm sorry but this building only goes up to floor 15.
1474,3052,1,14,68,83,1.1927710843373494,0.04681395181381146,688,Are you here to view the new office space?
2283,3053,3,13,83,99,1.1919191919191918,0.04691419395962154,688,"Whoa, you must be on a REALLY high floor."
1232,3053,2,15,82,99,1.1919191919191918,0.04466316750517219,688,Keep the door open. I'm afraid of closed spaces.
4720,3055,3,12,79,94,1.1914893617021276,0.048487995775374215,688,"To infinity and beyond?  Sir, this building has just 20 floors."
1441,3055,2,14,78,94,1.1914893617021276,0.046068483097531414,688,"Geared up for a zero-atmosphere party, Sir?"
1152,3055,2,14,78,94,1.1914893617021276,0.046068483097531414,688,"Sorry, Sir...the Moon is just above the Penthouse."
2792,3058,1,15,73,89,1.1910112359550562,0.04484795700808779,688,"I’m sorry, we don’t have any higher floors. P"
2753,3058,4,9,76,89,1.1910112359550562,0.052701300672173365,688,The 7th floor in T-minus 10...9...8...
2751,3058,2,13,74,89,1.1910112359550562,0.047609892487932244,688,"Yes, there is a 13th floor, and you're going to take me there!"
2701,3058,2,13,74,89,1.1910112359550562,0.047609892487932244,688,This is the elevator. It's continuing mission is to go up or down.
2696,3058,1,15,73,89,1.1910112359550562,0.04484795700808779,688,"Hey, aren't you supposed to be on the moon right now?"
2643,3058,4,9,76,89,1.1910112359550562,0.052701300672173365,688,"Co-opt board interview ready, Millennial applicant affects a tentless measure of enviable self-sufficiency."
2601,3058,3,11,75,89,1.1910112359550562,0.0502201600716848,688,I'm in town for the reshoot.
2317,3058,3,11,75,89,1.1910112359550562,0.0502201600716848,688,They said the building had a lot of open space...
2277,3058,3,11,75,89,1.1910112359550562,0.0502201600716848,688,I never believed the penthouse landing was faked.
2937,3058,3,11,75,89,1.1910112359550562,0.0502201600716848,688,"Welcome to the Burj Khalifa, sir, but this is only the 155th floor."
2245,3058,2,13,74,89,1.1910112359550562,0.047609892487932244,688,"Going up, pun intended?"
2229,3058,2,13,74,89,1.1910112359550562,0.047609892487932244,688,"I dress for the job I want, an elevator attendant."
2034,3058,3,11,75,89,1.1910112359550562,0.0502201600716848,688,"Mr. Jones, do you ever get the feeling that these high risers are getting to be a bit too high?"
1976,3058,2,13,74,89,1.1910112359550562,0.047609892487932244,688,How high dose this go
1963,3058,4,9,76,89,1.1910112359550562,0.052701300672173365,688,What happened to that steps for mankind thing?
3042,3058,2,13,74,89,1.1910112359550562,0.047609892487932244,688,Nice.
1515,3058,2,13,74,89,1.1910112359550562,0.047609892487932244,688,"You didn't know about the 40,000th floor?"
3063,3058,2,13,74,89,1.1910112359550562,0.047609892487932244,688,"No sir, the 7th floor is for PLACE settings."""
4570,3058,2,13,74,89,1.1910112359550562,0.047609892487932244,688,"I appreciate the concern, Mrs. Stern, but I assure you I have improved since your last few rides."
4556,3058,2,13,74,89,1.1910112359550562,0.047609892487932244,688,Run out of sunblock again?
4550,3058,1,15,73,89,1.1910112359550562,0.04484795700808779,688,"Lunar module or command capsule, sir?"
4422,3058,2,13,74,89,1.1910112359550562,0.047609892487932244,688,Bad launch pad traffic?
4310,3058,2,13,74,89,1.1910112359550562,0.047609892487932244,688,Can you believe they kicked me out of the program... so what I don’t like elevators ... or tight spaces!
4246,3058,2,13,74,89,1.1910112359550562,0.047609892487932244,688,"Sorry, Sir. Like the economy, the elevator only goes down."
3829,3058,2,13,74,89,1.1910112359550562,0.047609892487932244,688,"Sorry, Mars 2112 has been closed for 7 years."
3606,3058,0,17,72,89,1.1910112359550562,0.04190437486571198,688,Everyone who visits the Trump Tower is a bit spacey
3503,3058,1,15,73,89,1.1910112359550562,0.04484795700808779,688,They left!!  I’m only 5 minutes late.
3473,3058,3,11,75,89,1.1910112359550562,0.0502201600716848,688,"Tuna casserole again tonight, sir?"
3462,3058,1,15,73,89,1.1910112359550562,0.04484795700808779,688,"This elevator doesn't go too fast, does it? I get motion-sickness very easily."
3177,3058,2,13,74,89,1.1910112359550562,0.047609892487932244,688,I guess you could say it's a good job but the gravity is terrible.
3160,3058,2,13,74,89,1.1910112359550562,0.047609892487932244,688,"You know, for the first floor, it’s one small flight of stairs."
3151,3058,2,13,74,89,1.1910112359550562,0.047609892487932244,688,"Sir, it is customary to remove your meta-galactic 
cataphract before entering the gala"
1451,3058,3,11,75,89,1.1910112359550562,0.0502201600716848,688,Hey Norm am I still the man you think I am?
3047,3058,2,13,74,89,1.1910112359550562,0.047609892487932244,688,Your first visit to a supertall?
1413,3058,3,11,75,89,1.1910112359550562,0.0502201600716848,688,One giant step for mankind?
1053,3058,2,13,74,89,1.1910112359550562,0.047609892487932244,688,I can get you as high as the 27th floor.
1228,3058,1,15,73,89,1.1910112359550562,0.04484795700808779,688,"I'm afraid you were misinformed, sir."
5346,3058,3,11,75,89,1.1910112359550562,0.0502201600716848,688,"Sorry sir, but the elevator doesn't go that far up."
5280,3058,4,9,76,89,1.1910112359550562,0.052701300672173365,688,''I don't recall the war on the moon in 1969.''
5262,3058,2,13,74,89,1.1910112359550562,0.047609892487932244,688,"Yeah, that sounds exciting, I guess. While you were at the International Space Station I got the new Disney streaming service and I got kicked off GrubHub for insisting the delivery drivers feed me the food like I’m a baby bird"
5195,3058,2,13,74,89,1.1910112359550562,0.047609892487932244,688,Good luck at school
5111,3058,1,15,73,89,1.1910112359550562,0.04484795700808779,688,Everything's fine at work.  Why do you ask?
5075,3058,3,11,75,89,1.1910112359550562,0.0502201600716848,688,"I heard the NASA budget was gutted almost immediately after Apollo 11, but I had no idea it had gotten this bad!"
4998,3058,3,11,75,89,1.1910112359550562,0.0502201600716848,688,I hear they may be cracking down on these pencil towers.
4954,3058,4,9,76,89,1.1910112359550562,0.052701300672173365,688,I'm looking for a five star experience.
4937,3058,2,13,74,89,1.1910112359550562,0.047609892487932244,688,"P2, actually."
4763,3058,0,17,72,89,1.1910112359550562,0.04190437486571198,688,"You say you want the 23,000,000th floor?"
1218,3058,0,17,72,89,1.1910112359550562,0.04190437486571198,688,"Ad decem, as usual, sir?"
1381,3058,3,11,75,89,1.1910112359550562,0.0502201600716848,688,I just got tired of climbing the stairway to heaven
75,3058,3,11,75,89,1.1910112359550562,0.0502201600716848,688,It’s just not the same.
169,3058,4,9,76,89,1.1910112359550562,0.052701300672173365,688,you dont need to hold the door buzz and neil will be back
1370,3058,1,15,73,89,1.1910112359550562,0.04484795700808779,688,"Sorry sir, you'll have to take a different elevator; this one only goes to the 5th floor."
191,3058,0,17,72,89,1.1910112359550562,0.04190437486571198,688,Of course you are the first sir.
256,3058,3,11,75,89,1.1910112359550562,0.0502201600716848,688,Mr. Kubrick’s floor please.
1061,3058,2,13,74,89,1.1910112359550562,0.047609892487932244,688,"Third planet, please."
1057,3058,3,11,75,89,1.1910112359550562,0.0502201600716848,688,"Sir, are you looking for the gantry in the Sky Light Lounge?"
4597,3058,3,11,75,89,1.1910112359550562,0.0502201600716848,688,Can you believe they assigned me a middle seat.
844,3058,1,15,73,89,1.1910112359550562,0.04484795700808779,688,"Ah...you were asking for our most ""space-ish"" suite."
824,3058,1,15,73,89,1.1910112359550562,0.04484795700808779,688,"Ground, please."
196,3058,2,13,74,89,1.1910112359550562,0.047609892487932244,688,"Rough day, huh?"
721,3058,5,7,77,89,1.1910112359550562,0.05507076999145734,688,Elon Musk’s Plan B
735,3058,0,17,72,89,1.1910112359550562,0.04190437486571198,688,I don't recommend Uber.
621,3058,1,15,73,89,1.1910112359550562,0.04484795700808779,688,Have a good lunar day.
550,3058,1,15,73,89,1.1910112359550562,0.04484795700808779,688,"It's just one small step, sir. Nothing more than that."
488,3058,1,15,73,89,1.1910112359550562,0.04484795700808779,688,"For the last time, sir, there is no gantry on this floor."
470,3058,1,15,73,89,1.1910112359550562,0.04484795700808779,688,One floor up for mankind?
442,3058,1,15,73,89,1.1910112359550562,0.04484795700808779,688,You will have to get off here we don’t go as far as the moon.
335,3058,2,13,74,89,1.1910112359550562,0.047609892487932244,688,Nope--only one G.
690,3058,2,13,74,89,1.1910112359550562,0.047609892487932244,688,Express check out is to your left.
4700,3058,3,11,75,89,1.1910112359550562,0.0502201600716848,688,"I'm sorry sir, but this is the highest altitude this vessel can attain."
1345,3128,2,12,70,84,1.1904761904761905,0.049310188462709244,688,"Good morning, Mr. Pitt.   I guess we can call this the Pitt Stop, heh, heh, heh...."
930,3128,2,12,70,84,1.1904761904761905,0.049310188462709244,688,"I'm sorry, sir, but there is no 28,000th floor."
1735,3128,1,14,69,84,1.1904761904761905,0.04631018196447773,688,You're in the wrong building. We only have 20 floors.
4509,3128,1,14,69,84,1.1904761904761905,0.04631018196447773,688,Be careful. The atmosphere is lethal up here.
4459,3128,0,16,68,84,1.1904761904761905,0.04310187027192874,688,"Yeah, I worry about global warming, too."
4124,3128,2,12,70,84,1.1904761904761905,0.049310188462709244,688,A sore arm about 12 hours. You might want to try a Flu Shot.
3647,3128,1,14,69,84,1.1904761904761905,0.04631018196447773,688,"Really, Sir, I can’t continue to enable your addiction to liftoffs."
725,3128,0,16,68,84,1.1904761904761905,0.04310187027192874,688,You're the first to make it back from the Penthouse.
3096,3128,1,14,69,84,1.1904761904761905,0.04631018196447773,688,"I miss space, can we go down really fast?"
2837,3128,1,14,69,84,1.1904761904761905,0.04631018196447773,688,"Take a left.  Climb out the window.  Zoom up about 240,000 miles"
2112,3128,2,12,70,84,1.1904761904761905,0.049310188462709244,688,I’ve spent my whole life training for this moment.
2041,3128,1,14,69,84,1.1904761904761905,0.04631018196447773,688,"I know... I know...I forgot
my locker key again!!"
1581,3128,4,8,72,84,1.1904761904761905,0.05481987004287437,688,Yes Sir. Of course you're going up.
1587,3128,2,12,70,84,1.1904761904761905,0.049310188462709244,688,"I don't see a button labeled ""Moon."" Try the freight elevator."
4820,3128,2,12,70,84,1.1904761904761905,0.049310188462709244,688,Strap on so you don't float away.
667,3128,3,10,71,84,1.1904761904761905,0.052137859745800555,688,A Spaceman on Earth!
4271,3128,1,14,69,84,1.1904761904761905,0.04631018196447773,688,"I'm sorry, but this is the highest the elevator will go."
253,3128,2,12,70,84,1.1904761904761905,0.049310188462709244,688,All the best for the SpaceX demo Mr.Musk!
3220,3128,1,14,69,84,1.1904761904761905,0.04631018196447773,688,The Eagle has landed in the shoe department.
626,3128,3,10,71,84,1.1904761904761905,0.052137859745800555,688,"I'm ready for launch, Captain."
216,3128,1,14,69,84,1.1904761904761905,0.04631018196447773,688,Walking in the club like excuse me sir
125,3128,1,14,69,84,1.1904761904761905,0.04631018196447773,688,"| SAID | WANTED SPACE, MAN."" |"
1022,3150,3,12,80,95,1.1894736842105262,0.048017206793896844,688,Uber Air
90,3150,1,16,78,95,1.1894736842105262,0.043101320360528265,688,"Sorry, Bob, we don’t go up that high.  |"
2892,3150,2,14,79,95,1.1894736842105262,0.0456255189839455,688,To infinity and menswear and sporting goods!
5279,3150,4,10,81,95,1.1894736842105262,0.050295291171453975,688,"Can you stop at floors 10, 9, 8, 7, 6..."
3075,3154,4,9,77,90,1.1888888888888889,0.05215564061107554,688,"No sir, I can hardly tell you have a giant eye for a head."
3028,3154,4,9,77,90,1.1888888888888889,0.05215564061107554,688,I know you want to be launched into space but I only go to the top floor.
3015,3154,3,11,76,90,1.1888888888888889,0.04970435551754336,688,I don't know why these dates never work out.
2705,3154,2,13,75,90,1.1888888888888889,0.04712573678232538,688,"Sorry, but this is as far as we go."
2975,3154,3,11,76,90,1.1888888888888889,0.04970435551754336,688,"Sorry, the elevator only goes up to the sixth floor."
2958,3154,0,17,73,90,1.1888888888888889,0.041490472243665276,688,"Moon, Mars or our new space elevator destination Venus?"
2848,3154,2,13,75,90,1.1888888888888889,0.04712573678232538,688,"Sorry, the building has no 13 trillionth floor."
2765,3154,2,13,75,90,1.1888888888888889,0.04712573678232538,688,"18,700 please."
2726,3154,2,13,75,90,1.1888888888888889,0.04712573678232538,688,The fake moon-landing set is the second door down on your left.
3196,3154,1,15,74,90,1.1888888888888889,0.044397603281480034,688,Floor 3...2...1...Off lift!
3125,3154,3,11,76,90,1.1888888888888889,0.04970435551754336,688,"Hi, not Earth, please."
2700,3154,1,15,74,90,1.1888888888888889,0.044397603281480034,688,Nice to meet someone else who is in the business of taking people to new heights.
2579,3154,3,11,76,90,1.1888888888888889,0.04970435551754336,688,To the 20th floor and beyond!
2587,3154,1,15,74,90,1.1888888888888889,0.044397603281480034,688,Suite 2001. The cranes are ready with the obelisk.
3252,3154,1,15,74,90,1.1888888888888889,0.044397603281480034,688,What goes up must come down
2397,3154,1,15,74,90,1.1888888888888889,0.044397603281480034,688,"W-a-a-y up, please!"
2296,3154,2,13,75,90,1.1888888888888889,0.04712573678232538,688,"Sir, the elevator only goes up 94 floors."
2259,3154,0,17,73,90,1.1888888888888889,0.041490472243665276,688,There are sandwiches on the 107th floor if you get hungry.
2244,3154,2,13,75,90,1.1888888888888889,0.04712573678232538,688,The Final Frontier.
2200,3154,1,15,74,90,1.1888888888888889,0.044397603281480034,688,"Well, what goes up..."
2176,3154,2,13,75,90,1.1888888888888889,0.04712573678232538,688,I see you're prepared for the flu season.
2163,3154,2,13,75,90,1.1888888888888889,0.04712573678232538,688,I'm new here.  Which way is up?
2133,3154,3,11,76,90,1.1888888888888889,0.04970435551754336,688,Launch pad Mr Musk?
2068,3154,4,9,77,90,1.1888888888888889,0.05215564061107554,688,See ya yesterday!
2651,3154,3,11,76,90,1.1888888888888889,0.04970435551754336,688,"The lobby’s buzzing! C’mon, It’s just one small step."
2487,3154,2,13,75,90,1.1888888888888889,0.04712573678232538,688,"Actually, sir, SpaceX is next door."
3682,3154,2,13,75,90,1.1888888888888889,0.04712573678232538,688,"Third floor, the Final Frontier.Watch your one small step."
3464,3154,1,15,74,90,1.1888888888888889,0.044397603281480034,688,Do it again!
5281,3154,2,13,75,90,1.1888888888888889,0.04712573678232538,688,"Going to the moon, thank you."
5258,3154,2,13,75,90,1.1888888888888889,0.04712573678232538,688,Push the red button!
5234,3154,3,11,76,90,1.1888888888888889,0.04970435551754336,688,"Hey, count your blessings. It was a hot day at work..."
5139,3154,3,11,76,90,1.1888888888888889,0.04970435551754336,688,I have a feeling you're going to be underwhelmed.
5102,3154,0,17,73,90,1.1888888888888889,0.041490472243665276,688,"Sorry, this is as high as this thing goes."
4980,3154,3,11,76,90,1.1888888888888889,0.04970435551754336,688,"Welcome back, we haven't seen you at the studio in 50 years"
4845,3154,2,13,75,90,1.1888888888888889,0.04712573678232538,688,This elevator doesn't go THAT high!
4665,3154,2,13,75,90,1.1888888888888889,0.04712573678232538,688,"Yuck, who farted?"
4564,3154,0,17,73,90,1.1888888888888889,0.041490472243665276,688,Give me 15 minutes to change and we'll go together.
4557,3154,2,13,75,90,1.1888888888888889,0.04712573678232538,688,"Sorry, this is not a space elevator."
4489,3154,1,15,74,90,1.1888888888888889,0.044397603281480034,688,The rest of the way you are on your own.
4340,3154,1,15,74,90,1.1888888888888889,0.044397603281480034,688,"Ok,  I'll push past 99 if you slip me a Benjamin."
4198,3154,2,13,75,90,1.1888888888888889,0.04712573678232538,688,"The monolith from ""2001: A Space Odyssey"" is down the second isle on the left."
4179,3154,2,13,75,90,1.1888888888888889,0.04712573678232538,688,"I can tell you want to get high, but I can't help you."
4168,3154,1,15,74,90,1.1888888888888889,0.044397603281480034,688,The stairs are broken.
4048,3154,3,11,76,90,1.1888888888888889,0.04970435551754336,688,"Sorry sir, but we have no button for “Gantry.”"
4024,3154,1,15,74,90,1.1888888888888889,0.044397603281480034,688,Now remember . . . keeping a down-to-earth personality is the best way to go.
4011,3154,0,17,73,90,1.1888888888888889,0.041490472243665276,688,"At worst, you'll land among the donor class."
3770,3154,3,11,76,90,1.1888888888888889,0.04970435551754336,688,"Yes sir, this is the very top floor of the Space Needle. I think you're taking the name a bit to literally."
3766,3154,2,13,75,90,1.1888888888888889,0.04712573678232538,688,"Just to let you know, it’ll be slower and lower than a launch."
3749,3154,3,11,76,90,1.1888888888888889,0.04970435551754336,688,It’s not the moon but the sale is worth a look
3739,3154,1,15,74,90,1.1888888888888889,0.044397603281480034,688,That bar where they still allow smoking is two blocks east.
3733,3154,3,11,76,90,1.1888888888888889,0.04970435551754336,688,Floor 560 million please.
1915,3154,3,11,76,90,1.1888888888888889,0.04970435551754336,688,"Sir, your dry cleaning has arrived so you can take that suit off now."
3487,3154,3,11,76,90,1.1888888888888889,0.04970435551754336,688,This is one step for man ...
3270,3154,2,13,75,90,1.1888888888888889,0.04712573678232538,688,"Going up in T-minus 10, 9, 8..."
1908,3154,4,9,77,90,1.1888888888888889,0.05215564061107554,688,"Did we forget to use the bathroom before heading to work again, sir?"
2686,3154,3,11,76,90,1.1888888888888889,0.04970435551754336,688,"No tether, Sir"
1851,3154,0,17,73,90,1.1888888888888889,0.041490472243665276,688,"Sir, we only go up to 26."
1106,3154,3,11,76,90,1.1888888888888889,0.04970435551754336,688,"Up or down, sir?"
1041,3154,1,15,74,90,1.1888888888888889,0.044397603281480034,688,Going up or way up?
985,3154,4,9,77,90,1.1888888888888889,0.05215564061107554,688,That’s one small elevator for man.
957,3154,1,15,74,90,1.1888888888888889,0.044397603281480034,688,"Floor 1,654,352, I assume?"
955,3154,3,11,76,90,1.1888888888888889,0.04970435551754336,688,"The ""far yonder"" is not an option, I'm afraid."
920,3154,3,11,76,90,1.1888888888888889,0.04970435551754336,688,"sorry wrong, elevator"
881,3154,2,13,75,90,1.1888888888888889,0.04712573678232538,688,It gets a little bumpy on the way up
729,3154,3,11,76,90,1.1888888888888889,0.04970435551754336,688,The launch pad is to the left.
697,3154,0,17,73,90,1.1888888888888889,0.041490472243665276,688,Ten...nine...eight...
1153,3154,2,13,75,90,1.1888888888888889,0.04712573678232538,688,"Sorry, we only go to the 40th floor moonroof."
666,3154,1,15,74,90,1.1888888888888889,0.044397603281480034,688,"What stage, sir?"
573,3154,1,15,74,90,1.1888888888888889,0.044397603281480034,688,Thirteen’s floor please
496,3154,3,11,76,90,1.1888888888888889,0.04970435551754336,688,"If you're really feeling nostalgic, I can just cut the cord."
474,3154,2,13,75,90,1.1888888888888889,0.04712573678232538,688,"I see you've missed your takeoff, will you be going up to the roof?"
435,3154,4,9,77,90,1.1888888888888889,0.05215564061107554,688,She said the penthouse has more space than we need.
259,3154,1,15,74,90,1.1888888888888889,0.044397603281480034,688,New Listing! Open concept with  great flow. Tons of space. Views are out of this world. No washer/ dryer hookup.
102,3154,3,11,76,90,1.1888888888888889,0.04970435551754336,688,Dtchete tall halted hated snd elnelice!
59,3154,1,15,74,90,1.1888888888888889,0.044397603281480034,688,the agoraphobia conference room is to the left all the way down
1893,3154,2,13,75,90,1.1888888888888889,0.04712573678232538,688,Just consider it a giant leap for the Co-op
20,3154,3,11,76,90,1.1888888888888889,0.04970435551754336,688,"Yep, that’s what she Said. Space."
579,3154,3,11,76,90,1.1888888888888889,0.04970435551754336,688,"Alright Sir, does this look like the right floor?"
1159,3154,3,11,76,90,1.1888888888888889,0.04970435551754336,688,There is a stop for The Bends on the 39th floor.
51,3154,2,13,75,90,1.1888888888888889,0.04712573678232538,688,"Welcome to our planet, Sir. you have a pleasant stay!  Hope"
1557,3154,3,11,76,90,1.1888888888888889,0.04970435551754336,688,Great set last night.
1658,3154,2,13,75,90,1.1888888888888889,0.04712573678232538,688,Take one bold step.
1621,3154,3,11,76,90,1.1888888888888889,0.04970435551754336,688,"Sorry, but Mr. Trump isn't taking applications for Space Command yet."
1586,3154,0,17,73,90,1.1888888888888889,0.041490472243665276,688,This does not service the odd floors.
1559,3154,1,15,74,90,1.1888888888888889,0.044397603281480034,688,Is this where the auditions for Sea Hunt are being held?
1192,3154,3,11,76,90,1.1888888888888889,0.04970435551754336,688,"Everything that goes up must come down,sir"
1476,3154,2,13,75,90,1.1888888888888889,0.04712573678232538,688,Your job is redundant. It's not rocket science.
1430,3154,1,15,74,90,1.1888888888888889,0.044397603281480034,688,Mesosphere or Thermosphere?
1737,3154,1,15,74,90,1.1888888888888889,0.044397603281480034,688,This is not what I envisioned when I said space elevator.
1706,3154,1,15,74,90,1.1888888888888889,0.044397603281480034,688,"You know, people say I look like Matt Damon."
1754,3154,2,13,75,90,1.1888888888888889,0.04712573678232538,688,We now offer Moon Pies on our room service menu.
1774,3154,2,13,75,90,1.1888888888888889,0.04712573678232538,688,The zero-gravity machine was out of order.
1347,3154,2,13,75,90,1.1888888888888889,0.04712573678232538,688,"Houston, we have a lift..."
1310,3154,3,11,76,90,1.1888888888888889,0.04970435551754336,688,This will take a while -- you might want to sit down.
1304,3154,4,9,77,90,1.1888888888888889,0.05215564061107554,688,"The bathroom is on the fourth floor, sir."
1264,3154,2,13,75,90,1.1888888888888889,0.04712573678232538,688,The elevator has landed. Watch your small steps for man.
1215,3154,3,11,76,90,1.1888888888888889,0.04970435551754336,688,Mars please.
1374,3154,1,15,74,90,1.1888888888888889,0.044397603281480034,688,Nice to see you again.  The usual express to the observation deck?
1712,3154,4,9,77,90,1.1888888888888889,0.05215564061107554,688,"Watch your step sir, just one small step at a time"
1260,3253,3,10,72,85,1.188235294117647,0.051569532748121864,688,"First, there’s one small step."
4247,3253,1,14,70,85,1.188235294117647,0.045816946845285964,688,Mr. Trump's Apartment please...
1392,3253,1,14,70,85,1.188235294117647,0.045816946845285964,688,What color is your parachute?
1850,3253,2,12,71,85,1.188235294117647,0.048778116640986524,688,Welcome inside Musk's new Cybershuttle.
4152,3253,2,12,71,85,1.188235294117647,0.048778116640986524,688,"No, miss. Unfortunately, our elevators still don't go beyond the glass ceiling."
2157,3253,2,12,71,85,1.188235294117647,0.048778116640986524,688,"This is not the gantry elevator, Pal!"
2498,3253,2,12,71,85,1.188235294117647,0.048778116640986524,688,I can take you as high as 42.
2508,3253,2,12,71,85,1.188235294117647,0.048778116640986524,688,Year-2040:- All set to wander on the earth.
4559,3253,0,16,69,85,1.188235294117647,0.04265068080823368,688,"With the NASA cutbacks, we've been told to explore other ways to lift off into space."
3193,3253,1,14,70,85,1.188235294117647,0.045816946845285964,688,Welcome to Central Park Tower!
4098,3253,1,14,70,85,1.188235294117647,0.045816946845285964,688,Your job will disappear in ten years.
4811,3253,2,12,71,85,1.188235294117647,0.048778116640986524,688,"This is floor 5,762, sir."
4009,3253,2,12,71,85,1.188235294117647,0.048778116640986524,688,"I'm sorry, sir, but Trump was wrong when he called this an airlock."
2738,3253,3,10,72,85,1.188235294117647,0.051569532748121864,688,The curry cooking in 3B is a bit much for me too.
4778,3253,1,14,70,85,1.188235294117647,0.045816946845285964,688,"They couldn't build a space elevator, because it couldn't go up and down without paying me overtime."
3615,3268,1,16,79,96,1.1875,0.042695628191498324,688,Are you getting used to the acceleration and altitude?
4558,3269,3,11,77,91,1.1868131868131868,0.04919892568609763,688,Enjoy your extra vehicular activity.
1462,3269,2,13,76,91,1.1868131868131868,0.046651195530939105,688,"They call using the elevator for the final portion of the descent a ""soft landing."""
1508,3269,3,11,77,91,1.1868131868131868,0.04919892568609763,688,I’m here to install the atmosphere.
2742,3269,2,13,76,91,1.1868131868131868,0.046651195530939105,688,"Ballroom's down the hall, Sir. I'm sure the guests will especially enjoy your version of 'Fly Me To The Moon."
2798,3269,3,11,77,91,1.1868131868131868,0.04919892568609763,688,"Will there be anyone joining you this evening, sir?"
3085,3269,2,13,76,91,1.1868131868131868,0.046651195530939105,688,"Careful, sir! It’s a fake ‘landing’."
2923,3269,2,13,76,91,1.1868131868131868,0.046651195530939105,688,How high do you go?
2372,3269,2,13,76,91,1.1868131868131868,0.046651195530939105,688,"Have a nice day at work, Mr. Armstrong."
3209,3277,2,12,72,86,1.186046511627907,0.048257256089076536,688,Did you remember to pack the Tang?
3152,3277,1,14,71,86,1.186046511627907,0.04533392718515796,688,"Sir, I believe there is a jet pack supercharging station just down the block"
3183,3277,2,12,72,86,1.186046511627907,0.048257256089076536,688,"Basement: Outdoor living, Space walks."
3205,3277,2,12,72,86,1.186046511627907,0.048257256089076536,688,I’m not a winter person.
3089,3277,1,14,71,86,1.186046511627907,0.04533392718515796,688,"The Space Station, please."
3261,3277,1,14,71,86,1.186046511627907,0.04533392718515796,688,Floor 487 million?
3267,3277,2,12,72,86,1.186046511627907,0.048257256089076536,688,I don't think that we can go that high.
3383,3277,1,14,71,86,1.186046511627907,0.04533392718515796,688,To reach the spacewalk floor take the flight of stairs right there.
3494,3277,2,12,72,86,1.186046511627907,0.048257256089076536,688,"None of us can really get away, sir."
3618,3277,3,10,73,86,1.186046511627907,0.051013337241002224,688,It’s true. There’s no such thing as one rat”
3116,3277,1,14,71,86,1.186046511627907,0.04533392718515796,688,Just another day at the Office.
3074,3277,1,14,71,86,1.186046511627907,0.04533392718515796,688,Very well.  The twenty-eighth...MILE?!
2809,3277,1,14,71,86,1.186046511627907,0.04533392718515796,688,Nice shoes !
3033,3277,3,10,73,86,1.186046511627907,0.051013337241002224,688,"I'm sorry, sir, there's only a Fireman button."
3032,3277,1,14,71,86,1.186046511627907,0.04533392718515796,688,Aren't you taking the global warming thing a little to far?
3023,3277,2,12,72,86,1.186046511627907,0.048257256089076536,688,Next floor final frontier.
2411,3277,3,10,73,86,1.186046511627907,0.051013337241002224,688,"The elevator ends in this floor, from here you have to use the stairs"
2434,3277,1,14,71,86,1.186046511627907,0.04533392718515796,688,So Mr Jones climate change is that serious?
2543,3277,2,12,72,86,1.186046511627907,0.048257256089076536,688,"Sixth floor is fine, but I'm not going to say ""Blast off!"""
2559,3277,2,12,72,86,1.186046511627907,0.048257256089076536,688,"To the Cosmo Lounge, sir?"
2629,3277,3,10,73,86,1.186046511627907,0.051013337241002224,688,"Floor 11 sir,the soundstage is down the hall to your left."
2636,3277,0,16,70,86,1.186046511627907,0.04220861455688511,688,There’s no place like home sir.
2648,3277,3,10,73,86,1.186046511627907,0.051013337241002224,688,"Actually, I prefer my current uniform Mr. Musk."
2929,3277,0,16,70,86,1.186046511627907,0.04220861455688511,688,"Climate change is coming faster than you think!
or
Sea levels are rising faster than you think!"
3629,3277,3,10,73,86,1.186046511627907,0.051013337241002224,688,"That was one small step for you, man."
2860,3277,3,10,73,86,1.186046511627907,0.051013337241002224,688,"No jumping, Bruce. I’m serious this time."
3039,3277,2,12,72,86,1.186046511627907,0.048257256089076536,688,"I'd keep the space suit on. The environment in this co-op is toxic."""
3645,3277,1,14,71,86,1.186046511627907,0.04533392718515796,688,Rooftop party is so 2019.
4587,3277,1,14,71,86,1.186046511627907,0.04533392718515796,688,Riding these things makes me nauseous.
3745,3277,2,12,72,86,1.186046511627907,0.048257256089076536,688,"It’s just down 5th,  .00000000000000001 light year away."
5245,3277,1,14,71,86,1.186046511627907,0.04533392718515796,688,"I'm afraid this elevator only goes down, Sir."
5164,3277,1,14,71,86,1.186046511627907,0.04533392718515796,688,We only go as high as 101 floors.
5046,3277,2,12,72,86,1.186046511627907,0.048257256089076536,688,Sorry sir. There's no space on here for you.
5005,3277,2,12,72,86,1.186046511627907,0.048257256089076536,688,"We only go up to the 35th floor, Major."
4856,3277,1,14,71,86,1.186046511627907,0.04533392718515796,688,The launch pad stairway is second door on left.
4772,3277,1,14,71,86,1.186046511627907,0.04533392718515796,688,How strange. I didn't think elevators had operators any more.
2313,3277,1,14,71,86,1.186046511627907,0.04533392718515796,688,welcome to the Thirteenth Floor.
4761,3277,2,12,72,86,1.186046511627907,0.048257256089076536,688,"12th floor, no oxygen needed sir"""
4691,3277,4,8,74,86,1.186046511627907,0.053627962740362745,688,"Sorry, sir.  This elevator only goes to the 9 billionth floor!"
4662,3277,0,16,70,86,1.186046511627907,0.04220861455688511,688,I think you stepped into the wrong capsule.
4586,3277,2,12,72,86,1.186046511627907,0.048257256089076536,688,We’re not going that far up.
4466,3277,2,12,72,86,1.186046511627907,0.048257256089076536,688,I forgot my car keys.
4458,3277,0,16,70,86,1.186046511627907,0.04220861455688511,688,I thought the out of this world rating would bring in the social elite?
3693,3277,2,12,72,86,1.186046511627907,0.048257256089076536,688,"Yes, I can smell the Musk, but how do I know you are not Bezos?"
4441,3277,1,14,71,86,1.186046511627907,0.04533392718515796,688,"Yes, please bring me back a hunk of blue cheese."
4360,3277,1,14,71,86,1.186046511627907,0.04533392718515796,688,"Yeah, pretty good. Yourself?"
4337,3277,2,12,72,86,1.186046511627907,0.048257256089076536,688,"One small step for the doorman, one giant vertical leap for mankind"
4134,3277,1,14,71,86,1.186046511627907,0.04533392718515796,688,Mars awaits.
3982,3277,4,8,74,86,1.186046511627907,0.053627962740362745,688,Roof maintenance at the Burj Khalifa.
3949,3277,1,14,71,86,1.186046511627907,0.04533392718515796,688,"This way to set, Mr. Armstrong."
3876,3277,2,12,72,86,1.186046511627907,0.048257256089076536,688,"Going up I think? Or are you a scuba diver now, Jeremy?"
3842,3277,2,12,72,86,1.186046511627907,0.048257256089076536,688,"But Sir, this elevator is going down."
3837,3277,1,14,71,86,1.186046511627907,0.04533392718515796,688,"Mr. Santo, it's only 20 floors to the penthouse."
3830,3277,2,12,72,86,1.186046511627907,0.048257256089076536,688,This time you'll be going way past the highest floor
3817,3277,0,16,70,86,1.186046511627907,0.04220861455688511,688,"I'm off after this ride, you'll have to come down on your own."
3812,3277,1,14,71,86,1.186046511627907,0.04533392718515796,688,Is this lift off?
3798,3277,3,10,73,86,1.186046511627907,0.051013337241002224,688,Twenty-fifth floor. Small step? Giant Leap? Your call.
3794,3277,1,14,71,86,1.186046511627907,0.04533392718515796,688,"Matt Damon, is that you?"
4425,3277,3,10,73,86,1.186046511627907,0.051013337241002224,688,"Yes,I know the basement is flooded!"
2297,3277,1,14,71,86,1.186046511627907,0.04533392718515796,688,I finally found the hotel Wi-Fi signal.
2445,3277,2,12,72,86,1.186046511627907,0.048257256089076536,688,'Submarine or Astronaught? Down or Up?'
16,3277,1,14,71,86,1.186046511627907,0.04533392718515796,688,Can I see your boarding pass?
1273,3277,2,12,72,86,1.186046511627907,0.048257256089076536,688,"I'm sorry sir, we don't have a 90,514,286th floor."
1174,3277,3,10,73,86,1.186046511627907,0.051013337241002224,688,"I'm sorry, that's above my pay grade."
1154,3277,1,14,71,86,1.186046511627907,0.04533392718515796,688,They're still working on that space elevator eh?
1079,3277,2,12,72,86,1.186046511627907,0.048257256089076536,688,Women's undergarments and secondary air-packs please...
1023,3277,2,12,72,86,1.186046511627907,0.048257256089076536,688,"So, ALL the way up?"
1010,3277,0,16,70,86,1.186046511627907,0.04220861455688511,688,"Here you go, top floor."
993,3277,4,8,74,86,1.186046511627907,0.053627962740362745,688,You can do it. It's just one small step for man...
842,3277,1,14,71,86,1.186046511627907,0.04533392718515796,688,Watch your one step for man
713,3277,1,14,71,86,1.186046511627907,0.04533392718515796,688,This is 125. The down elevator is not working You’re on your own. Happy Landings
691,3277,3,10,73,86,1.186046511627907,0.051013337241002224,688,13th floor please.
1274,3277,2,12,72,86,1.186046511627907,0.048257256089076536,688,"Sir, this only goes to the tenth floor"
606,3277,1,14,71,86,1.186046511627907,0.04533392718515796,688,It's those NASA budget cuts for microgravity testing.
528,3277,1,14,71,86,1.186046511627907,0.04533392718515796,688,"238,900th floor, rare rocks and who knows what else!"
522,3277,2,12,72,86,1.186046511627907,0.048257256089076536,688,"I missed lift-off.  79,890th floor please."
469,3277,4,8,74,86,1.186046511627907,0.053627962740362745,688,Watch your step
358,3277,2,12,72,86,1.186046511627907,0.048257256089076536,688,"Houston, please."
356,3277,2,12,72,86,1.186046511627907,0.048257256089076536,688,"That'll be ten small steps, first door on the right."
339,3277,2,12,72,86,1.186046511627907,0.048257256089076536,688,It's flu season.
306,3277,1,14,71,86,1.186046511627907,0.04533392718515796,688,"Well, the penthouse floor might be a start."
295,3277,2,12,72,86,1.186046511627907,0.048257256089076536,688,"You'll need that suit in there, lots of hot air."
158,3277,1,14,71,86,1.186046511627907,0.04533392718515796,688,Oh so the moon’s not interesting enough huh?
96,3277,1,14,71,86,1.186046511627907,0.04533392718515796,688,There was no prep for this small talk thing.
559,3277,2,12,72,86,1.186046511627907,0.048257256089076536,688,The 50th floor is a giant leap for mankind?
1278,3277,2,12,72,86,1.186046511627907,0.048257256089076536,688,Too bad that budget cutbacks mean an elevator ride to the top of New York's tallest building is how NASA gets Americans to space nowadays.
705,3277,3,10,73,86,1.186046511627907,0.051013337241002224,688,Space Force.Duh!
1496,3277,1,14,71,86,1.186046511627907,0.04533392718515796,688,You must be the new buyer in the moon rocks department.
1357,3277,0,16,70,86,1.186046511627907,0.04220861455688511,688,"You just missed the messenger with the subpoena, sir."
2078,3277,1,14,71,86,1.186046511627907,0.04533392718515796,688,The sky is not the limit.
2046,3277,1,14,71,86,1.186046511627907,0.04533392718515796,688,"No, I said space station, foor# 3,538,731,704,673!"
2000,3277,3,10,73,86,1.186046511627907,0.051013337241002224,688,Have my friends Time and Continuum arrived yet?
2203,3277,3,10,73,86,1.186046511627907,0.051013337241002224,688,The “honeymoon” suite is to the left.
1995,3277,1,14,71,86,1.186046511627907,0.04533392718515796,688,"Kubrick's floor, please."
1981,3277,1,14,71,86,1.186046511627907,0.04533392718515796,688,"What fathom, please?"
1942,3277,2,12,72,86,1.186046511627907,0.048257256089076536,688,I feel like we should address the chair in the room
1927,3277,1,14,71,86,1.186046511627907,0.04533392718515796,688,"Ahhhh, just one giant leap...into the lobby! Tangs for riding with us!"
1913,3277,1,14,71,86,1.186046511627907,0.04533392718515796,688,"Floor 25,632, please."
1901,3277,3,10,73,86,1.186046511627907,0.051013337241002224,688,"Have a good day, Mr Musk"
1869,3277,4,8,74,86,1.186046511627907,0.053627962740362745,688,We heard that the people here are scared of a huge honeycomb. Where's it?
2171,3277,3,10,73,86,1.186046511627907,0.051013337241002224,688,Trump should have listened to Greta.
1526,3277,3,10,73,86,1.186046511627907,0.051013337241002224,688,"No, I've never been to the moon; I'm just here for an interview with the Space Force."
1770,3277,2,12,72,86,1.186046511627907,0.048257256089076536,688,"That's one small step for man, one giant leap for five-story brownstones."
1793,3277,1,14,71,86,1.186046511627907,0.04533392718515796,688,"Thyssen, we have a problem."
1711,3277,2,12,72,86,1.186046511627907,0.048257256089076536,688,"The Vice President is to your right, pod four."
1661,3277,1,14,71,86,1.186046511627907,0.04533392718515796,688,"I'm sorry Sir, we have a weight room, but no weightless room."
1639,3277,2,12,72,86,1.186046511627907,0.048257256089076536,688,Sometimes I feel like Elon goes too far.
1545,3277,2,12,72,86,1.186046511627907,0.048257256089076536,688,"Sir, this building has no floor 'zero', much less 'zero-g'."
2443,3385,2,12,73,87,1.1839080459770115,0.04774726195683065,688,"These new buildings go so high, I just wanted to be prepared for anything."
3054,3385,3,10,74,87,1.1839080459770115,0.050468893694394994,688,"That's one small step for man, one giant leap for Macys."
1290,3387,1,14,73,88,1.1818181818181819,0.044397318354580724,688,They said my room has a lot of space
3131,3388,2,11,70,83,1.180722891566265,0.04892190131450311,688,"It’s a nice apartment, but I’m looking for something with a little more space."
2989,3388,1,13,69,83,1.180722891566265,0.04582023644587216,688,"I know you wanted to go to the international space station, but this is as close as I could manage."
1334,3388,1,13,69,83,1.180722891566265,0.04582023644587216,688,So how are you enjoying your penthouse apartment?
2481,3388,1,13,69,83,1.180722891566265,0.04582023644587216,688,"Rooftop, please.  I need some space."
3164,3388,3,9,71,83,1.180722891566265,0.05183831390483617,688,I think this 'Space Force' thing is getting out of hand.
2213,3388,4,7,72,83,1.180722891566265,0.054599168022660204,688,… but YELP said it was a bit of a dive!
2131,3388,2,11,70,83,1.180722891566265,0.04892190131450311,688,Are we still in the troposphere?
1870,3388,1,13,69,83,1.180722891566265,0.04582023644587216,688,"The fuck you looking at, nerd?"
2785,3388,1,13,69,83,1.180722891566265,0.04582023644587216,688,"First day on your new job?  Looks like you already heard about the toxic work environment here.  Lots of luck, buddy!"
3422,3388,1,13,69,83,1.180722891566265,0.04582023644587216,688,"Happy New Year, Senator."
3517,3388,1,13,69,83,1.180722891566265,0.04582023644587216,688,"As high up as you can go, please."
3483,3388,2,11,70,83,1.180722891566265,0.04892190131450311,688,"Sir, there is a small charge if you choose to free fall from the 110th floor."
3493,3388,2,11,70,83,1.180722891566265,0.04892190131450311,688,"The air was fixed this afternoon, sir!"
3743,3388,0,15,68,83,1.180722891566265,0.04249277241702737,688,That's one small step for Doug...
3938,3388,3,9,71,83,1.180722891566265,0.05183831390483617,688,"that chick who drove across the country in diapers to kill her husband or whatever— how was she, as like a spaceman?"
3969,3388,1,13,69,83,1.180722891566265,0.04582023644587216,688,Gravity sucks
3976,3388,2,11,70,83,1.180722891566265,0.04892190131450311,688,"There is still oxygen here, I promise."
4079,3388,1,13,69,83,1.180722891566265,0.04582023644587216,688,Obviously cutbacks in NASA funding.
4113,3388,1,13,69,83,1.180722891566265,0.04582023644587216,688,I missed my flight.  Is this the observation deck?
4273,3388,2,11,70,83,1.180722891566265,0.04892190131450311,688,I think you have over-prepared for the penthouse.
4283,3388,3,9,71,83,1.180722891566265,0.05183831390483617,688,Is there a bar on the roof? I want to grab a drink before I head home.
4713,3388,2,11,70,83,1.180722891566265,0.04892190131450311,688,"food delivery, 987th floor please"
4162,3388,2,11,70,83,1.180722891566265,0.04892190131450311,688,"As the elevator landed, Mr. Armstrong was about to make another small step."
3432,3388,1,13,69,83,1.180722891566265,0.04582023644587216,688,"The Moon Suite, sir?"
998,3388,2,11,70,83,1.180722891566265,0.04892190131450311,688,There were too many steps on the next flight.
286,3388,0,15,68,83,1.180722891566265,0.04249277241702737,688,I hope you have an out of this world experience.
835,3388,1,13,69,83,1.180722891566265,0.04582023644587216,688,"Whatever “jacket weather” is in Kelvin, I think you’ll be okay."
4717,3388,2,11,70,83,1.180722891566265,0.04892190131450311,688,Mrs. Goldfarb in Apt 4-C is asking why the General Tsao Chicken delivery is taking so long.
2096,3388,0,15,68,83,1.180722891566265,0.04249277241702737,688,I suggest to check our shuttle route in the reception.
5078,3388,1,13,69,83,1.180722891566265,0.04582023644587216,688,"Sixth Floor, Decontamination Lock."
4970,3388,0,15,68,83,1.180722891566265,0.04249277241702737,688,"Sir, the Stratosphere is simply the name of the hotel."
982,3388,1,13,69,83,1.180722891566265,0.04582023644587216,688,Watch out for the crater at 79th and Park.
4885,3388,2,11,70,83,1.180722891566265,0.04892190131450311,688,"I'm sorry, sir, the moon elevator shuts down during the day."
4771,3388,3,9,71,83,1.180722891566265,0.05183831390483617,688,"Floor 12, ladies lingerie and SpaceCamp."
162,3388,2,11,70,83,1.180722891566265,0.04892190131450311,688,‘Plumbing gear has come a long way’ She told the lift  operator.
192,3388,0,15,68,83,1.180722891566265,0.04249277241702737,688,"Our rooms are large but not as spaciou as you could have imagined, sir"
4822,3388,1,13,69,83,1.180722891566265,0.04582023644587216,688,"Geoffrey, this is not what I meant when I asked to by taken to Ground Zero."
426,3388,1,13,69,83,1.180722891566265,0.04582023644587216,688,When should I start the countdown?
4829,3388,1,13,69,83,1.180722891566265,0.04582023644587216,688,Sorry I couldn’t take you higher
492,3388,1,13,69,83,1.180722891566265,0.04582023644587216,688,Floor 76 - But I was assured this went all the way to the upper atmosphere.
588,3388,0,15,68,83,1.180722891566265,0.04249277241702737,688,You know the drill: one small step.
1317,3429,1,14,74,89,1.1797752808988764,0.043943150178405346,688,"I’m sorry, this elevator’s already full of nostalgia."
360,3429,3,10,76,89,1.1797752808988764,0.04941382071271396,688,"No sir, I won't count down from 10 and say ""Lift-off"" before we go."
936,3431,3,11,81,95,1.1789473684210525,0.04727501054750545,688,"Up or down, and with or without the boosters?"
1806,3431,2,13,80,95,1.1789473684210525,0.044843756048454156,688,Is Mr. Musk expecting you?
4280,3433,2,11,71,84,1.1785714285714286,0.048383846887362136,688,What are your doing in a film studio anyway?
3889,3433,1,13,70,84,1.1785714285714286,0.04532256509703348,688,Saturn floor sir?
833,3433,1,13,70,84,1.1785714285714286,0.04532256509703348,688,"Sorry, sir, we only go to the troposphere."
1912,3433,1,13,70,84,1.1785714285714286,0.04532256509703348,688,"It doesn't look like much, but it's decent space!"
332,3433,1,13,70,84,1.1785714285714286,0.04532256509703348,688,Escape velocity? What floor is that on?
761,3438,0,15,70,85,1.1764705882352942,0.04159451654038516,688,Take me to your leader.
427,3439,1,14,76,91,1.1758241758241759,0.04306172017490284,688,You are welcome to orbit our cocktail lounge which is located on the top level and has maybe more exotic views than space.
99,3440,2,10,68,80,1.175,0.04960285312333035,688,You know... you might find the presence of gravity here quite useful.
2238,3441,1,13,72,86,1.1744186046511629,0.04435850856191582,688,This elevator doesn't go to the space station
5288,3441,2,11,73,86,1.1744186046511629,0.0473421069773523,688,I'm just here for a good time
1535,3441,2,11,73,86,1.1744186046511629,0.0473421069773523,688,"Welcome to Death Star XL41 ... asteroids to your left, black holes to your right.  Taking samples not allowed."
1524,3441,1,13,72,86,1.1744186046511629,0.04435850856191582,688,"Sorry, Sir. That's in the Cousteau building next door -- sub-, sub-,  sub-basement!"
1764,3441,1,13,72,86,1.1744186046511629,0.04435850856191582,688,Tell me what a good day is
3450,3446,0,14,67,81,1.1728395061728396,0.04227381152657762,688,"Going up, you say?"
3552,3446,1,12,68,81,1.1728395061728396,0.04577900300676336,688,There's no space for you here.
3604,3446,2,10,69,81,1.1728395061728396,0.04903426446477902,688,It's a security issue - I work for Trump
2885,3446,1,12,68,81,1.1728395061728396,0.04577900300676336,688,I still can't get you access to the roof...and the 'thin air' above the seventh floor isn't the reason.
2854,3446,4,6,71,81,1.1728395061728396,0.05496947373060047,688,"Sir, I’ll take you up, but I don’t think Mr. Trump was serious about the  whole Space Force thing.”"
4095,3446,1,12,68,81,1.1728395061728396,0.04577900300676336,688,"""Scented candles and perfume. Please check you oxygen levels..."
3669,3446,1,12,68,81,1.1728395061728396,0.04577900300676336,688,"Yes. We go up, but not that far."
3700,3446,0,14,67,81,1.1728395061728396,0.04227381152657762,688,I can take you up to 18...not sure what you do from there.
3750,3446,2,10,69,81,1.1728395061728396,0.04903426446477902,688,All out for vacuums
3774,3446,1,12,68,81,1.1728395061728396,0.04577900300676336,688,"Thirteen? The manager tell ya? Quantum fluctuation up there could trigger a vacuum bubble. Yep. It'd expand at the speed of light 'n wipe out everything. Most hotels don't bother having a floor like that, but, hey, we ain't most hotels!"
3886,3446,3,8,70,81,1.1728395061728396,0.05208647681414566,688,Sixth floor...now it's time to leave the elevator if you dare.
3918,3446,3,8,70,81,1.1728395061728396,0.05208647681414566,688,Must have been a heck of  a Halloween Party.
3965,3446,1,12,68,81,1.1728395061728396,0.04577900300676336,688,Just another Spare The Air day
3988,3446,2,10,69,81,1.1728395061728396,0.04903426446477902,688,"Is this a straight to the moon kind of day, sir?"
3355,3446,3,8,70,81,1.1728395061728396,0.05208647681414566,688,"I look at the unprotected elevator personnel, then at the Geiger-Mueller counter inside my helmet. This level of radiation exposure? He’ll be dead in weeks…maybe days. But we need SOMEONE—it’s just too damn hard to push buttons in these puffy gloves."
4203,3446,0,14,67,81,1.1728395061728396,0.04227381152657762,688,"Be careful out there, Fella.  I don't think you're ready for the current atmosphere."
4345,3446,1,12,68,81,1.1728395061728396,0.04577900300676336,688,I see you’re going up to the POTUS’s penthouse.
2614,3446,1,12,68,81,1.1728395061728396,0.04577900300676336,688,You thought this was the levitator?
4814,3446,1,12,68,81,1.1728395061728396,0.04577900300676336,688,"Houston, we have your floor."
4904,3446,3,8,70,81,1.1728395061728396,0.05208647681414566,688,I think there is still time to get your flu shot.
4963,3446,1,12,68,81,1.1728395061728396,0.04577900300676336,688,"Did you ask for the Delta Airlines Sky Lounge?""  Michael Sivak, Ann Arbor, M"
5073,3446,2,10,69,81,1.1728395061728396,0.04903426446477902,688,"Watch your step? That's what I was going to tell you, Sir!"
5198,3446,2,10,69,81,1.1728395061728396,0.04903426446477902,688,The job has its ups and downs.
5214,3446,3,8,70,81,1.1728395061728396,0.05208647681414566,688,"Space? Ma'am, this is New York City. Everyone wants space."
4220,3446,3,8,70,81,1.1728395061728396,0.05208647681414566,688,There's an alien world out there - be careful!
4780,3446,1,12,68,81,1.1728395061728396,0.04577900300676336,688,"So sorry, sir - my liftoff button is out of order."
4759,3446,1,12,68,81,1.1728395061728396,0.04577900300676336,688,Sorry sir.  We don't go any higher than ten floors.
4726,3446,1,12,68,81,1.1728395061728396,0.04577900300676336,688,"OK, but the 36th floor is as high we go."
4647,3446,2,10,69,81,1.1728395061728396,0.04903426446477902,688,"My cousins told me if you jump while the elevator is landing, it'll take you straight to the moon"
4628,3446,1,12,68,81,1.1728395061728396,0.04577900300676336,688,Level 4. Apollo and turtle necks.
4618,3446,0,14,67,81,1.1728395061728396,0.04227381152657762,688,"It's not the launching pad, but you can get there from here."
4435,3446,2,10,69,81,1.1728395061728396,0.04903426446477902,688,"No, Sir...we do not have a floor 85 thousand!"
4779,3446,2,10,69,81,1.1728395061728396,0.04903426446477902,688,I presume you are going down.
2513,3446,2,10,69,81,1.1728395061728396,0.04903426446477902,688,"No, sir. M is for Mezzanine, not Moon-Landing."
849,3446,1,12,68,81,1.1728395061728396,0.04577900300676336,688,"Sorry, I don't think it goes up that high."
2422,3446,2,10,69,81,1.1728395061728396,0.04903426446477902,688,Hi. I want to reach before Chandrayaan.
2429,3446,1,12,68,81,1.1728395061728396,0.04577900300676336,688,I bring you glad tidings!
154,3446,2,10,69,81,1.1728395061728396,0.04903426446477902,688,"Good morning, Major!  So glad to see you leave the tin can."
515,3446,2,10,69,81,1.1728395061728396,0.04903426446477902,688,More cutbacks?
526,3446,1,12,68,81,1.1728395061728396,0.04577900300676336,688,"I take it you had to park in the far lot, sir?"
669,3446,1,12,68,81,1.1728395061728396,0.04577900300676336,688,"Sir, I'm afraid my Moon button is out of order. Highest I can go is the Penthouse. You'll have to wait for the other elevator."
810,3446,2,10,69,81,1.1728395061728396,0.04903426446477902,688,I heard the penthouse has a moonroof.
954,3446,1,12,68,81,1.1728395061728396,0.04577900300676336,688,"It's not exactly what I expected, to be honest."
1011,3446,0,14,67,81,1.1728395061728396,0.04227381152657762,688,"I'll take you up, sir, but no counting backwards from 10 this time."
1289,3446,1,12,68,81,1.1728395061728396,0.04577900300676336,688,"Third floor, Menswear,  Manchester, Mars!"
1311,3446,2,10,69,81,1.1728395061728396,0.04903426446477902,688,"A few years after winning the chance to observe how government works, Jim's recent health conditions progressed to the point where he had to retreat."
1417,3446,1,12,68,81,1.1728395061728396,0.04577900300676336,688,I don’t go up that far!
1523,3446,2,10,69,81,1.1728395061728396,0.04903426446477902,688,"Only enough oxygen for one, so don't ask."
1648,3446,1,12,68,81,1.1728395061728396,0.04577900300676336,688,What moon is this?
821,3446,2,10,69,81,1.1728395061728396,0.04903426446477902,688,These new East-side buildings are taller than I thought.
1719,3446,2,10,69,81,1.1728395061728396,0.04903426446477902,688,"I'm sorry sir, we only go as far as the 22nd."
1665,3446,2,10,69,81,1.1728395061728396,0.04903426446477902,688,So that's one small step out of the lift and then one giant leap to the left.
2323,3446,1,12,68,81,1.1728395061728396,0.04577900300676336,688,"Zero G is doable, but not recommended on this elevator..."
2301,3446,0,14,67,81,1.1728395061728396,0.04227381152657762,688,"Penthouse or the pool today, sir?"
2228,3446,2,10,69,81,1.1728395061728396,0.04903426446477902,688,Sorry. Not allowed to take it up a couple of feet for you to make a giant leap. Don't care who you say it's for.
2013,3446,3,8,70,81,1.1728395061728396,0.05208647681414566,688,I know-air quality has taken a hit since this administration has taken over.
2324,3446,1,12,68,81,1.1728395061728396,0.04577900300676336,688,The Moon Lounge is down to your left and the Mars Bar is straight ahead.
2289,3446,3,8,70,81,1.1728395061728396,0.05208647681414566,688,I swear the smell last time wasn't me.
1900,3446,2,10,69,81,1.1728395061728396,0.04903426446477902,688,"Sir, I know you're going up, but this is the wrong ride."
1897,3446,3,8,70,81,1.1728395061728396,0.05208647681414566,688,Really nice to see that they finally upgraded the rockets
1894,3446,0,14,67,81,1.1728395061728396,0.04227381152657762,688,"I promise, they said I can keep the suit after the photos."
1762,3446,2,10,69,81,1.1728395061728396,0.04903426446477902,688,I'm sorry but the moon landing was never an option on this elevator
1749,3446,1,12,68,81,1.1728395061728396,0.04577900300676336,688,I forgot my sunglasses in the Cybertruck.
4243,3509,0,15,73,88,1.1704545454545454,0.04031482334670714,688,Fourteen millionth floor please.
199,3510,0,13,64,77,1.1688311688311688,0.0429698800970655,688,Is this seat taken? Gota  long way up.
3861,3510,1,11,65,77,1.1688311688311688,0.0467779231605511,688,I know. I should take the stairs.
3265,3512,0,13,65,78,1.1666666666666667,0.042470599286468784,688,This elevator doesn't even go up to the penthouse.
3357,3512,0,13,65,78,1.1666666666666667,0.042470599286468784,688,Der Mond ist aufgegangen?
3368,3512,2,9,67,78,1.1666666666666667,0.04969660420745535,688,Aren’t you taking your fear of flatulence a little to the extreme?
3240,3512,0,13,65,78,1.1666666666666667,0.042470599286468784,688,"Going up for some Tang?!"""
3412,3512,0,13,65,78,1.1666666666666667,0.042470599286468784,688,Take me through the roof.
3497,3512,1,11,66,78,1.1666666666666667,0.04622501635210242,688,This is as high as we go any higher you have to take the stairs
3449,3512,2,9,67,78,1.1666666666666667,0.04969660420745535,688,...3...2...1...We have liftoff!
3451,3512,0,13,65,78,1.1666666666666667,0.042470599286468784,688,Suit alterations?
3467,3512,1,11,66,78,1.1666666666666667,0.04622501635210242,688,"Yes, this is the Observation Deck"
3505,3512,0,13,65,78,1.1666666666666667,0.042470599286468784,688,"Second floor, sir."
3228,3512,2,9,67,78,1.1666666666666667,0.04969660420745535,688,Please report to management that some of the heat shielding was damaged on my re-entry.
3511,3512,1,11,66,78,1.1666666666666667,0.04622501635210242,688,"The Moon Saloon is to your left, directly across from the Mars Bar."
3444,3512,0,13,65,78,1.1666666666666667,0.042470599286468784,688,I won't miss you.
3217,3512,2,9,67,78,1.1666666666666667,0.04969660420745535,688,Sorry to hear your marriage is so toxic!”
2871,3512,3,7,68,78,1.1666666666666667,0.05294103137220508,688,"I am going to revisit the Grateful Dead song ""Dark Star!"""
3143,3512,0,13,65,78,1.1666666666666667,0.042470599286468784,688,Top floor: final frontier....everybody off!!
2736,3512,2,9,67,78,1.1666666666666667,0.04969660420745535,688,Going up or coming down?
2748,3512,0,13,65,78,1.1666666666666667,0.042470599286468784,688,"This is the express elevator, not SpaceX."
2757,3512,1,11,66,78,1.1666666666666667,0.04622501635210242,688,"Next stop, the Final Frontier"
2858,3512,2,9,67,78,1.1666666666666667,0.04969660420745535,688,10...9...8...7...6...5.....?
3564,3512,0,13,65,78,1.1666666666666667,0.042470599286468784,688,"125, the Oligarch floor, sir."
2873,3512,1,11,66,78,1.1666666666666667,0.04622501635210242,688,"10, 9, 8, 7,............"
2896,3512,0,13,65,78,1.1666666666666667,0.042470599286468784,688,Youv'e Been UP Before ... Wanna Go Down Now ??
2916,3512,0,13,65,78,1.1666666666666667,0.042470599286468784,688,"So,I take it the Mars Colonization is going well,Mr. Musk?"
2945,3512,0,13,65,78,1.1666666666666667,0.042470599286468784,688,Sorry.   This is only a 30 story building.
2952,3512,3,7,68,78,1.1666666666666667,0.05294103137220508,688,"I'm here from OSHA, which way is the West Wing?"
2964,3512,1,11,66,78,1.1666666666666667,0.04622501635210242,688,"I heard your wife call you a space cadet. If I may, sir, I think you're talking it too hard."
3005,3512,2,9,67,78,1.1666666666666667,0.04969660420745535,688,How high do you think this goes?
3040,3512,0,13,65,78,1.1666666666666667,0.042470599286468784,688,I ALWAYS forget my phone.
3084,3512,1,11,66,78,1.1666666666666667,0.04622501635210242,688,Just take me to the roof; I can jump from there.
3127,3512,1,11,66,78,1.1666666666666667,0.04622501635210242,688,It only goes sixteen floors.
3153,3512,4,5,69,78,1.1666666666666667,0.05599779581155972,688,"Did you say I should wait, Sir?"
3569,3512,1,11,66,78,1.1666666666666667,0.04622501635210242,688,Did they really cut the funding for the Space  Progran?
4295,3512,1,11,66,78,1.1666666666666667,0.04622501635210242,688,Be careful when you take that one small step for man.
3679,3512,0,13,65,78,1.1666666666666667,0.042470599286468784,688,Sorry—this only goes to the 21st floor.
2683,3512,0,13,65,78,1.1666666666666667,0.042470599286468784,688,I'm sorry but the highest I can go is the 82nd floor.
5207,3512,0,13,65,78,1.1666666666666667,0.042470599286468784,688,"Terribly sorry sir, I thought it would block smells"
5238,3512,1,11,66,78,1.1666666666666667,0.04622501635210242,688,I never come ill-prepared!
5239,3512,2,9,67,78,1.1666666666666667,0.04969660420745535,688,The observation deck is as close to ‘infinity and beyond’ as i can go.
5186,3512,0,13,65,78,1.1666666666666667,0.042470599286468784,688,Menswear is on four.
5260,3512,0,13,65,78,1.1666666666666667,0.042470599286468784,688,Soft landing
4690,3512,0,13,65,78,1.1666666666666667,0.042470599286468784,688,"One small step for mankind sir, but it's a big one for you"
5174,3512,2,9,67,78,1.1666666666666667,0.04969660420745535,688,"I would ask you, as a joke, if you are going up."
5101,3512,1,11,66,78,1.1666666666666667,0.04622501635210242,688,They called to say they’d pick you up on the roof.
5083,3512,2,9,67,78,1.1666666666666667,0.04969660420745535,688,"I'll do my best, sir."
4986,3512,1,11,66,78,1.1666666666666667,0.04622501635210242,688,"If I say, 'Watch your step,' will that affect my Christmas tip?"
4836,3512,3,7,68,78,1.1666666666666667,0.05294103137220508,688,"Going up?""
""To space? Yeah."
4819,3512,0,13,65,78,1.1666666666666667,0.042470599286468784,688,Was there some gossip I missed.
4663,3512,2,9,67,78,1.1666666666666667,0.04969660420745535,688,"The ""bring me back some honey"" line is wearing a bit thin"
4639,3512,1,11,66,78,1.1666666666666667,0.04622501635210242,688,You can tell the desk that your room doesn't have enough space to suit you ...
4573,3512,3,7,68,78,1.1666666666666667,0.05294103137220508,688,Infestation? I’d call it more of an invasion.
4544,3512,2,9,67,78,1.1666666666666667,0.04969660420745535,688,"Truly sorry, sir, I don't think the outfit will help you with the rarefied atmosphere of the Tower penthouse..."
3751,3512,1,11,66,78,1.1666666666666667,0.04622501635210242,688,It's one small step for Man and one giant leap for New Yorkers
3813,3512,2,9,67,78,1.1666666666666667,0.04969660420745535,688,"Yes, sometimes getting service to ""rocketer"" can be challenging from this floor..."
3819,3512,2,9,67,78,1.1666666666666667,0.04969660420745535,688,The second manhole on your left is the clogged sewer
3912,3512,1,11,66,78,1.1666666666666667,0.04622501635210242,688,"Sure, the brochure said 'to come sleep between the stars', but this is really the highest we can go."
3955,3512,1,11,66,78,1.1666666666666667,0.04622501635210242,688,They said the rooftop view is out of this world.
3981,3512,0,13,65,78,1.1666666666666667,0.042470599286468784,688,'This floor is pressurized.'
3670,3512,1,11,66,78,1.1666666666666667,0.04622501635210242,688,"Yes sir. I still sometimes get that sinking feeling in my stomach. Don’t worry, you’ll get used to it."
4090,3512,1,11,66,78,1.1666666666666667,0.04622501635210242,688,So you mean I might lose my job on Mars?
4216,3512,2,9,67,78,1.1666666666666667,0.04969660420745535,688,Quit staring... there's a reason I took the elevator.
4275,3512,1,11,66,78,1.1666666666666667,0.04622501635210242,688,"Mind the gap;
the First Step IS for Mankind."
4287,3512,1,11,66,78,1.1666666666666667,0.04622501635210242,688,I am either in a gravity field or in an accelerating elevator in outer space. BTW did you see my keys? I
4343,3512,1,11,66,78,1.1666666666666667,0.04622501635210242,688,"The costume party's theme is ""Broken Dreams."""
4406,3512,0,13,65,78,1.1666666666666667,0.042470599286468784,688,I only go to the 6th floor.
4518,3512,0,13,65,78,1.1666666666666667,0.042470599286468784,688,I assume you
4151,3512,1,11,66,78,1.1666666666666667,0.04622501635210242,688,"This is The Langtree, you want the Gantry"
2476,3512,3,7,68,78,1.1666666666666667,0.05294103137220508,688,"I'm sick of going up, take me down, sir."
1624,3512,3,7,68,78,1.1666666666666667,0.05294103137220508,688,"Sorry, rest rooms are for guests, only."
2458,3512,1,11,66,78,1.1666666666666667,0.04622501635210242,688,"I said we only have 12 floors, I didn't say we we're the space station this is a hotel"
1107,3512,2,9,67,78,1.1666666666666667,0.04969660420745535,688,"Sir, air is not too thin on the 100th floor balcony!"
1071,3512,2,9,67,78,1.1666666666666667,0.04969660420745535,688,"To the moon Jimmy, to the moon."
1065,3512,2,9,67,78,1.1666666666666667,0.04969660420745535,688,Are you sure you are on the right planet
916,3512,1,11,66,78,1.1666666666666667,0.04622501635210242,688,2000th Floor?
899,3512,0,13,65,78,1.1666666666666667,0.042470599286468784,688,"Sorry, this elevator goes down"
876,3512,1,11,66,78,1.1666666666666667,0.04622501635210242,688,We only go as high as the 12th floor.
855,3512,0,13,65,78,1.1666666666666667,0.042470599286468784,688,GOING UP!   HOW FAR SIR?
763,3512,1,11,66,78,1.1666666666666667,0.04622501635210242,688,"There is no ""space"" in these elevators these days"
724,3512,1,11,66,78,1.1666666666666667,0.04622501635210242,688,Is this Level Mars?
561,3512,1,11,66,78,1.1666666666666667,0.04622501635210242,688,Tickets are how much?!
541,3512,0,13,65,78,1.1666666666666667,0.042470599286468784,688,"Okay, but there will be a really big tip . . ."
517,3512,3,7,68,78,1.1666666666666667,0.05294103137220508,688,The chair is for Michael Collins after you and Buzz get off.
508,3512,2,9,67,78,1.1666666666666667,0.04969660420745535,688,The front desk can help you with directions.
1194,3512,0,13,65,78,1.1666666666666667,0.042470599286468784,688,Going up. Sky's the limit.
491,3512,1,11,66,78,1.1666666666666667,0.04622501635210242,688,The Moon Walk Lounge is on the left
371,3512,1,11,66,78,1.1666666666666667,0.04622501635210242,688,Anything can be a space walk if you've got enough middle aged whimsy.
3346,3512,2,11,77,90,1.1666666666666667,0.045386397671912215,688,"Up to Mars, sir?"
269,3512,0,13,65,78,1.1666666666666667,0.042470599286468784,688,Enjoy your launch break.
266,3512,1,11,66,78,1.1666666666666667,0.04622501635210242,688,I already warned that a rooftop disco named ‘Space’ would lead to misunderstandings
258,3512,2,9,67,78,1.1666666666666667,0.04969660420745535,688,"To be fair, you didn’t Say you WEREN’T a  bathroom attendant. (M"
226,3512,2,9,67,78,1.1666666666666667,0.04969660420745535,688,Where is my Tesla dude?
214,3512,3,7,68,78,1.1666666666666667,0.05294103137220508,688,wee ad I thought we had budget-cuts!
188,3512,0,13,65,78,1.1666666666666667,0.042470599286468784,688,want you home for _ dinner at 7”
136,3512,3,7,68,78,1.1666666666666667,0.05294103137220508,688,What? It was too cold in  my faux fur coat...
61,3512,2,9,67,78,1.1666666666666667,0.04969660420745535,688,"the indoor pool, Sir"
58,3512,1,11,66,78,1.1666666666666667,0.04622501635210242,688,Sometimes it’s just good to know which way is up.
947,3512,1,13,76,90,1.1666666666666667,0.04254688241805304,688,"Fly me go the moon. I overslept the shutt





Launch me."
1193,3512,4,7,79,90,1.1666666666666667,0.050589533244611136,688,I just needed some space.
467,3512,1,11,66,78,1.1666666666666667,0.04622501635210242,688,My parents were the original anti-vaxxers.
1279,3512,1,11,66,78,1.1666666666666667,0.04622501635210242,688,"I know you're playing Neil Armstrong but give it a rest."""
1168,3512,1,11,66,78,1.1666666666666667,0.04622501635210242,688,"The Honeymoon Suite, please."
1326,3512,1,11,66,78,1.1666666666666667,0.04622501635210242,688,"By the time it gets to my floor, it feels like we should already be to the space station."
2231,3512,1,11,66,78,1.1666666666666667,0.04622501635210242,688,"Level 13...rockets, shuttles & space stations."
2214,3512,0,13,65,78,1.1666666666666667,0.042470599286468784,688,"Yes, my name is Houston.  And no, we do not have a problem!"
2186,3512,1,11,66,78,1.1666666666666667,0.04622501635210242,688,Did she not realize it's me?
2162,3512,2,9,67,78,1.1666666666666667,0.04969660420745535,688,"Up or down please, either works."
2088,3512,0,13,65,78,1.1666666666666667,0.042470599286468784,688,"Which star, sir?"
2071,3512,0,13,65,78,1.1666666666666667,0.042470599286468784,688,"That's one small step, Mr. Armstrong. Have a good day. See ya when you get back."
1992,3512,1,11,66,78,1.1666666666666667,0.04622501635210242,688,It’s really just one small step.
1984,3512,1,11,66,78,1.1666666666666667,0.04622501635210242,688,Be careful.  It's a jungle out there.
1955,3512,1,11,66,78,1.1666666666666667,0.04622501635210242,688,"But, this is the top!"
1934,3512,2,9,67,78,1.1666666666666667,0.04969660420745535,688,"Yes sir, this the top floor!"
2460,3512,3,7,68,78,1.1666666666666667,0.05294103137220508,688,"What floor”
“ moon level”
“ what is that”
“ the moon level stupid”
“ get off"
1320,3512,1,11,66,78,1.1666666666666667,0.04622501635210242,688,"I can't tell you from Col. Glenn, Commander Carpenter. And neither can Mrs. Glenn, the maid tells me."
1881,3512,2,9,67,78,1.1666666666666667,0.04969660420745535,688,"Watch your step, man."
1861,3512,2,9,67,78,1.1666666666666667,0.04969660420745535,688,What you looking at ? Get your iphone 11 out and start shooting away sir- we still have time to make it to the evening news!
1792,3512,2,9,67,78,1.1666666666666667,0.04969660420745535,688,Sorry you took the wrong elevator.
1763,3512,1,11,66,78,1.1666666666666667,0.04622501635210242,688,"Yes, I've heard Trump funded this moon resort out of the NASA budget, but half the profits go to the Klingon Empire, so it's ok."
1758,3512,0,13,65,78,1.1666666666666667,0.042470599286468784,688,"Roof deck, I presume?"
1677,3512,2,9,67,78,1.1666666666666667,0.04969660420745535,688,"3, 2, or 1?"
1670,3512,1,11,66,78,1.1666666666666667,0.04622501635210242,688,"Sir, this elevator doesn't go beyond the 12th floor."
2452,3512,0,13,65,78,1.1666666666666667,0.042470599286468784,688,"Indeed, ma’am, there is more space in the penthouse"
1616,3512,1,11,66,78,1.1666666666666667,0.04622501635210242,688,"One small step for me, one giant leap for my families' penthouse dreams."
1612,3512,1,11,66,78,1.1666666666666667,0.04622501635210242,688,How fast can this elevator get? I'm practicing for my launch tomorrow.
1574,3512,1,11,66,78,1.1666666666666667,0.04622501635210242,688,"Sir,we don’t go that far up."
1544,3512,1,11,66,78,1.1666666666666667,0.04622501635210242,688,I said “up”.
1528,3512,1,11,66,78,1.1666666666666667,0.04622501635210242,688,Take me up to sea level please.
1473,3512,1,11,66,78,1.1666666666666667,0.04622501635210242,688,I’m guessing that NASA cut the training budget again?
1362,3512,0,13,65,78,1.1666666666666667,0.042470599286468784,688,Have a safe flight
1350,3512,1,11,66,78,1.1666666666666667,0.04622501635210242,688,Floor 37 sir. The flat earth convention is just down the hall
2346,3512,1,11,66,78,1.1666666666666667,0.04622501635210242,688,We'll need to stop at the Passport Office on the 110th floor.
2761,3643,1,11,67,79,1.1645569620253164,0.04568487714355834,688,"Sir, this is Hilton."
3421,3643,1,11,67,79,1.1645569620253164,0.04568487714355834,688,What exactly are you supposed to be?
4964,3643,0,13,66,79,1.1645569620253164,0.04198259228297974,688,"I'm more than happy to help you time your jumps, but surely there must be better ways to prepare for zero gravity."
4494,3643,0,13,66,79,1.1645569620253164,0.04198259228297974,688,"That’s 3 small floors up for man, one giant leap for mankind."
4992,3643,2,9,68,79,1.1645569620253164,0.04910883774276407,688,The restroom is straight ahead on your left.
2319,3643,0,13,66,79,1.1645569620253164,0.04198259228297974,688,"It's one small step for man, one giant leap for the 12th floor"
4477,3643,0,13,66,79,1.1645569620253164,0.04198259228297974,688,"Take it from me, they won’t believe you."
1638,3643,0,13,66,79,1.1645569620253164,0.04198259228297974,688,I understand -- what goes up must come down. But why MY elevator?
50,3643,2,9,68,79,1.1645569620253164,0.04910883774276407,688,"Just so you know, all of the jumping was purely for educational purposes."
107,3643,1,11,67,79,1.1645569620253164,0.04568487714355834,688,Top floor please.”
1046,3643,1,11,67,79,1.1645569620253164,0.04568487714355834,688,"Men's room,please"
5163,3654,0,13,67,80,1.1625,0.0415054899525657,688,"You replaced my favorite Sinatra song with elevator music?
Frank Buckley Andover, MA"
3353,3654,1,11,68,80,1.1625,0.04515707466615905,688,Maybe if you pump the gas a bit next time.
1686,3654,0,13,67,80,1.1625,0.0415054899525657,688,"Should I really push the button, or do you want to fake it again?"
823,3654,0,13,67,80,1.1625,0.0415054899525657,688,That's one baby step for mankind
1750,3658,1,10,63,74,1.162162162162162,0.047237758050578095,688,"I'm sorry, this elevator only goes to floor 83,573."
1991,3658,0,12,62,74,1.162162162162162,0.043141308959040406,688,You won't need a mask...
5079,3658,0,12,62,74,1.162162162162162,0.043141308959040406,688,I could've sworn Ms. Phillips said she was dating a deep sea diver.
5271,3658,1,10,63,74,1.162162162162162,0.047237758050578095,688,You know this isn't a real space needle.
5335,3662,3,7,71,81,1.1604938271604939,0.05108933752236682,688,"Hollywood basement, Mr. Armstrong."
3671,3663,0,12,63,75,1.16,0.04261708831227464,688,Are you sure you're in the right place?  We only go to the thirty-first floor.
3157,3663,0,12,63,75,1.16,0.04261708831227464,688,Big meeting this morning?
3203,3663,2,8,65,75,1.16,0.05036801501882853,688,Men's Rooms are on floors 3 and 5.
3788,3663,2,8,65,75,1.16,0.05036801501882853,688,If there’s an emergency at any point just take the stairs.
3276,3663,1,10,64,75,1.16,0.04665379487862243,688,"Sir, Cuomo had the subway craters filled in last night"
3281,3663,1,10,64,75,1.16,0.04665379487862243,688,"I’m definitely going up, no hurry though."
3300,3663,2,8,65,75,1.16,0.05036801501882853,688,Take the lift on the right to transfer floors.
3323,3663,1,10,64,75,1.16,0.04665379487862243,688,One small review for the hotel?
3360,3663,1,10,64,75,1.16,0.04665379487862243,688,"I think you're over reacting to the reports of Legionnaires, sir."
3404,3663,0,12,63,75,1.16,0.04261708831227464,688,I'm the keynote speaker at this year's EarthMom.Org climate change summit.
3408,3663,0,12,63,75,1.16,0.04261708831227464,688,Do they have cabanas on the Swimming Pool floor?
3413,3663,2,8,65,75,1.16,0.05036801501882853,688,"Like I said, finish with “one giant leap for mankind”.  Good luck up there!"
3787,3663,1,10,64,75,1.16,0.04665379487862243,688,"""Gantry? I don't know anybody by that name, sir."""
3655,3663,1,10,64,75,1.16,0.04665379487862243,688,The exosphere elevators are under repair.
3485,3663,2,8,65,75,1.16,0.05036801501882853,688,"...and so you're back. From outer space.
I just walked in to find you here with that sad look upon your face..."
3500,3663,1,10,64,75,1.16,0.04665379487862243,688,"Good protection,  but the impeachment trial is on the next floor"
3508,3663,2,8,65,75,1.16,0.05036801501882853,688,"Space lingerie? That would be rooftop, 3rd orbit to the right."
3728,3663,1,10,64,75,1.16,0.04665379487862243,688,"Sorry,Sir,going down."
3522,3663,0,12,63,75,1.16,0.04261708831227464,688,"Sorry, sir. We don't go up that high."
3579,3663,2,8,65,75,1.16,0.05036801501882853,688,I've been up. Does this go down?
3585,3663,0,12,63,75,1.16,0.04261708831227464,688,"Sorry, we only go as far as 54"
3621,3663,1,10,64,75,1.16,0.04665379487862243,688,No Sir. I don't smell a thing.
3635,3663,0,12,63,75,1.16,0.04261708831227464,688,How tall is this building?
3676,3663,1,10,64,75,1.16,0.04665379487862243,688,It's gonna take me forever to get to Mars.
3482,3663,2,8,65,75,1.16,0.05036801501882853,688,"The Sky Bar is in the 14th floor, sir."
3136,3663,1,10,64,75,1.16,0.04665379487862243,688,"L for Liftoff, please."
3078,3663,0,12,63,75,1.16,0.04261708831227464,688,"This is 'UP.""  You want ""DOWN."""
3099,3663,0,12,63,75,1.16,0.04261708831227464,688,The rocket room is on your right.
3799,3663,2,8,65,75,1.16,0.05036801501882853,688,"Taking that 'space-age bachelor pad' lifestyle to a bit of an extreme, aren't we?"
2639,3663,2,8,65,75,1.16,0.05036801501882853,688,I know this is a skyscraper but that 's going a little too far!
2638,3663,2,8,65,75,1.16,0.05036801501882853,688,"Yes Sir, the Gentlemen's is just a small step down the corridor and a giant leap around the corner."
2607,3663,2,8,65,75,1.16,0.05036801501882853,688,Launchpad access is available on floor 10
2597,3663,0,12,63,75,1.16,0.04261708831227464,688,Are you sure you don’t want the upper atmosphere elevator?
2578,3663,0,12,63,75,1.16,0.04261708831227464,688,"'Get in on the ground floor, but reach for the stars.' Very good, sir."""
2681,3663,0,12,63,75,1.16,0.04261708831227464,688,T-7 seconds to claustrophobia.
2773,3663,0,12,63,75,1.16,0.04261708831227464,688,2nd floor sir? T-minus 100...
2775,3663,2,8,65,75,1.16,0.05036801501882853,688,Let me see how spring is like in jupiter and mars
2789,3663,1,10,64,75,1.16,0.04665379487862243,688,This building only has 40 floors.
2818,3663,0,12,63,75,1.16,0.04261708831227464,688,Penthouse. Going up?
2821,3663,0,12,63,75,1.16,0.04261708831227464,688,"I'm sorry sir, this elevator doesn't service the Fra Mauro."
2824,3663,0,12,63,75,1.16,0.04261708831227464,688,"Going up? To the moon, please!"
2841,3663,1,10,64,75,1.16,0.04665379487862243,688,I forgot my umbrella.
2855,3663,1,10,64,75,1.16,0.04665379487862243,688,I never thought they’d accept me for the Mars colony.
2904,3663,2,8,65,75,1.16,0.05036801501882853,688,I need a breath of bad air to freshen up!
2927,3663,1,10,64,75,1.16,0.04665379487862243,688,"Sir, evacuations won't be necessary for at least a few more years."
2941,3663,1,10,64,75,1.16,0.04665379487862243,688,Top floor I presume?
2574,3663,1,10,64,75,1.16,0.04665379487862243,688,Don’t even.
3011,3663,2,8,65,75,1.16,0.05036801501882853,688,"Prepared to blast off in my '03 Honda Civic. Houston, please set course for the parking garage."
3018,3663,0,12,63,75,1.16,0.04261708831227464,688,We only go to the 48th floor.
3048,3663,1,10,64,75,1.16,0.04665379487862243,688,"Sorry,but you missed NASA's Day Parade"
3055,3663,1,10,64,75,1.16,0.04665379487862243,688,Those 77th floor parties are severely lacking in atmosphere.
3076,3663,3,6,66,75,1.16,0.0538265482573172,688,The sound stage is right this way sir.
3094,3663,3,6,66,75,1.16,0.0538265482573172,688,Trump Towers' VIP Suite is always reserved for members of the Space Force.
3128,3663,2,8,65,75,1.16,0.05036801501882853,688,Which stage ma'm?
3816,3663,2,8,65,75,1.16,0.05036801501882853,688,I think you want the Penthouse Elevator.
4802,3663,3,6,66,75,1.16,0.0538265482573172,688,"You must have come down several thousand floors, if you made it all the way to the top floor of the Empire State Building."
3887,3663,0,12,63,75,1.16,0.04261708831227464,688,"I'm sorry, this is as high as we go."
4655,3663,1,10,64,75,1.16,0.04665379487862243,688,"No, only Willy Wonka has one of those..."
4666,3663,0,12,63,75,1.16,0.04261708831227464,688,This one's going down...I think you want the one going up.
4698,3663,1,10,64,75,1.16,0.04665379487862243,688,Are you here to check out the office space?
4718,3663,1,10,64,75,1.16,0.04665379487862243,688,"You know you can't get a head start like this, right?"
4745,3663,1,10,64,75,1.16,0.04665379487862243,688,"The penthouse is that high, huh?"
4749,3663,1,10,64,75,1.16,0.04665379487862243,688,"Fourth floor...women's shoes, men's sport coats...Tang."
4756,3663,1,10,64,75,1.16,0.04665379487862243,688,May I please see your Green Card?
4853,3663,1,10,64,75,1.16,0.04665379487862243,688,Please tell me your going to a Halloween party.
4895,3663,1,10,64,75,1.16,0.04665379487862243,688,"This isn't a space elevator, fuckwit."
4977,3663,2,8,65,75,1.16,0.05036801501882853,688,This elevator doesn't go that far.
4997,3663,1,10,64,75,1.16,0.04665379487862243,688,"Guard-Sorry, not interested in changing places, off you go to Mars!
Astronaut-Just a last minute try!"
5345,3663,0,12,63,75,1.16,0.04261708831227464,688,The Sixtyfourth’d
5037,3663,2,8,65,75,1.16,0.05036801501882853,688,How's the air out there?
5061,3663,1,10,64,75,1.16,0.04665379487862243,688,I'm sorry sir but this is the suborbital elevator.
5116,3663,1,10,64,75,1.16,0.04665379487862243,688,The front desk is 10 small steps or one giant leap away.
5136,3663,1,10,64,75,1.16,0.04665379487862243,688,Welcome to the land of no personal space.
5188,3663,1,10,64,75,1.16,0.04665379487862243,688,"Ever since they retired the Space Shuttles, getting off the ground isn't half as exciting as the good old days."
5189,3663,1,10,64,75,1.16,0.04665379487862243,688,But how will I get back down?
5194,3663,1,10,64,75,1.16,0.04665379487862243,688,"Yes, I'm sure this is the top floor."
5315,3663,2,8,65,75,1.16,0.05036801501882853,688,"Sorry sir, the elevator doesn't go that far up"
5285,3663,3,6,66,75,1.16,0.0538265482573172,688,I need more space too sometimes.
5253,3663,2,8,65,75,1.16,0.05036801501882853,688,"Oops, wrong elevator!"
5205,3663,2,8,65,75,1.16,0.05036801501882853,688,Your space ship must be waiting outside.
2569,3663,0,12,63,75,1.16,0.04261708831227464,688,Password is: 13th floor space capsule please...
5208,3663,2,8,65,75,1.16,0.05036801501882853,688,"You do know this the wrong elevator, don't you?"
4608,3663,2,8,65,75,1.16,0.05036801501882853,688,Please take one small step and get off my elevator.
4568,3663,2,8,65,75,1.16,0.05036801501882853,688,"Yes doctor, Nurse Frazier said the shark is prepped."
4566,3663,1,10,64,75,1.16,0.04665379487862243,688,Ionosphere?  Try the Intrepid at Pier 86.
4561,3663,1,10,64,75,1.16,0.04665379487862243,688,Will you have pain if I go up too fast?
3906,3663,2,8,65,75,1.16,0.05036801501882853,688,Our top floor is 23.
3925,3663,2,8,65,75,1.16,0.05036801501882853,688,"So you want me to say, '3-2-1 Blast-off' before pressing the Up button?"
3970,3663,2,8,65,75,1.16,0.05036801501882853,688,Going out for some fresh air today sir?
3992,3663,1,10,64,75,1.16,0.04665379487862243,688,Ever since Space Force rented space in Trump Tower I feel a bit silly asking if you're going up
3993,3663,2,8,65,75,1.16,0.05036801501882853,688,"Penthouse, I presume..."
3996,3663,0,12,63,75,1.16,0.04261708831227464,688,"Down, sir?? Well, if you insist."
4013,3663,0,12,63,75,1.16,0.04261708831227464,688,Your rocket is set to blast off !
4033,3663,3,6,66,75,1.16,0.0538265482573172,688,"Fifth, fourth, third, second, first?"
4036,3663,2,8,65,75,1.16,0.05036801501882853,688,The Eagle has landed.
4057,3663,1,10,64,75,1.16,0.04665379487862243,688,Moonwares is to your left just past time travel.
4089,3663,1,10,64,75,1.16,0.04665379487862243,688,"Have a safe trip back to Mars, sir! We'll see you again in two years."
4129,3663,2,8,65,75,1.16,0.05036801501882853,688,"To be , or not to be , that is the question !"
3879,3663,1,10,64,75,1.16,0.04665379487862243,688,... Should I be wearing a suit!?
4182,3663,1,10,64,75,1.16,0.04665379487862243,688,"So, my elevator nightmare is real?"
4227,3663,2,8,65,75,1.16,0.05036801501882853,688,"Housewares, men's fashions, or low earth orbit?"
4229,3663,2,8,65,75,1.16,0.05036801501882853,688,I've also never seen a chair in an elevator before.
4234,3663,0,12,63,75,1.16,0.04261708831227464,688,"If there is a fire alarm, don't use the elevator, use your jet pack."
4245,3663,1,10,64,75,1.16,0.04665379487862243,688,"Could you speak up, Sir?"
4320,3663,2,8,65,75,1.16,0.05036801501882853,688,"One small step for a man, one giant leap for an elevator cab"
4334,3663,2,8,65,75,1.16,0.05036801501882853,688,I’m sorry sir but this IS the last floor.
4409,3663,1,10,64,75,1.16,0.04665379487862243,688,"20,108th story"
4431,3663,0,12,63,75,1.16,0.04261708831227464,688,"5, 4, 3, 2, 1, Penthouse."
4437,3663,1,10,64,75,1.16,0.04665379487862243,688,"Traffic was heavy, okay. Now please do as I ask, push the button to the penthouse, hold down the door closed button and hang on when we screech to a stop."
4484,3663,0,12,63,75,1.16,0.04261708831227464,688,Where's the valet?
4520,3663,2,8,65,75,1.16,0.05036801501882853,688,I'll just put in floor 100000000000 and see what happens.
4552,3663,0,12,63,75,1.16,0.04261708831227464,688,I’m sorry to say this elevator does not go any farther than the penthouse
4193,3663,1,10,64,75,1.16,0.04665379487862243,688,"98,560,881, please."
2563,3663,1,10,64,75,1.16,0.04665379487862243,688,"Let’s just say, cleaning the bathroom was a bigger mission than anticipated. #blastoff"
261,3663,0,12,63,75,1.16,0.04261708831227464,688,"Floor 1,326,785 please"
2516,3663,1,10,64,75,1.16,0.04665379487862243,688,"1,999th   floor - Space Station"
940,3663,0,12,63,75,1.16,0.04261708831227464,688,I was sure the small would fit. Maybe I should take the stairs.
978,3663,2,8,65,75,1.16,0.05036801501882853,688,"I’m sorry sir,  but this elevator only goes to the troposhere."
987,3663,1,10,64,75,1.16,0.04665379487862243,688,"Yes, mam, an umbrella is definitely required today."
991,3663,0,12,63,75,1.16,0.04261708831227464,688,"Ok then, you’re going to want to grab a seat."
1038,3663,0,12,63,75,1.16,0.04261708831227464,688,The suite is out of this world
1082,3663,0,12,63,75,1.16,0.04261708831227464,688,"You need to take the ""Express"""
1117,3663,1,10,64,75,1.16,0.04665379487862243,688,"Oh, my mistake. You did say up."
1122,3663,1,10,64,75,1.16,0.04665379487862243,688,"Well, they say dress for the job you want."
1126,3663,1,10,64,75,1.16,0.04665379487862243,688,"No, we didn't orbit anything and that's a wedding reception not a parade on the mezzanine."
1185,3663,1,10,64,75,1.16,0.04665379487862243,688,How high is up?
1240,3663,0,12,63,75,1.16,0.04261708831227464,688,Penthouse?
862,3663,2,8,65,75,1.16,0.05036801501882853,688,No... I will not take one giant step.
1249,3663,0,12,63,75,1.16,0.04261708831227464,688,"there's one small step there, man"
1272,3663,2,8,65,75,1.16,0.05036801501882853,688,The Honeymoon Suite?
1309,3663,1,10,64,75,1.16,0.04665379487862243,688,I can only take you as high as the penthouse.
1312,3663,0,12,63,75,1.16,0.04261708831227464,688,"26,000th floor!  Watch your step."
1325,3663,2,8,65,75,1.16,0.05036801501882853,688,"Welcome to the moon. Due to climate change, you’ll no longer need that attire."
1356,3663,1,10,64,75,1.16,0.04665379487862243,688,And this is the top floor. Women’s wear and you won’t find Tang here either.
1364,3663,2,8,65,75,1.16,0.05036801501882853,688,Are you all right? You look a bit spacey.
1372,3663,2,8,65,75,1.16,0.05036801501882853,688,"It's not exactly the final frontier, but it is the penthouse."
1397,3663,0,12,63,75,1.16,0.04261708831227464,688,"Top floor, sir?"
1408,3663,1,10,64,75,1.16,0.04665379487862243,688,I can get you as far as the 22 floor. After that you're on your own.
2533,3663,1,10,64,75,1.16,0.04665379487862243,688,"We only go as high as the 12th floor, sir."
1435,3663,2,8,65,75,1.16,0.05036801501882853,688,"It's bad out there today, Madam. I hope this the updated model you're wearing."
1262,3663,1,10,64,75,1.16,0.04665379487862243,688,I only can go at home.
1444,3663,1,10,64,75,1.16,0.04665379487862243,688,"Break a leg, Mrs. Maisel!"
848,3663,1,10,64,75,1.16,0.04665379487862243,688,"Yes, your room has plenty of space, Sir."
798,3663,1,10,64,75,1.16,0.04665379487862243,688,Is it true that these new penthouse suites are spacious?
11,3663,1,10,64,75,1.16,0.04665379487862243,688,Where is Greta Thunberg? I need her out there with me next time!
66,3663,0,12,63,75,1.16,0.04261708831227464,688,"Stratosphere, please"
128,3663,1,10,64,75,1.16,0.04665379487862243,688,It wasn’t me I swear.
131,3663,1,10,64,75,1.16,0.04665379487862243,688,"As the bell hop pressed the button to close the elevator door, he looked back and suddenly I realized the gravity of the  Situation."
219,3663,1,10,64,75,1.16,0.04665379487862243,688,you need to stop taking your work home with  yo
232,3663,1,10,64,75,1.16,0.04665379487862243,688,Is this the way to the moon landing set?
279,3663,1,10,64,75,1.16,0.04665379487862243,688,"Not quite the weather forecast yet, but better safe than sorry."
323,3663,2,8,65,75,1.16,0.05036801501882853,688,"I could set my watch by your afternoon space walk, sir."
331,3663,0,12,63,75,1.16,0.04261708831227464,688,Where to sir: low earth orbit
343,3663,0,12,63,75,1.16,0.04261708831227464,688,"Welcome to Vegas, Commander. Is this your first time experiencing The Stratosphere?"
380,3663,1,10,64,75,1.16,0.04665379487862243,688,"Sorry, this is as far as we go."
831,3663,1,10,64,75,1.16,0.04665379487862243,688,I’d ask you for a hug but I just took a shower.
424,3663,2,8,65,75,1.16,0.05036801501882853,688,'First Man' - This is the First Floor!  I've been waiting to say that my whole life.
446,3663,1,10,64,75,1.16,0.04665379487862243,688,Complaints?
514,3663,0,12,63,75,1.16,0.04261708831227464,688,I think you got on the wrong elevator.
553,3663,0,12,63,75,1.16,0.04261708831227464,688,"Sir thisvis the Moon Tower, but I think you got it wrong!"
580,3663,0,12,63,75,1.16,0.04261708831227464,688,"Jim, I swear, if you ask ‘Going up?’ one more time."
604,3663,2,8,65,75,1.16,0.05036801501882853,688,"If you want to go that far up, you really should take the express elevator across the lobby."
607,3663,0,12,63,75,1.16,0.04261708831227464,688,"We all try to relive our glory days, one way or another."
651,3663,1,10,64,75,1.16,0.04665379487862243,688,"Okay, have it your way - one giant leap for mankind."
703,3663,2,8,65,75,1.16,0.05036801501882853,688,"Second floor, perfumes and cosmetics."
717,3663,1,10,64,75,1.16,0.04665379487862243,688,"The 1,453,786th floor please."
767,3663,2,8,65,75,1.16,0.05036801501882853,688,"Coming back from your trip to the moon,eh? apollo 11?"
787,3663,1,10,64,75,1.16,0.04665379487862243,688,Have you seen Alexa!?
434,3663,1,10,64,75,1.16,0.04665379487862243,688,Surely a rocket would be faster.
1448,3663,2,8,65,75,1.16,0.05036801501882853,688,"Be back in five, going to get some more romaine lettuce."
1429,3663,1,10,64,75,1.16,0.04665379487862243,688,"Saturn, please."
1510,3663,1,10,64,75,1.16,0.04665379487862243,688,What? I missed my flight.
1507,3663,1,10,64,75,1.16,0.04665379487862243,688,One gigaparsec please
2089,3663,1,10,64,75,1.16,0.04665379487862243,688,Thought I'd start off this way since I get airsick
2090,3663,1,10,64,75,1.16,0.04665379487862243,688,"You feel that tingling, that's the tension before liftoff."
2104,3663,1,10,64,75,1.16,0.04665379487862243,688,Would you like me to do the ‘countdown’ thing?
2110,3663,0,12,63,75,1.16,0.04261708831227464,688,"Well, at least tomorrow’s Friday."
2111,3663,0,12,63,75,1.16,0.04261708831227464,688,"Bespoke tailoring is to your left, first door on the right."
2114,3663,1,10,64,75,1.16,0.04665379487862243,688,"Just checking, are you sure you meant to say, “Down?”"
2137,3663,1,10,64,75,1.16,0.04665379487862243,688,"First I have to do the countdown...10, 9, 8......"
2151,3663,0,12,63,75,1.16,0.04261708831227464,688,I value my privacy
2174,3663,0,12,63,75,1.16,0.04261708831227464,688,"I'm not sure the investors are going to like this, Mr. Musk."
2181,3663,1,10,64,75,1.16,0.04665379487862243,688,"Sorry,giant leaps are on the 12th floor."
2056,3663,4,4,67,75,1.16,0.05707589384019892,688,"One small step for man, one giant step for Henry 
Klein."""
2221,3663,1,10,64,75,1.16,0.04665379487862243,688,25th floor is the highest I can go.
2263,3663,1,10,64,75,1.16,0.04665379487862243,688,"I don't know what you mean by 'deep state,' but this is as far down as I can take you."""
2264,3663,0,12,63,75,1.16,0.04261708831227464,688,NO. This time I'm going down.
2303,3663,1,10,64,75,1.16,0.04665379487862243,688,Flu season's started?
2315,3663,0,12,63,75,1.16,0.04261708831227464,688,"Thank you for following our new smoking policy, sir."
2332,3663,1,10,64,75,1.16,0.04665379487862243,688,"What floor Mr. President?"" ... ""Take me to the Fake News room."
2386,3663,1,10,64,75,1.16,0.04665379487862243,688,Is it safe?
2390,3663,0,12,63,75,1.16,0.04261708831227464,688,We can't go that far up.
2444,3663,2,8,65,75,1.16,0.05036801501882853,688,"You wanted the blast off floor,right?"
2457,3663,1,10,64,75,1.16,0.04665379487862243,688,"Sir, I think you are looking for a different pad."
2461,3663,0,12,63,75,1.16,0.04261708831227464,688,I understand budget cuts - but my elevator can’t get you to zero gravity.
2490,3663,0,12,63,75,1.16,0.04261708831227464,688,The lander was broken so I took the elevator.
2233,3663,2,8,65,75,1.16,0.05036801501882853,688,"“No really, it’s just one small step.”"
2029,3663,1,10,64,75,1.16,0.04665379487862243,688,Is the planetarium still open?
2082,3663,0,12,63,75,1.16,0.04261708831227464,688,"Sorry, we don't go that high."
1974,3663,1,10,64,75,1.16,0.04665379487862243,688,Excuse me sir but the Halloween party was in October...
1705,3663,0,12,63,75,1.16,0.04261708831227464,688,"Sir, the atmosphere is not a floor."
1588,3663,1,10,64,75,1.16,0.04665379487862243,688,First floor.  Perfumes and cosmetics.
1708,3663,1,10,64,75,1.16,0.04665379487862243,688,"Yes, all the way up...but you have to give me a 10 second count-down before you actually press the button."
1733,3663,1,10,64,75,1.16,0.04665379487862243,688,"Sir, this is a bank."
1571,3663,3,6,66,75,1.16,0.0538265482573172,688,She's in apt. 37. Good luck and I'm sure the cameras won't get you.
1736,3663,0,12,63,75,1.16,0.04261708831227464,688,"Unfortunately sir, Man has already stepped off on every floor in this building."
2023,3663,0,12,63,75,1.16,0.04261708831227464,688,Is this the third Stone from the Sun?
1813,3663,3,6,66,75,1.16,0.0538265482573172,688,"No sir, you did not travel to infinity and beyond. This is just the ground floor."
1831,3663,0,12,63,75,1.16,0.04261708831227464,688,The casting call said “Astronaut type”.
1854,3663,0,12,63,75,1.16,0.04261708831227464,688,"In this city, there is no air if I can’t see it."
1659,3663,2,8,65,75,1.16,0.05036801501882853,688,Going way way way way up?
1860,3663,0,12,63,75,1.16,0.04261708831227464,688,"You going way, way up?"
1536,3663,1,10,64,75,1.16,0.04665379487862243,688,ARE YOU SURE THIS IS HOW YOU START TO GET OVER YOUR FEAR OF HEIGHTS?
1905,3663,0,12,63,75,1.16,0.04261708831227464,688,"No sir, I don't have any Kleenex."
1910,3663,2,8,65,75,1.16,0.05036801501882853,688,"No, Sir. This is not the launch pad floor."
1919,3663,1,10,64,75,1.16,0.04665379487862243,688,No more steps for Mankind.  Twelfth floor please.
1921,3663,0,12,63,75,1.16,0.04261708831227464,688,You mean that lady across the hall really is contagious?
1938,3663,0,12,63,75,1.16,0.04261708831227464,688,"One small step for man, one working elevator for the building"
1949,3663,0,12,63,75,1.16,0.04261708831227464,688,"I’m sorry sir, this car only goes to the stratosphere"
1965,3663,2,8,65,75,1.16,0.05036801501882853,688,"Yes, sir. I made sure your Uber has a moonroof."
1511,3663,2,8,65,75,1.16,0.05036801501882853,688,Fifth Floor please.  5A is still having problems with her shower.
1872,3663,1,10,64,75,1.16,0.04665379487862243,688,"I'm scared of mosquitoes, Only mosquitoes."""
1690,3663,0,12,63,75,1.16,0.04261708831227464,688,Is this the right shuttle?
1745,3886,1,10,65,76,1.1578947368421053,0.0460839492511007,688,36th floor at 7 G’s please
3773,3886,0,12,64,76,1.1578947368421053,0.04210526315789474,688,The building manager says it will be some time before this elevator reaches Mars.
4900,3886,0,12,64,76,1.1578947368421053,0.04210526315789474,688,"Yes, sir, there is space for rent on this floor."
3591,3886,1,10,65,76,1.1578947368421053,0.0460839492511007,688,"We're not going up that far, sir."
4157,3886,0,12,64,76,1.1578947368421053,0.04210526315789474,688,"Year 2049
- Sir, this is the floor of planet Earth. Make sure your clothes are cool and your oxygen lasts for the entire stay. If you're not satisfied, pick up the time phone and feel free to call previous generations and make your complaints."
2627,3886,1,10,65,76,1.1578947368421053,0.0460839492511007,688,"Penthouse, and quick -- I'm late for a mission."
1925,3886,0,15,80,95,1.1578947368421053,0.03760997900055245,688,"I'm sorry, ma'am - this is 11-19. 20000-30000 is around the corner."
5130,3893,2,8,67,77,1.155844155844156,0.04913793781438531,688,"Well, as long as you are asking, you may be a tad overdressed for the eleventh floor."
2702,3893,1,10,66,77,1.155844155844156,0.04552772158797496,688,"That's one small step on linoleum, one giant slip for the webcam."
4399,3893,0,12,65,77,1.155844155844156,0.04160540750111606,688,It’s my circular breathing suit after Elvis and intelligent oxygen have left the building.
3150,3896,1,12,77,90,1.1555555555555554,0.04154059161636941,688,"Sorry, which floor was it again? So anyway, Kubrick felt so guilty about deceiving the world that he dropped a bunch of hints about his involvement all throughout The Shining. There are plenty of YouTube videos on this if you've got the time."
1769,3897,1,9,61,71,1.1549295774647887,0.0476738049630549,688,"Sorry, did you say 23rd floor or 23rd century?"
1816,3897,1,9,61,71,1.1549295774647887,0.0476738049630549,688,SpaceX installed this new button in the Wonka factory elevator?
4194,3897,0,11,60,71,1.1549295774647887,0.04324785766640781,688,These NASA budget cuts are getting out of hand
4259,3897,0,11,60,71,1.1549295774647887,0.04324785766640781,688,"I'm sorry, but we do not have an ""Aether"" button."
3299,3901,1,9,62,72,1.1527777777777777,0.04705623039870244,688,"Fourth floor. Sporting goods, ladies lingerie. Kind of the same thing."
3309,3901,3,5,64,72,1.1527777777777777,0.05474268382893093,688,"Will you be exploring the penthouse again this evening, sir?"
3317,3901,0,11,61,72,1.1527777777777777,0.0426972190266123,688,Launch me...full throttle.
3361,3901,2,7,63,72,1.1527777777777777,0.051044344702082634,688,"Houston, this guy doesn't know where the 5th floor is.."
3386,3901,1,9,62,72,1.1527777777777777,0.04705623039870244,688,"This is ground control to Major Tom; I think we have arrived. Now it's time to leave the lift, if you dare!...This is major Tom to ground control; I'm stepping through the door."
3403,3901,1,9,62,72,1.1527777777777777,0.04705623039870244,688,Infiniti and beyond? I'm afraid this only goes up to sixteen.
3406,3901,0,11,61,72,1.1527777777777777,0.0426972190266123,688,I'm sure your room will have enough space.
3414,3901,2,7,63,72,1.1527777777777777,0.051044344702082634,688,"Look out, Sir . .Ma'am? .  .for Captain Space Farce . .He's tougher than he looks . . ."
3455,3901,1,9,62,72,1.1527777777777777,0.04705623039870244,688,Since when did hotels start charging for oxygen?
3478,3901,0,11,61,72,1.1527777777777777,0.0426972190266123,688,Going up and out there?
3519,3901,2,7,63,72,1.1527777777777777,0.051044344702082634,688,Did you fly into this space?
3543,3901,0,11,61,72,1.1527777777777777,0.0426972190266123,688,"Wow, you're the latest free agent signing by the Astros?"
3582,3901,0,11,61,72,1.1527777777777777,0.0426972190266123,688,"I’m sorry, sir--this is as high as we can go in this building.”"
3593,3901,2,7,63,72,1.1527777777777777,0.051044344702082634,688,This is embarrassing. My lanyard was in here the whole time.
3600,3901,0,11,61,72,1.1527777777777777,0.0426972190266123,688,What Planet?
3638,3901,0,11,61,72,1.1527777777777777,0.0426972190266123,688,sorry Mr. Bezos - perhaps the up button this time?
3741,3901,3,5,64,72,1.1527777777777777,0.05474268382893093,688,13th floor sir...
3746,3901,0,11,61,72,1.1527777777777777,0.0426972190266123,688,"Sir, we only go up to the penthouse."
3822,3901,1,9,62,72,1.1527777777777777,0.04705623039870244,688,The staircase is a giant leap for mankind.
3825,3901,0,11,61,72,1.1527777777777777,0.0426972190266123,688,I too used to be over the moon for the lady on that floor!
3847,3901,1,9,62,72,1.1527777777777777,0.04705623039870244,688,"Floor 92,955,807."
3852,3901,0,11,61,72,1.1527777777777777,0.0426972190266123,688,Fifth floor. Ladies lingerie.
3293,3901,3,5,64,72,1.1527777777777777,0.05474268382893093,688,New York thinks it is the most fun city in the world and maybe it used to be. I think Sao Paolo. What do you think?
3266,3901,0,11,61,72,1.1527777777777777,0.0426972190266123,688,I can either play pretend or admit to my wife I blew all our savings
3236,3901,2,7,63,72,1.1527777777777777,0.051044344702082634,688,"Look...I’m happy to take you to our leader, but first I need to see your Real ID compliant card.”"
3227,3901,2,7,63,72,1.1527777777777777,0.051044344702082634,688,I'm avoiding my flu shot this year.
2703,3901,2,7,63,72,1.1527777777777777,0.051044344702082634,688,"Yes, sir. 'G' is for geostationary."
2723,3901,1,9,62,72,1.1527777777777777,0.04705623039870244,688,Spatial awareness training.
2764,3901,1,9,62,72,1.1527777777777777,0.04705623039870244,688,I got tired of taking small steps.
2793,3901,2,7,63,72,1.1527777777777777,0.051044344702082634,688,Elon recommended some practice before the trip
2794,3901,2,7,63,72,1.1527777777777777,0.051044344702082634,688,"One billionth floor, please."
2806,3901,2,7,63,72,1.1527777777777777,0.051044344702082634,688,"No, ma'am. The bathroom is to the left."
2833,3901,1,9,62,72,1.1527777777777777,0.04705623039870244,688,"12th floor.  Shoes, ladies lingerie, and Mars."
2839,3901,1,9,62,72,1.1527777777777777,0.04705623039870244,688,"Oh, is that what they mean by space capacity?"
2853,3901,2,7,63,72,1.1527777777777777,0.051044344702082634,688,"I think you're overdressed in that space suit, sir.  This is only a 10 story building.  Pressurization is not required, even on the top floor!"
2857,3901,1,9,62,72,1.1527777777777777,0.04705623039870244,688,"If I wanted to see my grandkid, it was either this or get the DTaP vaccine."
2876,3901,0,11,61,72,1.1527777777777777,0.0426972190266123,688,"The penthouse, if you please."
2881,3901,0,11,61,72,1.1527777777777777,0.0426972190266123,688,"No, sir.  ""Going Down"" was a statement, not a question."
2887,3901,0,11,61,72,1.1527777777777777,0.0426972190266123,688,"Sorry, sir, this is as far down as we go."
2898,3901,0,11,61,72,1.1527777777777777,0.0426972190266123,688,"Third floor, perfume samples..."
2905,3901,2,7,63,72,1.1527777777777777,0.051044344702082634,688,"This elevator only goes to 120th floor, the Space Elevator hasn’t been built yet Colonel!!!!"
2919,3901,2,7,63,72,1.1527777777777777,0.051044344702082634,688,"Did you forget your medicine again, sir?"
2951,3901,0,11,61,72,1.1527777777777777,0.0426972190266123,688,"Remember to take your lunch, Sir?"
2959,3901,2,7,63,72,1.1527777777777777,0.051044344702082634,688,10th floor.....perfumes and colognes
2971,3901,1,9,62,72,1.1527777777777777,0.04705623039870244,688,"90,082,457th Floor"
2990,3901,0,11,61,72,1.1527777777777777,0.0426972190266123,688,"Sorry, I can’t take you as high as you need to go."
3012,3901,0,11,61,72,1.1527777777777777,0.0426972190266123,688,the launching pad to your capsule is across the street
3026,3901,0,11,61,72,1.1527777777777777,0.0426972190266123,688,The smog isn't that bad...
3056,3901,0,11,61,72,1.1527777777777777,0.0426972190266123,688,Thats one small step for man... and one giant leap in everyone's expectations at my High School reunion.
3083,3901,0,11,61,72,1.1527777777777777,0.0426972190266123,688,"Sir, we only have 22 floors."
3208,3901,1,9,62,72,1.1527777777777777,0.04705623039870244,688,"I think you'll have no trouble blasting off from here, Sir."
3864,3901,0,11,61,72,1.1527777777777777,0.0426972190266123,688,"The penthouse is as high as we go,Sir."
3899,3901,1,9,62,72,1.1527777777777777,0.04705623039870244,688,I'm moving into a new space.
3986,3901,1,9,62,72,1.1527777777777777,0.04705623039870244,688,"*muffled* ""23 please...I only do 1 small step"""
418,3901,2,7,63,72,1.1527777777777777,0.051044344702082634,688,"And please stop calling me ""Houston."""
4582,3901,1,9,62,72,1.1527777777777777,0.04705623039870244,688,The penthouse views in this building are out of this world!
4661,3901,0,11,61,72,1.1527777777777777,0.0426972190266123,688,The penthouse still had oxygen the last time I was up there...
4664,3901,2,7,63,72,1.1527777777777777,0.051044344702082634,688,"There's always a higher floor, Steve. Keep going."
4734,3901,1,9,62,72,1.1527777777777777,0.04705623039870244,688,"Mezzanine - Sky, Moon, and Stars"
4784,3901,1,9,62,72,1.1527777777777777,0.04705623039870244,688,You still owe me a Christmas tip.
4785,3901,2,7,63,72,1.1527777777777777,0.051044344702082634,688,But I only go up to the 37th floor!
4796,3901,0,11,61,72,1.1527777777777777,0.0426972190266123,688,"I don't have to ask, going up"
4810,3901,0,11,61,72,1.1527777777777777,0.0426972190266123,688,Aren’t you going a tad higher than the forty-third floor?
4855,3901,1,9,62,72,1.1527777777777777,0.04705623039870244,688,Your Louis XVI bedroom with the luminous floor is down the hall to your right.
4867,3901,1,9,62,72,1.1527777777777777,0.04705623039870244,688,"What do you mean, ""no roof access""?"
4875,3901,0,11,61,72,1.1527777777777777,0.0426972190266123,688,"NASA's G-Force simulator is broken, how many G's does this thing do?"
4579,3901,0,11,61,72,1.1527777777777777,0.0426972190266123,688,We'll make it back...  One small step at a time.
4962,3901,1,9,62,72,1.1527777777777777,0.04705623039870244,688,"8297th floor, men's jetpacks."
5010,3901,0,11,61,72,1.1527777777777777,0.0426972190266123,688,This is what I shot for the moon for? 5 freaking stars?! I'd like to speak to your manager!
5217,3901,1,9,62,72,1.1527777777777777,0.04705623039870244,688,Me taking you above the penthouse would be an unknown story.
5187,3901,1,9,62,72,1.1527777777777777,0.04705623039870244,688,All you need to get started is to take one small step.
5178,3901,2,7,63,72,1.1527777777777777,0.051044344702082634,688,Who's Houston? And what problem?!
5170,3901,0,11,61,72,1.1527777777777777,0.0426972190266123,688,"I'm going up, up & away!"
5131,3901,0,11,61,72,1.1527777777777777,0.0426972190266123,688,"Sorry sir, the 45th floor is as high as I can make this one go."
5025,3901,0,11,61,72,1.1527777777777777,0.0426972190266123,688,"I'm sorry sir, escape velocity is only available for our penthouse guests."
5241,3901,1,9,62,72,1.1527777777777777,0.04705623039870244,688,It helps me avoid making eye contact.
5251,3901,1,9,62,72,1.1527777777777777,0.04705623039870244,688,Must we count down every time?
2584,3901,1,9,62,72,1.1527777777777777,0.04705623039870244,688,The Mos Eisley cantina is on your left. I hope you are able to hire a starship crew. Just be careful.
5257,3901,0,11,61,72,1.1527777777777777,0.0426972190266123,688,"Have a giant leap for mankind today, sir."
4988,3901,1,9,62,72,1.1527777777777777,0.04705623039870244,688,"Sorry, there is no 18,000,000th floor."
3967,3901,0,11,61,72,1.1527777777777777,0.0426972190266123,688,"For the Moon ; you continue to the next elevator on your right, then you take the next one, and so on until you have reached the so called Moon."
4548,3901,0,11,61,72,1.1527777777777777,0.0426972190266123,688,SO unhealthy for most persons!
4478,3901,1,9,62,72,1.1527777777777777,0.04705623039870244,688,"Despite his work, I'm no fan of David Bowie."
4004,3901,1,9,62,72,1.1527777777777777,0.04705623039870244,688,"Lingerie, pajamas, air"
4035,3901,2,7,63,72,1.1527777777777777,0.051044344702082634,688,"JPL budget cuts have been a real bitch, huh?"
4062,3901,1,9,62,72,1.1527777777777777,0.04705623039870244,688,"I’m sorry, sir, this as high as we can go."
4086,3901,1,9,62,72,1.1527777777777777,0.04705623039870244,688,Working hard or hardly working??? Hahah just kidding. What floor?
4116,3901,0,11,61,72,1.1527777777777777,0.0426972190266123,688,"Ten seconds to lift-off...nine, eight, seven..."
4188,3901,2,7,63,72,1.1527777777777777,0.051044344702082634,688,We don't elevate fast enough to send you into orbit.
4202,3901,0,11,61,72,1.1527777777777777,0.0426972190266123,688,"Hey diddle diddle, the cat and the fiddle, the cow jumped over the........ c’mon you got this!"
4208,3901,1,9,62,72,1.1527777777777777,0.04705623039870244,688,I may be a tad too proud but I think you will find our hotel to be out of this world.
4213,3901,1,9,62,72,1.1527777777777777,0.04705623039870244,688,This is the Apollo Hotel what were you expecting.
4238,3901,0,11,61,72,1.1527777777777777,0.0426972190266123,688,Looks like the rocket didn't work.
4250,3901,1,9,62,72,1.1527777777777777,0.04705623039870244,688,"Sorry, was that ""seven"" or ""Saturn""? It was a bit muffled."
4483,3901,1,9,62,72,1.1527777777777777,0.04705623039870244,688,"The ghost is in the Ballroom to the left, several of the Ghostbusters are here already."
4252,3901,2,7,63,72,1.1527777777777777,0.051044344702082634,688,See you in twenty-two months.
4317,3901,0,11,61,72,1.1527777777777777,0.0426972190266123,688,I suggest you ste out: On the way down I'll be practicing weightessness
4319,3901,3,5,64,72,1.1527777777777777,0.05474268382893093,688,"I want to, but it quit being one small step after the hip replacement."
4323,3901,2,7,63,72,1.1527777777777777,0.051044344702082634,688,"This elevator doesn’t go all the way up, sir.  You’ll need to change at the 95-th floor."
4344,3901,1,9,62,72,1.1527777777777777,0.04705623039870244,688,So sorry the air conditioner isn’t working up there.
4354,3901,1,9,62,72,1.1527777777777777,0.04705623039870244,688,"I know it’s Muzak, but it’s still “Fly Me to the Moon”"
4397,3901,1,9,62,72,1.1527777777777777,0.04705623039870244,688,Where do you want to go Alice?
4427,3901,2,7,63,72,1.1527777777777777,0.051044344702082634,688,We only have 43 floors
4453,3901,1,9,62,72,1.1527777777777777,0.04705623039870244,688,"Shall I switch on the underwater landing lights, sir?"
4461,3901,2,7,63,72,1.1527777777777777,0.051044344702082634,688,"One small step off the elevator, one giant leap to my front door."
4471,3901,2,7,63,72,1.1527777777777777,0.051044344702082634,688,Any chance you’re looking for a different elevator?
4474,3901,2,7,63,72,1.1527777777777777,0.051044344702082634,688,This is definately going to be a major letdown.
4297,3901,2,7,63,72,1.1527777777777777,0.051044344702082634,688,Gravity is really bringing me down these days; 7th floor please.
2583,3901,2,7,63,72,1.1527777777777777,0.051044344702082634,688,"Sorry, since '73 this is as high as it gets."
2679,3901,1,9,62,72,1.1527777777777777,0.04705623039870244,688,"Men's underwear department, and make it quick.  I need to be somewhere in minus 10:07"
2549,3901,0,11,61,72,1.1527777777777777,0.0426972190266123,688,Ship's in the shop?
785,3901,1,9,62,72,1.1527777777777777,0.04705623039870244,688,Which apartment has the most space?
852,3901,1,9,62,72,1.1527777777777777,0.04705623039870244,688,"Going up, I assume?""
""Constellation Room or Starlight Lounge""
""The Dress Code clearly stated Black Tie."
863,3901,2,7,63,72,1.1527777777777777,0.051044344702082634,688,I said I was going up
866,3901,0,11,61,72,1.1527777777777777,0.0426972190266123,688,Please watch your one small step.
886,3901,0,11,61,72,1.1527777777777777,0.0426972190266123,688,Just don't try a spacewalk. It's a 110 stories.
908,3901,1,9,62,72,1.1527777777777777,0.04705623039870244,688,How high did you want to go? This is only the second floor.
933,3901,1,9,62,72,1.1527777777777777,0.04705623039870244,688,"Top floor, Jeeves. Warp factor six."
972,3901,0,11,61,72,1.1527777777777777,0.0426972190266123,688,I’m sorry if you don’t think there’s enough space here sir.
1021,3901,0,11,61,72,1.1527777777777777,0.0426972190266123,688,I'm as surprised as you are
1044,3901,1,9,62,72,1.1527777777777777,0.04705623039870244,688,"Yes, the men's room has a changing station. It's to the left down the hall."
1045,3901,0,11,61,72,1.1527777777777777,0.0426972190266123,688,I’m sorry but  the elevator doesn’t go up that high.
1092,3901,1,9,62,72,1.1527777777777777,0.04705623039870244,688,The upper upper penthouse I assume.
1098,3901,1,9,62,72,1.1527777777777777,0.04705623039870244,688,"Oh, sir...actually, today the air quality at the top is much improved."
1105,3901,1,9,62,72,1.1527777777777777,0.04705623039870244,688,Take the cross-town bus to the dock.  You will find the ocean there.
1169,3901,1,9,62,72,1.1527777777777777,0.04705623039870244,688,"Tap it hard - escape velocity is 25,000 mph."
1230,3901,1,9,62,72,1.1527777777777777,0.04705623039870244,688,"I don't blame you pal, it won't be long before I get off of this M----r F----r, too!"
1291,3901,0,11,61,72,1.1527777777777777,0.0426972190266123,688,I think you’ll find the accommodations to be most spacious.
1315,3901,1,9,62,72,1.1527777777777777,0.04705623039870244,688,Going that far up sir?
1316,3901,1,9,62,72,1.1527777777777777,0.04705623039870244,688,"""This is the express, hope you can handle it."
1367,3901,2,7,63,72,1.1527777777777777,0.051044344702082634,688,"Its not a problem for me to select your floor, and my name is not Houston."
1373,3901,1,9,62,72,1.1527777777777777,0.04705623039870244,688,It’s one small step for a man . . .
696,3901,1,9,62,72,1.1527777777777777,0.04705623039870244,688,I am sorry the penthouse was so disappointing.
657,3901,3,5,64,72,1.1527777777777777,0.05474268382893093,688,"I know you're going up, but this baby won't get you there. May I suggest you speak with Mr. Musk. He's in the penthouse."
635,3901,1,9,62,72,1.1527777777777777,0.04705623039870244,688,"I am afraid we don't go that high,Mr. Anderson."
628,3901,1,9,62,72,1.1527777777777777,0.04705623039870244,688,I think you jumped a little late.
55,3901,2,7,63,72,1.1527777777777777,0.051044344702082634,688,One small step for me to  | get out of this elevator but | the isolation of my  | apartment is terrifying
71,3901,1,9,62,72,1.1527777777777777,0.04705623039870244,688,"You cant go to- the moon with an  elevator,though"
77,3901,1,9,62,72,1.1527777777777777,0.04705623039870244,688,"One small step for man, one giant leap for mankind ‘  ,Oh ok, you must be heading up to COP 25‘"
78,3901,0,11,61,72,1.1527777777777777,0.0426972190266123,688,G = “i oing up?
93,3901,0,11,61,72,1.1527777777777777,0.0426972190266123,688,"I gotta say, this place has quite an atmosphere.."
143,3901,1,9,62,72,1.1527777777777777,0.04705623039870244,688,Sorry this is the furthest we can go
157,3901,2,7,63,72,1.1527777777777777,0.051044344702082634,688,"It is not that giant leap for mankind, but here you go!  This is the smoking terrace!"
205,3901,1,9,62,72,1.1527777777777777,0.04705623039870244,688,"This is the space bar, unfortunately drinks do not include complementary laptops"
221,3901,2,7,63,72,1.1527777777777777,0.051044344702082634,688,This is my final exam!
247,3901,1,9,62,72,1.1527777777777777,0.04705623039870244,688,"‘Mondays, am I right?"
1442,3901,0,11,61,72,1.1527777777777777,0.0426972190266123,688,"Floor 7,567,789, please."
277,3901,2,7,63,72,1.1527777777777777,0.051044344702082634,688,Mr. Douglas Adams is waiting you at the end of the universe
305,3901,1,9,62,72,1.1527777777777777,0.04705623039870244,688,"10,817th floor.  Moon rock, Mars ice and baby Yoda dolls."""
357,3901,0,11,61,72,1.1527777777777777,0.0426972190266123,688,Take one small step and you will be in the lobby
388,3901,1,9,62,72,1.1527777777777777,0.04705623039870244,688,"No liftoff, sorry.  All I can give you is off-lift."
396,3901,0,11,61,72,1.1527777777777777,0.0426972190266123,688,"No, there’s no Zero G in this building"
420,3901,0,11,61,72,1.1527777777777777,0.0426972190266123,688,High enough for me.
472,3901,0,11,61,72,1.1527777777777777,0.0426972190266123,688,The only way is up.
486,3901,0,11,61,72,1.1527777777777777,0.0426972190266123,688,Do you really think that will be one giant leap for mankind?
551,3901,1,9,62,72,1.1527777777777777,0.04705623039870244,688,"10? 9? 8, 7, 6..."
563,3901,2,7,63,72,1.1527777777777777,0.051044344702082634,688,"Yes sir, we ARE going up!"
627,3901,1,9,62,72,1.1527777777777777,0.04705623039870244,688,"""See?  I told you ..."
299,3901,2,7,63,72,1.1527777777777777,0.051044344702082634,688,"This is just a side hustle, I really want to get into BitCoin."
1481,3901,0,11,61,72,1.1527777777777777,0.0426972190266123,688,"Beam me up to the MTV auditions, Scotty."
891,3901,1,9,62,72,1.1527777777777777,0.04705623039870244,688,"I’m sorry, but this elevator only goes up ten floors."
1525,3901,1,9,62,72,1.1527777777777777,0.04705623039870244,688,"Aside from cost, it’s probably also less painful than Botox."
2003,3901,1,9,62,72,1.1527777777777777,0.04705623039870244,688,"Sorry, sir.  The Houston Astros are not tenants in this building."
2008,3901,1,9,62,72,1.1527777777777777,0.04705623039870244,688,"Sooooo, this is NOT the gantry then."
2009,3901,1,9,62,72,1.1527777777777777,0.04705623039870244,688,"I don't go that far,try the space escalator."
2030,3901,1,9,62,72,1.1527777777777777,0.04705623039870244,688,Sir! Space launches are on floor 4.
2031,3901,3,5,64,72,1.1527777777777777,0.05474268382893093,688,"It's time to leave the elevator if you dare. Tell your wife I, I mean, you, love her so."
2124,3901,1,9,62,72,1.1527777777777777,0.04705623039870244,688,"Say it with me, ""It's one small step for a man..."""
2179,3901,1,9,62,72,1.1527777777777777,0.04705623039870244,688,I used to take a rocket to get up here.
2187,3901,0,11,61,72,1.1527777777777777,0.0426972190266123,688,This elevator is going down
2189,3901,2,7,63,72,1.1527777777777777,0.051044344702082634,688,And a Top o’the Gantry to you too!
2191,3901,0,11,61,72,1.1527777777777777,0.0426972190266123,688,Shall We Lift-Off?
2193,3901,0,11,61,72,1.1527777777777777,0.0426972190266123,688,This will be
2276,3901,0,11,61,72,1.1527777777777777,0.0426972190266123,688,Mr. Musk is expecting you
2295,3901,1,9,62,72,1.1527777777777777,0.04705623039870244,688,"Yes, this is the Mars floor"
2316,3901,1,9,62,72,1.1527777777777777,0.04705623039870244,688,"Sir, I must insist Mr. Musk is quite busy today."
2352,3901,0,11,61,72,1.1527777777777777,0.0426972190266123,688,"I'm sorry, sir...I only go to the top floor."
1517,3901,0,11,61,72,1.1527777777777777,0.0426972190266123,688,"They were out of flu vaccine at Rite Aid, and I teach first grade at P.S. 186."
2424,3901,0,11,61,72,1.1527777777777777,0.0426972190266123,688,"Are you sure that is what your Commander meant when he said ""take the elevator to the Rockettes?"""
2448,3901,0,11,61,72,1.1527777777777777,0.0426972190266123,688,"Well no, sir. It only goes up to 12."
2450,3901,0,11,61,72,1.1527777777777777,0.0426972190266123,688,"Sorry sir, this elevator only goes down!"
2463,3901,1,9,62,72,1.1527777777777777,0.04705623039870244,688,"I guess you try to avoid taking any more steps, huh?"
2467,3901,1,9,62,72,1.1527777777777777,0.04705623039870244,688,"Twelfth floor in T-minus 10, 9, 8..."
2560,3901,1,9,62,72,1.1527777777777777,0.04705623039870244,688,That was far from a giant leap for mankind.
2493,3901,2,7,63,72,1.1527777777777777,0.051044344702082634,688,"If you're looking for space, this is the place."
1967,3901,2,7,63,72,1.1527777777777777,0.051044344702082634,688,"They say it doesn’t stink.
I’ve seen it all in the videos.
It stinks."
1920,3901,0,11,61,72,1.1527777777777777,0.0426972190266123,688,To infinity and the penthouse!
2404,3901,1,9,62,72,1.1527777777777777,0.04705623039870244,688,Watch this space.
1887,3901,3,5,64,72,1.1527777777777777,0.05474268382893093,688,"You may have taken the wrong lift, sir"
1891,3901,0,11,61,72,1.1527777777777777,0.0426972190266123,688,Re-entry is scheduled no later than 5 PM
1532,3901,1,9,62,72,1.1527777777777777,0.04705623039870244,688,Should I hold the door?
1534,3901,2,7,63,72,1.1527777777777777,0.051044344702082634,688,"The penthouse. Right away, sir!"""
1575,3901,1,9,62,72,1.1527777777777777,0.04705623039870244,688,"Suits are one small step, one giant leap on your left."
1609,3901,0,11,61,72,1.1527777777777777,0.0426972190266123,688,"Sir, we have no space walk exit. You will just have to walk around the lobby."
1610,3901,1,9,62,72,1.1527777777777777,0.04705623039870244,688,Moon rocks?  next floor.
1634,3901,1,9,62,72,1.1527777777777777,0.04705623039870244,688,"I'm afraid this is as 'way up high' as I can take you, Captain."
1676,3901,0,11,61,72,1.1527777777777777,0.0426972190266123,688,What type of ship is this?
1692,3901,0,11,61,72,1.1527777777777777,0.0426972190266123,688,Um . . . you do realize that skyscraper is just an expression?
1707,3901,0,11,61,72,1.1527777777777777,0.0426972190266123,688,What floor is probing?
1727,3901,0,11,61,72,1.1527777777777777,0.0426972190266123,688,I hear the view is great today
1590,3901,2,7,63,72,1.1527777777777777,0.051044344702082634,688,It’s 2:00 AM sir.  Good luck on your Central Park moonwalk.
1757,3901,0,11,61,72,1.1527777777777777,0.0426972190266123,688,"455,737,221st Floor. Men’s suits."
1739,3901,1,9,62,72,1.1527777777777777,0.04705623039870244,688,The penthouse is higher than you think.
1857,3901,0,11,61,72,1.1527777777777777,0.0426972190266123,688,I love the open space concept of your penthouse.
1777,3901,0,11,61,72,1.1527777777777777,0.0426972190266123,688,"Sir, the penthouse is fully pressurized."
1862,3901,1,9,62,72,1.1527777777777777,0.04705623039870244,688,I'm here about 'Solo' Honeymoon Package
1821,3901,1,9,62,72,1.1527777777777777,0.04705623039870244,688,I hope Madam's Space Force interview goes well.
1826,3901,1,9,62,72,1.1527777777777777,0.04705623039870244,688,"If we're really going that high, shouldn't I be wearing one of those too?"
1830,3901,1,9,62,72,1.1527777777777777,0.04705623039870244,688,Your planet is so technologically backward—you still have elevator operators.
3176,4110,2,7,64,73,1.1506849315068493,0.050383736280168755,688,"There we are, ""level 3, men's wallets & haberdashery"". Godspeed."
3204,4110,1,9,63,73,1.1506849315068493,0.0464543149529128,688,"I tried to tell you, this is as high up as it goes."
3684,4110,0,11,62,73,1.1506849315068493,0.0421602404397703,688,"To floor ninety, and beyond!"
3759,4110,2,7,64,73,1.1506849315068493,0.050383736280168755,688,Would you like some dinner before you retire and become a new born fetus?
3833,4110,1,9,63,73,1.1506849315068493,0.0464543149529128,688,Call it cautious optimism.
3959,4110,1,9,63,73,1.1506849315068493,0.0464543149529128,688,There is absolutely no sense of atmosphere with my building's staff
4020,4110,0,11,62,73,1.1506849315068493,0.0421602404397703,688,Going down to the ocean floor?
3069,4110,0,11,62,73,1.1506849315068493,0.0421602404397703,688,The Penthouse I presume.......
3061,4110,2,7,64,73,1.1506849315068493,0.050383736280168755,688,"Yes, I know it's a tall skyscraper. No, I wasn't told it that it's THAT tall!"
2663,4110,0,11,62,73,1.1506849315068493,0.0421602404397703,688,45th floor has spectacular views
2943,4110,2,7,64,73,1.1506849315068493,0.050383736280168755,688,And this space is where the door used to be.
2799,4110,1,9,63,73,1.1506849315068493,0.0464543149529128,688,"Sorry sir, the lift is off."
2640,4110,1,9,63,73,1.1506849315068493,0.0464543149529128,688,Ugh... Moon days amIright?
2077,4110,2,7,64,73,1.1506849315068493,0.050383736280168755,688,I think you’re gonna need a bigger lift.
2433,4110,2,7,64,73,1.1506849315068493,0.050383736280168755,688,"-The astronaut: Nice disguise, dude!"
4101,4110,1,9,63,73,1.1506849315068493,0.0464543149529128,688,This is as close as I can get you to the moon.
2226,4110,0,11,62,73,1.1506849315068493,0.0421602404397703,688,"And, the association just opened a high-altitude training center on 265.  Keycard only, though."
2242,4110,1,9,63,73,1.1506849315068493,0.0464543149529128,688,"I like to avoid awkward elevator chitchat."""
2254,4110,0,11,62,73,1.1506849315068493,0.0421602404397703,688,It comes with the cybertruck.
2304,4110,3,5,65,73,1.1506849315068493,0.05402812587305586,688,The prices here are stratospheric
3000,4110,0,11,62,73,1.1506849315068493,0.0421602404397703,688,I wanted to push button.
4218,4110,2,7,64,73,1.1506849315068493,0.050383736280168755,688,I asked the front desk to give me a high floor.
4801,4110,0,11,62,73,1.1506849315068493,0.0421602404397703,688,And you're sure this is what earthlings wear every day?
4325,4110,2,7,64,73,1.1506849315068493,0.050383736280168755,688,"But, Sir, we don’t go that high!"
2032,4110,1,9,63,73,1.1506849315068493,0.0464543149529128,688,You had the chili? It’s gonna get rough in there.
5244,4110,3,5,65,73,1.1506849315068493,0.05402812587305586,688,Are you here to see Mr. Musk or Sir Branson
5312,4110,1,9,63,73,1.1506849315068493,0.0464543149529128,688,"No, staying on the top floor does not mean you've gone into orbit."
5063,4110,3,5,65,73,1.1506849315068493,0.05402812587305586,688,"No Mr. Musk,  I don't know which way the Falcon Rocket is."
5066,4110,0,11,62,73,1.1506849315068493,0.0421602404397703,688,"Sorry sir, if you want to reach terminal velocity you’ll have to take number 11."
5166,4110,1,9,63,73,1.1506849315068493,0.0464543149529128,688,Sorry.....You'll have to use the escalator to get to that one....
5203,4110,2,7,64,73,1.1506849315068493,0.050383736280168755,688,Welcome to New Delhi! Ready to step out Sir?
4981,4110,2,7,64,73,1.1506849315068493,0.050383736280168755,688,Ad astra?
4935,4110,0,11,62,73,1.1506849315068493,0.0421602404397703,688,The sales are out of this world.
4233,4110,1,9,63,73,1.1506849315068493,0.0464543149529128,688,"But... that’s as high as we go, sir!"
4921,4110,3,5,65,73,1.1506849315068493,0.05402812587305586,688,"Which bookcase on the Interstellevator today, sir?"
4874,4110,1,9,63,73,1.1506849315068493,0.0464543149529128,688,Climbing or diving?
4860,4110,2,7,64,73,1.1506849315068493,0.050383736280168755,688,Number 1 requests a new throne.
4797,4110,0,11,62,73,1.1506849315068493,0.0421602404397703,688,It's too many giant steps to the 9th floor
4770,4110,0,11,62,73,1.1506849315068493,0.0421602404397703,688,"Man, budget cuts, am I right?"
4712,4110,0,11,62,73,1.1506849315068493,0.0421602404397703,688,"Sir, I can confirm the parachute did not deploy. But have a lovely day."
4659,4110,2,7,64,73,1.1506849315068493,0.050383736280168755,688,You're on your own after the top floor.
4488,4110,1,9,63,73,1.1506849315068493,0.0464543149529128,688,"Sorry, sir, this is as far as we go---"
4469,4110,1,9,63,73,1.1506849315068493,0.0464543149529128,688,"Sorry, but the 102nd floor is as high as we go."
4380,4110,1,9,63,73,1.1506849315068493,0.0464543149529128,688,"How'd the group therapy go?
Germaphobia is it?"
4883,4110,0,11,62,73,1.1506849315068493,0.0421602404397703,688,"Oh, not THAT type of rendezvous. My bad."
1989,4110,0,11,62,73,1.1506849315068493,0.0421602404397703,688,It was the last one they had.
4164,4110,0,11,62,73,1.1506849315068493,0.0421602404397703,688,You'll find the door to the launch pad down the hall to your right.
806,4110,1,9,63,73,1.1506849315068493,0.0464543149529128,688,Ground floor. Going up again?
127,4110,2,7,64,73,1.1506849315068493,0.050383736280168755,688,THIS IS AS FAR AS I CAN GET YOU  SIXTH FLOOR
535,4110,1,9,63,73,1.1506849315068493,0.0464543149529128,688,"VR headset repair? Walk the plank, then free fall to the sixth floor."
600,4110,0,11,62,73,1.1506849315068493,0.0421602404397703,688,"Sure, go to the first hallway, turn left and then it's one small step for the Men's room."
794,4110,0,11,62,73,1.1506849315068493,0.0421602404397703,688,"One small step for Human Resources,one giant step for the cafeteria."
19,4110,1,9,63,73,1.1506849315068493,0.0464543149529128,688,| don’t Know when they put in the elevator. I’ve only been here a week.
799,4110,1,9,63,73,1.1506849315068493,0.0464543149529128,688,"Going down, I presume."
857,4110,0,11,62,73,1.1506849315068493,0.0421602404397703,688,"Another Extra-Vehicular Activity simulation, Sir?"
4844,4110,0,11,62,73,1.1506849315068493,0.0421602404397703,688,"I'm sorry sir, but this is a lift without a liftoff."
1078,4110,1,9,63,73,1.1506849315068493,0.0464543149529128,688,She’s about to birth our 7th child.
1089,4110,0,11,62,73,1.1506849315068493,0.0421602404397703,688,"This is as high as it goes.  Try the next building over, they have another 10 floors."
1137,4110,1,9,63,73,1.1506849315068493,0.0464543149529128,688,"Yes,this is the only Hotel in Vegas with a rooftop launching pad"
1183,4110,1,9,63,73,1.1506849315068493,0.0464543149529128,688,I will be back in a week. Just heading out for some cheese.
390,4110,0,11,62,73,1.1506849315068493,0.0421602404397703,688,The penthouse suite? One small step to your left and one giant leap down the hall.
1977,4110,1,9,63,73,1.1506849315068493,0.0464543149529128,688,"I could have ordered a Lyft faster than that lift, and that's coming from someone whose been to the moon and back..."
1393,4110,2,7,64,73,1.1506849315068493,0.050383736280168755,688,"Sir, the gantry is near Miami Florida, not Miami, Ohio."
1402,4110,2,7,64,73,1.1506849315068493,0.050383736280168755,688,This is your official uniform for jumping man of the moon!
1405,4110,1,9,63,73,1.1506849315068493,0.0464543149529128,688,My payload is none of your business.
1433,4110,0,11,62,73,1.1506849315068493,0.0421602404397703,688,Do we really need to stop at every floor?
1472,4110,2,7,64,73,1.1506849315068493,0.050383736280168755,688,"You can't miss it - it's one small step to the M, one giant leap for Manhattan"
1498,4110,2,7,64,73,1.1506849315068493,0.050383736280168755,688,And to think i was voted most likely to succeed.
1550,4110,0,11,62,73,1.1506849315068493,0.0421602404397703,688,"I'm sorry sir, this elevator only goes to the 25th floor."
1556,4110,1,9,63,73,1.1506849315068493,0.0464543149529128,688,This is the express elevator so you may want to sit on that chair.
1562,4110,1,9,63,73,1.1506849315068493,0.0464543149529128,688,I know you are in a hurry so shall I hold the elevator while you retrieve your keys?
1688,4110,2,7,64,73,1.1506849315068493,0.050383736280168755,688,How's the weather out there?
1743,4110,0,11,62,73,1.1506849315068493,0.0421602404397703,688,Thanks for helping me get grounded
1766,4110,0,11,62,73,1.1506849315068493,0.0421602404397703,688,I was told to expect and awkward atmosphere
1247,4110,0,11,62,73,1.1506849315068493,0.0421602404397703,688,"Wow, look at all the space."
173,4110,0,11,62,73,1.1506849315068493,0.0421602404397703,688,Your Uber shuttle Is right outside
4787,4186,0,11,63,74,1.1486486486486487,0.04163642831779319,688,"Basement, please."
5047,4187,0,12,69,81,1.1481481481481481,0.03971779738801338,688,"My name is Steve, not Houston."
23,4188,0,11,64,75,1.1466666666666667,0.04112531205098986,688,Can you hear me? Sorry I lost you there for a minute” -Major To
2863,4188,1,9,65,75,1.1466666666666667,0.045295161459604626,688,"Well, I wouldn’t exactly call it a *giant* leap."
3291,4188,1,9,65,75,1.1466666666666667,0.045295161459604626,688,"Ah! Dressing like it’s your last day on earth? I admire you sir. If it were your—God forbid, day of demise—what splendid attire to be done in, in. I wish the Doormen Union was not so strict with dress code. We have to sleep and bathe in our uniforms."
3989,4188,0,11,64,75,1.1466666666666667,0.04112531205098986,688,Penthouse and beyond?
4442,4188,0,11,64,75,1.1466666666666667,0.04112531205098986,688,"Enjoy your trip, Mr. Wilberforce and mind the gap."
1994,4193,2,6,62,70,1.1428571428571428,0.051017450372708696,688,I'm sorry to inform you this is not the Space Needle -- it's in Seattle.
2100,4193,0,10,60,70,1.1428571428571428,0.04212627318711346,688,But this IS the top floor sir....
2321,4193,1,8,61,70,1.1428571428571428,0.04678356086900135,688,"Today's pollution pattern certainly validates your insightful choice of garb, sir."
2938,4193,1,8,61,70,1.1428571428571428,0.04678356086900135,688,The valet wants to know what color.
1697,4193,0,10,60,70,1.1428571428571428,0.04212627318711346,688,Flu season...
2377,4193,0,10,60,70,1.1428571428571428,0.04212627318711346,688,"Ocean intrusion level, please."
2081,4193,1,8,61,70,1.1428571428571428,0.04678356086900135,688,You want the Express elevator. This one only goes to the stratosphere.
3260,4193,0,10,60,70,1.1428571428571428,0.04212627318711346,688,"Sorry, you want the stairway to the stars. This is the elevator to Floor 9: women's apparel, outerwear, and home furnishings."
4395,4193,1,8,61,70,1.1428571428571428,0.04678356086900135,688,This car doesn’t go to the bridge. You need to transfer on the twenty-eighth floor.
3639,4193,3,4,63,70,1.1428571428571428,0.054925940296730785,688,Sorry. This elevator only goes as high as the 14th floor.
3977,4193,0,10,60,70,1.1428571428571428,0.04212627318711346,688,"I'd love to go for lunch sir, but I just started my shift!"
4145,4193,2,6,62,70,1.1428571428571428,0.051017450372708696,688,Ground control to Major Tom...I see the recession hit you hard.
4282,4193,0,10,60,70,1.1428571428571428,0.04212627318711346,688,the President's Suite is down the corridor on your right
4338,4193,3,4,63,70,1.1428571428571428,0.054925940296730785,688,"Let me guess, Jared,"" said the concierge wearily. ""No tip today."
1427,4193,0,10,60,70,1.1428571428571428,0.04212627318711346,688,"I'm sorry, going to the 13th floor is a moonshot."
4547,4193,2,6,62,70,1.1428571428571428,0.051017450372708696,688,Need I ask?
4595,4193,1,8,61,70,1.1428571428571428,0.04678356086900135,688,"I'm sorry, this elevator does not go that far."
3594,4193,1,8,61,70,1.1428571428571428,0.04678356086900135,688,It's been a rare privilege to share your personal space.
1394,4193,2,6,62,70,1.1428571428571428,0.051017450372708696,688,"Sir, or Madam, if you would clean your helmet, you would see this is not your rocket ship and I can’t manage enough thrust to launch you into orbit."
3667,4193,2,6,62,70,1.1428571428571428,0.051017450372708696,688,"Economy, Business or First Class"
1138,4193,0,10,60,70,1.1428571428571428,0.04212627318711346,688,"Sir, this elevator only goes to the 70th floor; you'll have to change there to get to the capsule entry gantry."
1096,4193,0,10,60,70,1.1428571428571428,0.04212627318711346,688,"3,400,00th floor, sir?"
976,4193,0,10,60,70,1.1428571428571428,0.04212627318711346,688,Penthouse please.
903,4193,0,10,60,70,1.1428571428571428,0.04212627318711346,688,Mars is to the left and up the escalator.
902,4193,1,8,61,70,1.1428571428571428,0.04678356086900135,688,The lobby is one small step ahead.
344,4193,1,8,61,70,1.1428571428571428,0.04678356086900135,688,"Exxon gave me this cool walk-the-Earth-without-imminent-death suit after I helped accidentally ice and boil a few countries with my old money, sick right?"
297,4193,0,10,60,70,1.1428571428571428,0.04212627318711346,688,"I assure you, there's no button for Mars."
1358,4193,0,10,60,70,1.1428571428571428,0.04212627318711346,688,"I totally agree, sir.  . .especially the airborne."
4130,4193,0,10,60,70,1.1428571428571428,0.04212627318711346,688,I spent too much time on WebMD.
365,4222,0,11,67,78,1.141025641025641,0.039663750600197265,688,Beware the effects of deceleration on descent.
3857,4223,0,10,61,71,1.1408450704225352,0.04157742116654289,688,It’s a small step for a man.
3806,4223,1,8,62,71,1.1408450704225352,0.046163800079517044,688,When I said to wear your suit from work I didn't mean...
3868,4223,0,10,61,71,1.1408450704225352,0.04157742116654289,688,"Next time, don't press all the buttons."
2335,4223,2,6,63,71,1.1408450704225352,0.05033399372892188,688,Is this the floor for Space Force accessories?
1720,4223,2,6,63,71,1.1408450704225352,0.05033399372892188,688,"Sorry, sir, the Chrysler Building cannot take off."
1572,4223,1,8,62,71,1.1408450704225352,0.046163800079517044,688,Did Russia arrive yet?
845,4223,2,6,63,71,1.1408450704225352,0.05033399372892188,688,"Fifth floor - Men’s Department, casual clothes and footwear."
5233,4230,2,6,64,72,1.1388888888888888,0.04966852391033734,688,To Moon or to Boss?
4160,4230,1,8,63,72,1.1388888888888888,0.04556013565281042,688,"Alright, alright, alright."
4281,4230,0,10,62,72,1.1388888888888888,0.04104253469235572,688,"Skywalk, I presume?"
4498,4230,0,10,62,72,1.1388888888888888,0.04104253469235572,688,"Sorry,sir,but this is as high as we go."
1428,4230,0,10,62,72,1.1388888888888888,0.04104253469235572,688,This only goes to the 35th floor.
2147,4230,0,10,62,72,1.1388888888888888,0.04104253469235572,688,"The 32nd balcony was two scary.
I was afraid I' couldn't open the ripcord
fast enough on any of the lower floors."
2165,4230,0,10,62,72,1.1388888888888888,0.04104253469235572,688,"Sorry, sir - I can’t reach that button."
924,4237,0,10,63,73,1.1369863013698631,0.04052109440479188,688,I’m sure your qualified. You made it to the 12th floor
1198,4237,2,6,65,73,1.1369863013698631,0.049020343729643576,688,"Houston, we are preparing for ascent."
4359,4237,0,10,63,73,1.1369863013698631,0.04052109440479188,688,"Yes, sir, the lights are on and it is broad daylight outside."
3052,4240,0,9,57,66,1.1363636363636365,0.042565532289603344,688,Take the stairs wise guy.
95,4240,0,9,57,66,1.1363636363636365,0.042565532289603344,688,"Do you mina if we do a countdown before you push the button e""  ("
2074,4240,0,9,57,66,1.1363636363636365,0.042565532289603344,688,I told them I'd meet them on the roof.
4476,4240,0,9,57,66,1.1363636363636365,0.042565532289603344,688,Launching or re-launching?
49,4240,0,9,57,66,1.1363636363636365,0.042565532289603344,688,"Good morning, Mr. LaLiberte. So you were serious."
1504,4240,1,7,58,66,1.1363636363636365,0.04772866020849245,688,Did somebody pass gas???
1946,4240,0,9,57,66,1.1363636363636365,0.042565532289603344,688,"No, not up.  Down.  Center of the Earth, please."
1363,4240,0,9,57,66,1.1363636363636365,0.042565532289603344,688,"White silk scarves please.
They’re still in fashion, right? 
My boyfriend was a major fail; I mean come on, a Black scarf?  Like, where am I headed?  A black hole?"
1928,4248,0,10,64,74,1.135135135135135,0.040012605956627305,688,"Watch your step, Mr Armstrong, lest it becomes a leap in this gravity!"
3541,4249,0,9,58,67,1.1343283582089552,0.041974785069899656,688,Here ya go Major Tom.
3457,4249,0,9,58,67,1.1343283582089552,0.041974785069899656,688,Up to the Future
3415,4249,1,7,59,67,1.1343283582089552,0.04705493189919477,688,"The 81st Floor?!? We only have 33!""                   J K Fuller. GENOA, N"
3399,4249,0,9,58,67,1.1343283582089552,0.041974785069899656,688,"I’m afraid we’re a few hundred miles short of the ISS, sir."
3495,4249,0,9,58,67,1.1343283582089552,0.041974785069899656,688,"As I said, the sky’s the limit."
3509,4249,2,5,60,67,1.1343283582089552,0.0516376863386756,688,"WAIT A MINUTE
I LEFT THE IRON ON"
3540,4249,2,5,60,67,1.1343283582089552,0.0516376863386756,688,"This is five, are you going to infinity and beyond?"
3476,4249,0,9,58,67,1.1343283582089552,0.041974785069899656,688,Doesn't this thing go up any higher?
3584,4249,2,5,60,67,1.1343283582089552,0.0516376863386756,688,"All the way up, mate!"
3785,4249,0,9,58,67,1.1343283582089552,0.041974785069899656,688,Which do you think?
3559,4249,0,9,58,67,1.1343283582089552,0.041974785069899656,688,One small step for man. One giant walk of shame for mankind.
3726,4249,0,9,58,67,1.1343283582089552,0.041974785069899656,688,It may not be the final frontier but it is the first floor
3598,4249,1,7,59,67,1.1343283582089552,0.04705493189919477,688,"Don't worry. I didn't understand the ending of ""2001"" either."
3612,4249,1,7,59,67,1.1343283582089552,0.04705493189919477,688,This elevator doesn’t go that high.  Ou want NASA.
3720,4249,0,9,58,67,1.1343283582089552,0.041974785069899656,688,"Hey, not THAT far up."
3358,4249,1,7,59,67,1.1343283582089552,0.04705493189919477,688,"I assume you're on floor 1,000?"
3761,4249,1,7,59,67,1.1343283582089552,0.04705493189919477,688,Do you need me to call a cab?
3747,4249,1,7,59,67,1.1343283582089552,0.04705493189919477,688,"Whaddya mean I have a funny-looking outfit? 
Take a look at yourself!"
3729,4249,2,5,60,67,1.1343283582089552,0.0516376863386756,688,Am I there yet?
3553,4249,1,7,59,67,1.1343283582089552,0.04705493189919477,688,Sorry -85 is as high as we go in this one.
3356,4249,2,5,60,67,1.1343283582089552,0.0516376863386756,688,I swear if you do a launch countdown like the last guy I’m taking the stairs.
3087,4249,0,9,58,67,1.1343283582089552,0.041974785069899656,688,"I’m sorry, but I’ll have to see an actual  photo ID."
3307,4249,1,7,59,67,1.1343283582089552,0.04705493189919477,688,"You'll be fine here, in our building all women come from Venus."
2893,4249,0,9,58,67,1.1343283582089552,0.041974785069899656,688,"Ok, but 79,000 feet will take a while."
2935,4249,0,9,58,67,1.1343283582089552,0.041974785069899656,688,"Sorry, but there is no roof access from this elevator."
3832,4249,0,9,58,67,1.1343283582089552,0.041974785069899656,688,Our rockets are made in the USSR
2890,4249,1,7,59,67,1.1343283582089552,0.04705493189919477,688,Space Station? To your left.
2864,4249,1,7,59,67,1.1343283582089552,0.04705493189919477,688,I’ll announce you to Mr. &. Mrs. Jetson.
2968,4249,1,7,59,67,1.1343283582089552,0.04705493189919477,688,"Strato-floor, please."
2982,4249,0,9,58,67,1.1343283582089552,0.041974785069899656,688,"Floor B1, satellites, drones, space wreckage, helmet cams, freeze dried food, American flags, golf balls and face mask cleaner..."
2992,4249,1,7,59,67,1.1343283582089552,0.04705493189919477,688,Space please.
3036,4249,0,9,58,67,1.1343283582089552,0.041974785069899656,688,Be careful on your first step.
3057,4249,0,9,58,67,1.1343283582089552,0.041974785069899656,688,I believe the tailor is on the fifth floor.
3338,4249,1,7,59,67,1.1343283582089552,0.04705493189919477,688,Fifth floor and hurry. I left the keys to the spaceship in my other suit...
3070,4249,0,9,58,67,1.1343283582089552,0.041974785069899656,688,"Sir, I'm afraid this elevator does not go that high.
Rebecca L. Hawkins, M.D."
3105,4249,1,7,59,67,1.1343283582089552,0.04705493189919477,688,You going up or down?
3123,4249,0,9,58,67,1.1343283582089552,0.041974785069899656,688,"You will need to take one small step, sir, as this is your floor."
3155,4249,1,7,59,67,1.1343283582089552,0.04705493189919477,688,I can’t see too well in this thing so let me know when we get up into orbit.
3175,4249,0,9,58,67,1.1343283582089552,0.041974785069899656,688,"Sixth floor, please, planetarium."
3184,4249,0,9,58,67,1.1343283582089552,0.041974785069899656,688,You're still going to gasp when they tell you how much the rent is here.
3186,4249,0,9,58,67,1.1343283582089552,0.041974785069899656,688,Go higher? This is the top floor.
3194,4249,1,7,59,67,1.1343283582089552,0.04705493189919477,688,It's not like I have a pocket to put them in
3202,4249,1,7,59,67,1.1343283582089552,0.04705493189919477,688,"Actually, the hotel shuttle is on the ground floor."
3269,4249,1,7,59,67,1.1343283582089552,0.04705493189919477,688,Which Floor?
3302,4249,0,9,58,67,1.1343283582089552,0.041974785069899656,688,"Take it easy, Homeland Security
isn't worried about refugees from friendly nations."
3088,4249,0,9,58,67,1.1343283582089552,0.041974785069899656,688,"Sir, the space elevator is next door..."
3867,4249,0,9,58,67,1.1343283582089552,0.041974785069899656,688,"10, 9, 8, 7, 6, 5, 4, 3, 2, 1...please."
5094,4249,0,9,58,67,1.1343283582089552,0.041974785069899656,688,"Are you sure it's not the roof you want, sir?"
3897,4249,2,5,60,67,1.1343283582089552,0.0516376863386756,688,'Up?'  Seriously?
4830,4249,0,9,58,67,1.1343283582089552,0.041974785069899656,688,Just trying  to hide myself from the world
4834,4249,1,7,59,67,1.1343283582089552,0.04705493189919477,688,Wrong station
4842,4249,0,9,58,67,1.1343283582089552,0.041974785069899656,688,"what floor sir ?
go up to the moon"
4881,4249,1,7,59,67,1.1343283582089552,0.04705493189919477,688,Bellhop: “and we’re going up in 5..4..3..2..1 And we have lift off from lobby”
4913,4249,2,5,60,67,1.1343283582089552,0.0516376863386756,688,"Godspeed, 3rd floor."
4918,4249,0,9,58,67,1.1343283582089552,0.041974785069899656,688,It'll be faster in a rocket over at the cape
4966,4249,0,9,58,67,1.1343283582089552,0.041974785069899656,688,Do you know something I don't know?
5006,4249,0,9,58,67,1.1343283582089552,0.041974785069899656,688,"I'm sorry, this elevator only goes to the stratosphere."
5019,4249,1,7,59,67,1.1343283582089552,0.04705493189919477,688,"Try space*woman*, you misogynist trash. And Housewares, please."
5040,4249,2,5,60,67,1.1343283582089552,0.0516376863386756,688,Your reentry approach was bumpy.
5052,4249,0,9,58,67,1.1343283582089552,0.041974785069899656,688,"For the 10,000th floor, you want the express."
5055,4249,1,7,59,67,1.1343283582089552,0.04705493189919477,688,I think you’ll find space savers on the fourth floor.
5110,4249,0,9,58,67,1.1343283582089552,0.041974785069899656,688,"Heaven, please."
5134,4249,0,9,58,67,1.1343283582089552,0.041974785069899656,688,Weightlessness withdrawals?
5181,4249,2,5,60,67,1.1343283582089552,0.0516376863386756,688,"Five, four, three, two, one?"
5199,4249,0,9,58,67,1.1343283582089552,0.041974785069899656,688,I don't think giant leaps involve elevators.
5247,4249,0,9,58,67,1.1343283582089552,0.041974785069899656,688,"I'll put on turbo, sir.  But can't promise anything."
5284,4249,0,9,58,67,1.1343283582089552,0.041974785069899656,688,I don't know if she can take us that far up!
5287,4249,1,7,59,67,1.1343283582089552,0.04705493189919477,688,What? Did I forget to put my pants on? AGAIN?!
5306,4249,0,9,58,67,1.1343283582089552,0.041974785069899656,688,To the 13th floor and beyond please.
5323,4249,1,7,59,67,1.1343283582089552,0.04705493189919477,688,"Pretty nasty suit fire, from what I hear."
5348,4249,1,7,59,67,1.1343283582089552,0.04705493189919477,688,We will ensure you have a proper countdown to lift off for next time.
2814,4249,2,5,60,67,1.1343283582089552,0.0516376863386756,688,"Welcome to Beijing
Enjoy your jog sir!"
4827,4249,0,9,58,67,1.1343283582089552,0.041974785069899656,688,You're safe.  There's zero-g's.
3871,4249,1,7,59,67,1.1343283582089552,0.04705493189919477,688,"Sir, The  Space-Time Continuum requires a coat and tie."
4804,4249,1,7,59,67,1.1343283582089552,0.04705493189919477,688,"Yes, sir. I'm still holding my breath, sir."
4705,4249,0,9,58,67,1.1343283582089552,0.041974785069899656,688,"Take me to the moon, Jensen."
3936,4249,1,7,59,67,1.1343283582089552,0.04705493189919477,688,"Sorry, it's out of order. You'll have to moonwalk instead."
3963,4249,0,9,58,67,1.1343283582089552,0.041974785069899656,688,Please watch your giant leap as you exit.
3980,4249,0,9,58,67,1.1343283582089552,0.041974785069899656,688,"No, we don't go as far as the moon."
4001,4249,1,7,59,67,1.1343283582089552,0.04705493189919477,688,You might prefer the express elevator.
4019,4249,0,9,58,67,1.1343283582089552,0.041974785069899656,688,"Can you talk loader?”
Don Dechman, Austin, T"
4050,4249,1,7,59,67,1.1343283582089552,0.04705493189919477,688,"T-minus 10, 9, 8, 7 ..."
4063,4249,0,9,58,67,1.1343283582089552,0.041974785069899656,688,"Buzz was wise to ""Chilli Tuesday"" in the staff cafeteria."
4106,4249,0,9,58,67,1.1343283582089552,0.041974785069899656,688,"Dare I say ""Blast off!"""
4159,4249,2,5,60,67,1.1343283582089552,0.0516376863386756,688,"It's based on quantum gravity, sir."
4167,4249,0,9,58,67,1.1343283582089552,0.041974785069899656,688,A rocket? I thought that was just people getting busy on the tenth floor.
4185,4249,0,9,58,67,1.1343283582089552,0.041974785069899656,688,"3.....2.....1......, Lift ....your left foot... off... the floor and step out."
4209,4249,0,9,58,67,1.1343283582089552,0.041974785069899656,688,"10? 9? 8?...""
""Basement bachelorette party."
4228,4249,2,5,60,67,1.1343283582089552,0.0516376863386756,688,Gratuity of twenty percent for large trips above the roof.
4244,4249,0,9,58,67,1.1343283582089552,0.041974785069899656,688,"The earth is really octagonal, isn't it?"
4386,4249,1,7,59,67,1.1343283582089552,0.04705493189919477,688,"Yes, it goes up. No, it is not going to be a space shot."
4438,4249,0,9,58,67,1.1343283582089552,0.041974785069899656,688,"128632, please"
4468,4249,1,7,59,67,1.1343283582089552,0.04705493189919477,688,The 'Starlight Roof' is the 19th floor.
4519,4249,0,9,58,67,1.1343283582089552,0.041974785069899656,688,What floor is the swimming pool on?
4562,4249,0,9,58,67,1.1343283582089552,0.041974785069899656,688,The launchroom?
4591,4249,1,7,59,67,1.1343283582089552,0.04705493189919477,688,"Geostationary orbit, sir?"
4602,4249,1,7,59,67,1.1343283582089552,0.04705493189919477,688,This is Ground Concourse 2 Major Tom.
4605,4249,1,7,59,67,1.1343283582089552,0.04705493189919477,688,"Do you count down from ten, or me?"
4609,4249,0,9,58,67,1.1343283582089552,0.041974785069899656,688,"I KNOW YOU WANT ""UP""  BUT  I'M ALREADY  GOING DOWN!"
4709,4249,1,7,59,67,1.1343283582089552,0.04705493189919477,688,"Sorry, but there is a dress code for this elevator"
2802,4249,0,9,58,67,1.1343283582089552,0.041974785069899656,688,"To the Top Floor!
And Beyond!"
3860,4249,0,9,58,67,1.1343283582089552,0.041974785069899656,688,"Yeah, I was also disappointed the diaper subplot was left out of the movie."
2740,4249,2,5,60,67,1.1343283582089552,0.0516376863386756,688,"You think I don’t recognise you in that suit, Jerry? You’re trying to fuck my wife again, aren’t you? You’re not even a real astronaut you sonuva bitch!"
549,4249,0,9,58,67,1.1343283582089552,0.041974785069899656,688,Take me to the Sky Room.
589,4249,0,9,58,67,1.1343283582089552,0.041974785069899656,688,Sure we have a wide open space.
599,4249,1,7,59,67,1.1343283582089552,0.04705493189919477,688,Did you say 'Space Force' ?
602,4249,0,9,58,67,1.1343283582089552,0.041974785069899656,688,"Sir, did you mean to get on the space elevator next door?"
618,4249,1,7,59,67,1.1343283582089552,0.04705493189919477,688,"I’m sorry, there’s no button for Zooptah."
625,4249,0,9,58,67,1.1343283582089552,0.041974785069899656,688,Exhilarating.
629,4249,1,7,59,67,1.1343283582089552,0.04705493189919477,688,"I agree,  the fragrance spritzers are a bit insistent..."
642,4249,1,7,59,67,1.1343283582089552,0.04705493189919477,688,"Here you go Commander, you can catch the express elevator to Saturn on this floor"
682,4249,3,3,61,67,1.1343283582089552,0.05584563263841704,688,"Ground floor Major Toms. Control Room is down the hall. 

Collier Holmes
Fairhope, Al"
712,4249,0,9,58,67,1.1343283582089552,0.041974785069899656,688,Do NOT press the button until I FINISH the countdown!
714,4249,2,5,60,67,1.1343283582089552,0.0516376863386756,688,Next time try the surface elevator.
796,4249,0,9,58,67,1.1343283582089552,0.041974785069899656,688,It beats a walk up
834,4249,1,7,59,67,1.1343283582089552,0.04705493189919477,688,"Sir, this only goes up to 12."
858,4249,1,7,59,67,1.1343283582089552,0.04705493189919477,688,I'm sorry.  I'm going down.
894,4249,1,7,59,67,1.1343283582089552,0.04705493189919477,688,"Blast off on your signal sir."""
905,4249,0,9,58,67,1.1343283582089552,0.041974785069899656,688,Charlie testing the Wonka-Vator 2.0
958,4249,0,9,58,67,1.1343283582089552,0.041974785069899656,688,What floor Maj. Tom?
974,4249,1,7,59,67,1.1343283582089552,0.04705493189919477,688,Directions to Venus?  You'll have to ask the concierge.
995,4249,0,9,58,67,1.1343283582089552,0.041974785069899656,688,I’m just done.  Up please.
1000,4249,0,9,58,67,1.1343283582089552,0.041974785069899656,688,"Please exit carefully, even if it's one small step for a man."
1019,4249,1,7,59,67,1.1343283582089552,0.04705493189919477,688,Funding cuts...afraid you'll have to walk the remaining ten floors to the capsule.
504,4249,0,9,58,67,1.1343283582089552,0.041974785069899656,688,Damn budget cuts - we're launching from the penthouse.
462,4249,1,7,59,67,1.1343283582089552,0.04705493189919477,688,"The offices of Cosmo are on the 40th floor, but I'm not sure how you'll get to the Cosmos from here."
457,4249,0,9,58,67,1.1343283582089552,0.041974785069899656,688,"I’m sorry, what did you say about a giant leap?"
448,4249,1,7,59,67,1.1343283582089552,0.04705493189919477,688,Second floor!  Acrophobia clinic is in room six.
22,4249,0,9,58,67,1.1343283582089552,0.041974785069899656,688,"Up or down, Sir?”  “Up, my kid was drawing a masterpiece”"
28,4249,0,9,58,67,1.1343283582089552,0.041974785069899656,688,"Ah yes, going all the way up! 47"
54,4249,0,9,58,67,1.1343283582089552,0.041974785069899656,688,‘Earth orbits parking lot. Left my roadster there...’
76,4249,0,9,58,67,1.1343283582089552,0.041974785069899656,688,"Sorry, we dont go that far up."
105,4249,0,9,58,67,1.1343283582089552,0.041974785069899656,688,"It’s called #Fashion, Frank"
123,4249,0,9,58,67,1.1343283582089552,0.041974785069899656,688,"Ya know, we’ve been  debating whether to call it the 9th floor or the 9th tier"
152,4249,2,5,60,67,1.1343283582089552,0.0516376863386756,688,HA HA HA! | WAS OUT THERE FOR JUST A WEEK AND TOTALLY  FORGOT ABOUT GRAVITY
174,4249,0,9,58,67,1.1343283582089552,0.041974785069899656,688,Power dressing for millenials
185,4249,0,9,58,67,1.1343283582089552,0.041974785069899656,688,I will just check up on a friend and
193,4249,2,5,60,67,1.1343283582089552,0.0516376863386756,688,"HUH, YOU WERE RIGHT, WE ARE THE SAME SIZE."
1033,4249,0,9,58,67,1.1343283582089552,0.041974785069899656,688,"It’s the latest in pollution fashion, Henry. Yours is on the way. Between the tenants and the air quality, I figured you could use the protection."
202,4249,0,9,58,67,1.1343283582089552,0.041974785069899656,688,"Excuse me, is this the  level of the Moon Headquarters?"
242,4249,0,9,58,67,1.1343283582089552,0.041974785069899656,688,High society lounge space?
243,4249,1,7,59,67,1.1343283582089552,0.04705493189919477,688,Oh Mr Armstrong the moon landing recording is over?
249,4249,1,7,59,67,1.1343283582089552,0.04705493189919477,688,IT had no other clean clothes
304,4249,0,9,58,67,1.1343283582089552,0.041974785069899656,688,"Regularmoon suite, please."
307,4249,0,9,58,67,1.1343283582089552,0.041974785069899656,688,"Sorry, I've never seen the Willie Wonka movie."
386,4249,1,7,59,67,1.1343283582089552,0.04705493189919477,688,I don't like shaking hands
407,4249,0,9,58,67,1.1343283582089552,0.041974785069899656,688,"I'm sorry, sir, this mission is black tie only!"
411,4249,1,7,59,67,1.1343283582089552,0.04705493189919477,688,Next shaft.
413,4249,0,9,58,67,1.1343283582089552,0.041974785069899656,688,Need a breath mint?
425,4249,0,9,58,67,1.1343283582089552,0.041974785069899656,688,"I beg your pardon, Commander - this isn't the express."
224,4249,0,9,58,67,1.1343283582089552,0.041974785069899656,688,This is as high as it goes.
1036,4249,1,7,59,67,1.1343283582089552,0.04705493189919477,688,Take me outta this world!
965,4249,0,9,58,67,1.1343283582089552,0.041974785069899656,688,"20th floor is as high as I go sir, you'll have to find another way to the moon."
2069,4249,2,5,60,67,1.1343283582089552,0.0516376863386756,688,Ahead one giant step for lingerie.
2059,4249,1,7,59,67,1.1343283582089552,0.04705493189919477,688,Space Station viewing is the best on this floor.
2067,4249,0,9,58,67,1.1343283582089552,0.041974785069899656,688,Musk?
1110,4249,0,9,58,67,1.1343283582089552,0.041974785069899656,688,"Highest floor, please. Obviously."
2102,4249,1,7,59,67,1.1343283582089552,0.04705493189919477,688,Liftoff... it's all relative.
2106,4249,2,5,60,67,1.1343283582089552,0.0516376863386756,688,I want you to know that Christmas bonus was out of this world.
2139,4249,0,9,58,67,1.1343283582089552,0.041974785069899656,688,Shall I take you to the top or the bottom?
2145,4249,0,9,58,67,1.1343283582089552,0.041974785069899656,688,We go only to the 97th floor.
2149,4249,0,9,58,67,1.1343283582089552,0.041974785069899656,688,"The most toxic Xmas party is in 1307, but they are big tippers."
2152,4249,1,7,59,67,1.1343283582089552,0.04705493189919477,688,"4... 3... 2... 1... Lunar Lounge, please!"
2216,4249,0,9,58,67,1.1343283582089552,0.041974785069899656,688,Sir-Top floor is forty feet above  sea level
2281,4249,1,7,59,67,1.1343283582089552,0.04705493189919477,688,"Vite! Ou est le toilet, s'il vous plait."
2331,4249,1,7,59,67,1.1343283582089552,0.04705493189919477,688,Penthouse? Practice flight?
2344,4249,0,9,58,67,1.1343283582089552,0.041974785069899656,688,Sure you work for NASA buddy. Come down from Mars and show me some ID.
2353,4249,0,9,58,67,1.1343283582089552,0.041974785069899656,688,"I told you before, this elevator only goes down."
2359,4249,1,7,59,67,1.1343283582089552,0.04705493189919477,688,"Glad to see you getting out, Mr. Kelly, even though our air quality can't match pure O2."
2373,4249,1,7,59,67,1.1343283582089552,0.04705493189919477,688,Be sure to give me a heads up when you expect to touch down.
2408,4249,2,5,60,67,1.1343283582089552,0.0516376863386756,688,I wish my honeymoon had been as exciting
2535,4249,1,7,59,67,1.1343283582089552,0.04705493189919477,688,"Mr. Kubrick's Suite is left, then 2nd on the right..."
2624,4249,1,7,59,67,1.1343283582089552,0.04705493189919477,688,And I thought only chickens could lay eggs.
2776,4249,2,5,60,67,1.1343283582089552,0.0516376863386756,688,"The Space Force Headquarters floor, Sir?"
2707,4249,0,9,58,67,1.1343283582089552,0.041974785069899656,688,Do you know if the flat Earth convention is in town?
1982,4249,0,9,58,67,1.1343283582089552,0.041974785069899656,688,All the way up!
1780,4249,1,7,59,67,1.1343283582089552,0.04705493189919477,688,The Fragrance section is to the left.
2042,4249,0,9,58,67,1.1343283582089552,0.041974785069899656,688,Bon voyage!
1746,4249,1,7,59,67,1.1343283582089552,0.04705493189919477,688,Hi! This is Universal Studios. If you believe they put a man on the moon. Take your pills.
1131,4249,0,9,58,67,1.1343283582089552,0.041974785069899656,688,"This is as high as we go, bub."
1182,4249,0,9,58,67,1.1343283582089552,0.041974785069899656,688,"Here is where you take one giant leap for mankind, sir."
1209,4249,1,7,59,67,1.1343283582089552,0.04705493189919477,688,You will probably survive New Delhi with that.
1214,4249,1,7,59,67,1.1343283582089552,0.04705493189919477,688,"Let me guess, Rent the Runway?"
1241,4249,1,7,59,67,1.1343283582089552,0.04705493189919477,688,Third floor today Mr. Jones?
1259,4249,1,7,59,67,1.1343283582089552,0.04705493189919477,688,Sorry for the cramped space.
1319,4249,0,9,58,67,1.1343283582089552,0.041974785069899656,688,"Sir, I'm afraid the space elevator is still on the drawing board....."
1384,4249,1,7,59,67,1.1343283582089552,0.04705493189919477,688,I think I got the wrong floor.
1748,4249,1,7,59,67,1.1343283582089552,0.04705493189919477,688,"Morning,Frank. Knicks lose again. Shocker. I'm running out for a Tang,you want one?"
1409,4249,0,9,58,67,1.1343283582089552,0.041974785069899656,688,"It’s okay, everyone mistakes the description of the Zero-G-Simulator for an analogy."
1477,4249,1,7,59,67,1.1343283582089552,0.04705493189919477,688,"Umm, the Farmers' Almanac says we are not getting snow until January...you might want to rethink your outfit."
1399,4249,0,9,58,67,1.1343283582089552,0.041974785069899656,688,"“Umpteenth Floor,  just go down the hall 
and out the door.  GO MAN, GO❗️”"
1516,4249,0,9,58,67,1.1343283582089552,0.041974785069899656,688,"Space is not here on earth, over and out!!"
1649,4249,0,9,58,67,1.1343283582089552,0.041974785069899656,688,For some reason I always want to take the express.
1478,4249,1,7,59,67,1.1343283582089552,0.04705493189919477,688,"Sorry we were unable to reach escape velocity, sir."
1605,4249,0,9,58,67,1.1343283582089552,0.041974785069899656,688,"This elevator only goes as far as the twelfth floor"".."
1592,4249,1,7,59,67,1.1343283582089552,0.04705493189919477,688,"Always a pleasure to see a gentleman dressed in a nice business suit, sir."
1645,4249,1,7,59,67,1.1343283582089552,0.04705493189919477,688,"If we go that high, then we might break the fourth wall."
1576,4249,0,9,58,67,1.1343283582089552,0.041974785069899656,688,"Good luck, and don't burn your fuse up there alone."
1569,4249,0,9,58,67,1.1343283582089552,0.041974785069899656,688,Enough with the prunes!
1566,4249,0,9,58,67,1.1343283582089552,0.041974785069899656,688,"You can only get up there with the stairs from here, sir."
1585,4249,0,9,58,67,1.1343283582089552,0.041974785069899656,688,Please tell me there is still space available up there.
251,4450,0,10,65,75,1.1333333333333333,0.039516598557587955,688,Next stop Mars.
4415,4450,1,8,66,75,1.1333333333333333,0.043839729948095284,688,"Pluto's a planet, Sir. I would know. VIVA LA PLUTO!"
3623,4452,1,7,60,68,1.1323529411764706,0.0463998528118308,688,"Sorry, this elevator car only goes to the 45,218th floor."
4329,4452,2,5,61,68,1.1323529411764706,0.05091098018830443,688,They sent you down for not wearing a tie.
3641,4452,1,7,60,68,1.1323529411764706,0.0463998528118308,688,"8,735,246th floor, please."
4242,4452,1,7,60,68,1.1323529411764706,0.0463998528118308,688,I always wanted to try one of those MRE's. Are they any good
4614,4452,1,7,60,68,1.1323529411764706,0.0463998528118308,688,"And, your suit is rated for how many G's, Sir ?"
5009,4452,1,7,60,68,1.1323529411764706,0.0463998528118308,688,"Lunarhouse, sir."
4959,4452,0,9,59,68,1.1323529411764706,0.0414000577075105,688,Forget to tip the Alien BellHopper at your peril!
4973,4452,0,9,59,68,1.1323529411764706,0.0414000577075105,688,Decompression room to the right but don't forget to wipe your shoes before you go in.
4989,4452,1,7,60,68,1.1323529411764706,0.0463998528118308,688,"I believe your Rover is waiting, sir... ma'am... martian?"
2903,4452,2,5,61,68,1.1323529411764706,0.05091098018830443,688,"I'm sorry sir but in this building 35 is the limit, not the sky."
4880,4452,1,7,60,68,1.1323529411764706,0.0463998528118308,688,Second Planet Please
2769,4452,2,5,61,68,1.1323529411764706,0.05091098018830443,688,The turn to “disinformation” reminds me of the way “ideology” worked against social theory in the 1960s.
4953,4452,3,3,62,68,1.1323529411764706,0.055053696211138176,688,"Sorry, I'm supposed to get out on the 85092102nd floor."
2421,4452,0,9,59,68,1.1323529411764706,0.0414000577075105,688,"Sir, the music playing then was ""A Foggy Day"". But we've arrived ""On A Clear Day""."
2345,4452,1,7,60,68,1.1323529411764706,0.0463998528118308,688,I want to scrape the sky.
2312,4452,1,7,60,68,1.1323529411764706,0.0463998528118308,688,What do you mean that elevator doesn't go to space?
2109,4452,1,7,60,68,1.1323529411764706,0.0463998528118308,688,We're dealing with serious budget issues.
2017,4452,2,5,61,68,1.1323529411764706,0.05091098018830443,688,Sorry - this elevator doesn't go that far up.
1791,4452,1,7,60,68,1.1323529411764706,0.0463998528118308,688,"They're on the left, and no, I can't assist you any further."
1771,4452,0,9,59,68,1.1323529411764706,0.0414000577075105,688,There's a new Uber drone stop on the roof.
1314,4452,1,7,60,68,1.1323529411764706,0.0463998528118308,688,Ghostbusters! What do you want?
2494,4452,1,7,60,68,1.1323529411764706,0.0463998528118308,688,"Great job kids, they didn’t suspect a thing!"
1280,4452,0,9,59,68,1.1323529411764706,0.0414000577075105,688,"‘I’m sorry, it doesn’t come with a seat belt.’"
2664,4475,1,7,62,70,1.1285714285714286,0.04514264748228169,688,"Can you jump to get that weightless feelin'?  Go for it, buddy!"
2713,4476,0,8,56,64,1.125,0.041666666666666664,688,"Yes, your space food has been delivered to your room"
2886,4476,1,6,57,64,1.125,0.0472455591261534,688,I’m looking for the new elevator to the moon but First I need to stop at Macy’s to do my Christmas shopping.
3380,4476,0,8,56,64,1.125,0.041666666666666664,688,I can only take you to the top floor.
3474,4476,1,6,57,64,1.125,0.0472455591261534,688,"Sorry, sir, we don't have a 5,237th floor."
3565,4476,0,8,56,64,1.125,0.041666666666666664,688,PH floor 645667899 has adequate oxygen levels and supports plant life.
3710,4476,0,8,56,64,1.125,0.041666666666666664,688,"I’m sorry, Sir.  This elevator only goes to the 23rd floor."
3795,4476,0,8,56,64,1.125,0.041666666666666664,688,"Hey dude ,you should check out the awesome plant around the corner."
3807,4476,1,6,57,64,1.125,0.0472455591261534,688,"3rd floor; Sinks, Toilets and Spaceforce"
3968,4476,2,4,58,64,1.125,0.052231930877334055,688,New shuttle still not ready?
3975,4476,0,8,56,64,1.125,0.041666666666666664,688,"Sorry sir, but we only go to the 21st floor."
4826,4476,0,8,56,64,1.125,0.041666666666666664,688,"Third floor...menswear, shoes, Space Force..."
4102,4476,0,8,56,64,1.125,0.041666666666666664,688,Your wife just got off on the top floor in her gear. You guys are really taking this honeymoon thing to another level.
4298,4476,1,6,57,64,1.125,0.0472455591261534,688,"None of the floors are called ""Mars""."
4302,4476,0,8,56,64,1.125,0.041666666666666664,688,One small step for man.  One giant lobby for a toddler.
2647,4476,1,6,57,64,1.125,0.0472455591261534,688,Floor one... no need for the giant leap.
5060,4476,1,6,57,64,1.125,0.0472455591261534,688,"Fumigating the penthouse again, Mr. Wellington?"
5210,4476,0,8,56,64,1.125,0.041666666666666664,688,"Even with your generous tip, the penthouse is as high as we go."
5226,4476,1,6,57,64,1.125,0.0472455591261534,688,"Take me to a floor with deep space and no life."""
5266,4476,0,8,56,64,1.125,0.041666666666666664,688,"You know what they say, “One small step”."
5331,4476,1,6,57,64,1.125,0.0472455591261534,688,Excuse me. What floor did you say again?
4066,4476,1,6,57,64,1.125,0.0472455591261534,688,"Sir, this elevator definitely will not take you to the space capsule"
2482,4476,1,6,57,64,1.125,0.0472455591261534,688,"Not yet?....ok, just let me know when."
3259,4476,0,8,56,64,1.125,0.041666666666666664,688,3-2-1 and a smaller step for mankind.
759,4476,0,8,56,64,1.125,0.041666666666666664,688,"Okay Major Tom, this is ground control."
2349,4476,0,8,56,64,1.125,0.041666666666666664,688,"Sorry, sir. We only go to the 102nd floor."
101,4476,0,8,56,64,1.125,0.041666666666666664,688,"that chick who drove across the country in diapers to kill her husband or whatever— how was she, as like a spaceman?  on god i bet she was Super good"
132,4476,0,8,56,64,1.125,0.041666666666666664,688,Don’t stop until we lose gravity.
142,4476,0,8,56,64,1.125,0.041666666666666664,688,Space voyage through Heavenward
450,4476,0,8,56,64,1.125,0.041666666666666664,688,"Sorry, Mr. Branson, the penthouse is as close to the moon as I can get you."
516,4476,1,6,57,64,1.125,0.0472455591261534,688,"One small step for a man, one giant leap for the co-op board."
819,4476,0,8,56,64,1.125,0.041666666666666664,688,"Sorruy, we only go up 99 floors!"
836,4476,0,8,56,64,1.125,0.041666666666666664,688,I'm assuming you want to go up?
1225,4476,1,6,57,64,1.125,0.0472455591261534,688,"5th floor; take a left through Men's Wear and UFOs will be on your right"".."
980,4476,0,8,56,64,1.125,0.041666666666666664,688,Is the Oxygen level low on the penthouse?
1300,4476,0,8,56,64,1.125,0.041666666666666664,688,Have a good night Sir/Madam.
1391,4476,0,8,56,64,1.125,0.041666666666666664,688,"For the last time, YES. I AM Edward’s escort for the weekend!"
1490,4476,0,8,56,64,1.125,0.041666666666666664,688,"The ad may have overstated the case a little, sir.  The ""stratospheric penthouse with a view"" is still very much in breathing bounds."
1593,4476,0,8,56,64,1.125,0.041666666666666664,688,"When I say blastoff , hit 4!"
1618,4476,0,8,56,64,1.125,0.041666666666666664,688,"On behalf of Acme Space Elevators, welcome back down to earth."
1668,4476,1,6,57,64,1.125,0.0472455591261534,688,"Sir, would you like your countdown?"
1679,4476,0,8,56,64,1.125,0.041666666666666664,688,Lost & Found Dept straight ahead!
2061,4476,1,6,57,64,1.125,0.0472455591261534,688,For some reason I assumed you were going up.
1251,4476,1,6,57,64,1.125,0.0472455591261534,688,"That’s one small step for me, one giant button press for you."
2695,4519,0,8,59,67,1.1194029850746268,0.039913905875911725,688,What are you waiting for? David Pumpkins?
3890,4520,0,7,54,61,1.1147540983606556,0.04114721441970865,688,"Houston, you oversold me on this."
4169,4520,0,7,54,61,1.1147540983606556,0.04114721441970865,688,I’m sure you’ll find something of interest.
4316,4520,0,7,54,61,1.1147540983606556,0.04114721441970865,688,Please exit through the rear door.
3560,4520,1,5,55,61,1.1147540983606556,0.04732379255652672,688,Fake news Mr. President.  The tower's elevators do not reach earth exit velocity.
5149,4520,0,7,54,61,1.1147540983606556,0.04114721441970865,688,To the cafeteria please.
3371,4520,0,7,54,61,1.1147540983606556,0.04114721441970865,688,Did you take a left turn at Albuquerque?
4405,4520,0,7,54,61,1.1147540983606556,0.04114721441970865,688,"Zero-G, as usual, Sir?"
3365,4520,1,5,55,61,1.1147540983606556,0.04732379255652672,688,"Boy Santa, the new outfit looks good, but really, no more chimneys?"
3411,4520,0,7,54,61,1.1147540983606556,0.04114721441970865,688,"I’m sorry, did you mean ""headed to lunch?"""
4567,4520,0,7,54,61,1.1147540983606556,0.04114721441970865,688,We've redecorated the launch tower since you visited last.
5176,4520,0,7,54,61,1.1147540983606556,0.04114721441970865,688,"Safe travels out there, sir.  There are a lot of crazy drivers on the freeway."
4589,4520,0,7,54,61,1.1147540983606556,0.04114721441970865,688,I’m a pot smoker and don’t want to offend anyone.
4642,4520,1,5,55,61,1.1147540983606556,0.04732379255652672,688,"Once more Charlie, time to unclog this $360 million residential tower's $6 outflow connection to the sewer system!"""
4743,4520,0,7,54,61,1.1147540983606556,0.04114721441970865,688,Are you my module pilot? Nice to meet you. I am Steve!
4765,4520,1,5,55,61,1.1147540983606556,0.04732379255652672,688,I told them to stop the world and let me off!
4837,4520,0,7,54,61,1.1147540983606556,0.04114721441970865,688,"Going up, i'm assuming?"
4884,4520,0,7,54,61,1.1147540983606556,0.04114721441970865,688,"Seventh floor,please"
5008,4520,0,7,54,61,1.1147540983606556,0.04114721441970865,688,"I'm sorry sir, this elevator does not go to infinity or beyond."
5050,4520,0,7,54,61,1.1147540983606556,0.04114721441970865,688,"That's one small press for man, one giant leap for elevator kind."
3242,4520,1,5,55,61,1.1147540983606556,0.04732379255652672,688,"Sir, I see you're prepared for our rarefied New York air."
2063,4520,0,7,54,61,1.1147540983606556,0.04114721441970865,688,"Sir, fire sale was just a figure of speech."
3235,4520,1,5,55,61,1.1147540983606556,0.04732379255652672,688,I get altitude sickness.
1633,4520,0,7,54,61,1.1147540983606556,0.04114721441970865,688,"Mr. McConaughey, it's time to move on"
3062,4520,0,7,54,61,1.1147540983606556,0.04114721441970865,688,"Should I call a Land Rover, sir?"
3122,4520,0,7,54,61,1.1147540983606556,0.04114721441970865,688,Mars ain’t the kind of place to raise your kids
204,4520,0,7,54,61,1.1147540983606556,0.04114721441970865,688,Elevators terrify me. | usually take the stairs.’
218,4520,1,5,55,61,1.1147540983606556,0.04732379255652672,688,-Where can I take you Siz?  -Fly me to the moon and let me play among the stars
303,4520,1,5,55,61,1.1147540983606556,0.04732379255652672,688,"No, sir, I'm sorry, this isn't Mars. You're in Washington D.C."
394,4520,0,7,54,61,1.1147540983606556,0.04114721441970865,688,Good luck in Yankee Candle.
445,4520,2,3,56,61,1.1147540983606556,0.05278247274773007,688,"10,000 th floor:moon, mars,and beyond"
1361,4520,1,5,55,61,1.1147540983606556,0.04732379255652672,688,You must be the 'missile toe' ordered for the Christmas party at 833
1866,4520,1,5,55,61,1.1147540983606556,0.04732379255652672,688,"Sorry, not his Ghost.... I'm Strong, only Strong but with Arms."
2,4520,1,5,55,61,1.1147540983606556,0.04732379255652672,688,They weren’t kidding about that penthouse in the sky
1962,4520,1,5,55,61,1.1147540983606556,0.04732379255652672,688,Rocket entry? Top floor.
2235,4520,1,5,55,61,1.1147540983606556,0.04732379255652672,688,That's one small step for [a] man.
2610,4520,1,5,55,61,1.1147540983606556,0.04732379255652672,688,"Takes about two years to acclimate to our air on this planet. Earth was waaaay better. But hey, even the suites are cheap here."
2755,4520,1,5,55,61,1.1147540983606556,0.04732379255652672,688,I'm so sorry your toilet exploded.  Better luck next time.
2828,4520,0,7,54,61,1.1147540983606556,0.04114721441970865,688,"The zero gravity simulator is broken, so ground floor at top speed, please."
2966,4520,0,7,54,61,1.1147540983606556,0.04114721441970865,688,We've arrived in space. Please watch your step.
1932,4520,0,7,54,61,1.1147540983606556,0.04114721441970865,688,Just wondering if your license plate is ILIKESPACE24?
3060,4520,0,7,54,61,1.1147540983606556,0.04114721441970865,688,"You have to take stairs the rest of the way, ma'am."
81,4561,0,7,55,62,1.1129032258064515,0.04052040316035677,688,Did I win?
4143,4562,0,7,56,63,1.1111111111111112,0.039912289339283334,688,Astronauts are really down to Earth.
4142,4562,0,7,56,63,1.1111111111111112,0.039912289339283334,688,‘“Ground Floor. Indefinite articles.”
4114,4562,1,5,57,63,1.1111111111111112,0.04588053629154694,688,"To the moon, Alex... too the moon!"
3962,4562,1,5,57,63,1.1111111111111112,0.04588053629154694,688,I don’t do bucket lists.
3841,4562,0,7,56,63,1.1111111111111112,0.039912289339283334,688,"Penthouse, sir?  Or the command module?"
3828,4562,0,7,56,63,1.1111111111111112,0.039912289339283334,688,"Where is your pad located, sir?"
3513,4562,1,5,57,63,1.1111111111111112,0.04588053629154694,688,"Ast or not, only Wrights allowed on this floor!"
3614,4562,1,5,57,63,1.1111111111111112,0.04588053629154694,688,...with possible cosmic ray flurries
3586,4562,1,5,57,63,1.1111111111111112,0.04588053629154694,688,They thought a more luxurious ride up the launch pad is appropriate!
3504,4562,1,5,57,63,1.1111111111111112,0.04588053629154694,688,Oops. I must have pressed 009 instead of 909
3475,4562,0,7,56,63,1.1111111111111112,0.039912289339283334,688,I just want a normal college experience.
3385,4562,1,5,57,63,1.1111111111111112,0.04588053629154694,688,I was surprised to see a chair in an elevator too! You guys have made things so comfortable since I got back.
4292,4562,0,7,56,63,1.1111111111111112,0.039912289339283334,688,"I love you to the moon and back. Just get a real job someday, please?"
3111,4562,1,5,57,63,1.1111111111111112,0.04588053629154694,688,Another moon landing?
3102,4562,0,7,56,63,1.1111111111111112,0.039912289339283334,688,This is as far as it goes. There is no sub-sub-sub-sub-sub-sub-sub-basement
4306,4562,0,7,56,63,1.1111111111111112,0.039912289339283334,688,Which floor's the NASA-themed party?
5223,4562,2,3,58,63,1.1111111111111112,0.051157173304408075,688,You must be a manager.
4410,4562,1,5,57,63,1.1111111111111112,0.04588053629154694,688,"Down, please.  I've already been up."
5162,4562,1,5,57,63,1.1111111111111112,0.04588053629154694,688,It looks like you're gonna land that job
5171,4562,1,5,57,63,1.1111111111111112,0.04588053629154694,688,Good luck sir and rest assured that no one will know you are terrified of elevators.
5248,4562,0,7,56,63,1.1111111111111112,0.039912289339283334,688,"Another expedition to DUMBO, Mr. Gladstone?"
5155,4562,0,7,56,63,1.1111111111111112,0.039912289339283334,688,I guess the elevator to space has taken a lot of the joy out of it.
5114,4562,0,7,56,63,1.1111111111111112,0.039912289339283334,688,Take me all the way up...but as slowly as possible.
5038,4562,1,5,57,63,1.1111111111111112,0.04588053629154694,688,"Theoretical or not, I assure you, Sir, that this is not a space elevator."
4984,4562,1,5,57,63,1.1111111111111112,0.04588053629154694,688,Thirteens. Am I right?
4946,4562,1,5,57,63,1.1111111111111112,0.04588053629154694,688,It gets quite claustrophobic in here.
4931,4562,0,7,56,63,1.1111111111111112,0.039912289339283334,688,"When the doors close, will you be counting down the time to liftoff?"
4919,4562,1,5,57,63,1.1111111111111112,0.04588053629154694,688,have a lovely flight Sir
4882,4562,0,7,56,63,1.1111111111111112,0.039912289339283334,688,Which way to Mars?
4839,4562,0,7,56,63,1.1111111111111112,0.039912289339283334,688,"Takeoff begins at Floor 1, sir."
4710,4562,1,5,57,63,1.1111111111111112,0.04588053629154694,688,"12th Floor
Ladies lingerie
and 
Launch Pad"
4649,4562,0,7,56,63,1.1111111111111112,0.039912289339283334,688,"Sorry, I meant to say Ground Zero, not ground floor..."
4492,4562,1,5,57,63,1.1111111111111112,0.04588053629154694,688,"One giant leap for the Plaza, sir."
4394,4562,0,7,56,63,1.1111111111111112,0.039912289339283334,688,There's space available on this floor.
2756,4562,1,5,57,63,1.1111111111111112,0.04588053629154694,688,Someone's gotta tell Paul to stop putting chairs in the elevator.
377,4562,1,5,57,63,1.1111111111111112,0.04588053629154694,688,"5, 4, 3, 2, 1...

-Willa Jaymes, Rhinecliff, NY"
2562,4562,1,5,57,63,1.1111111111111112,0.04588053629154694,688,If we could get moving that would be great. I'm kind of running late for a thing.
2657,4562,0,7,56,63,1.1111111111111112,0.039912289339283334,688,Nothing beats that penthouse view!
2188,4562,0,7,56,63,1.1111111111111112,0.039912289339283334,688,"Coming back down is really hard, man!"
1,4562,1,5,57,63,1.1111111111111112,0.04588053629154694,688,Welcome Major Tom! great to see you back at ground control please leave your helmet at the lobby desk this season we have protein pills special merry christmas to you and your beloved wife!
183,4562,0,7,56,63,1.1111111111111112,0.039912289339283334,688,Welcome back Mrs. Portman! - My name Is Lucy.
220,4562,0,7,56,63,1.1111111111111112,0.039912289339283334,688,The floor is essentially tile
257,4562,1,5,57,63,1.1111111111111112,0.04588053629154694,688,Wife thinks I have acrophobia.
367,4562,0,7,56,63,1.1111111111111112,0.039912289339283334,688,That' the best soft landing I've done today.
410,4562,0,7,56,63,1.1111111111111112,0.039912289339283334,688,The Astronauts With Vertigo program is down the hall on the left.
473,4562,0,7,56,63,1.1111111111111112,0.039912289339283334,688,"I'm dressed up as an astronaut as I  can
reached for the stars!"
505,4562,1,5,57,63,1.1111111111111112,0.04588053629154694,688,They’re getting pretty high these days.
576,4562,1,5,57,63,1.1111111111111112,0.04588053629154694,688,"I have never been more certain. If you smelt it, you dealt it."
659,4562,0,7,56,63,1.1111111111111112,0.039912289339283334,688,"Boy, the atmosphere in this building has really changed since the election."
960,4562,0,7,56,63,1.1111111111111112,0.039912289339283334,688,"Going up"" was a term with a limit"
1018,4562,1,5,57,63,1.1111111111111112,0.04588053629154694,688,Down or up sir ?
1076,4562,0,7,56,63,1.1111111111111112,0.039912289339283334,688,Going up or to the costume ball
456,4562,0,7,56,63,1.1111111111111112,0.039912289339283334,688,I usually just leave the elevator to pee.
1543,4562,0,7,56,63,1.1111111111111112,0.039912289339283334,688,"Sorry, this elevator only goes down."
2558,4562,1,5,57,63,1.1111111111111112,0.04588053629154694,688,The moon's got nothing on 16F.
1453,4562,0,7,56,63,1.1111111111111112,0.039912289339283334,688,What do YOU mean we're going up?
2392,4562,1,5,57,63,1.1111111111111112,0.04588053629154694,688,"The lobby is gravity-free, so prepare to hit the ceiling"
2270,4562,0,7,56,63,1.1111111111111112,0.039912289339283334,688,"No offense, but has anyone else ever told you that you're kind of a blank slate?"
2268,4562,0,7,56,63,1.1111111111111112,0.039912289339283334,688,"I think you're looking for sub-basement, sir."
2257,4562,1,5,57,63,1.1111111111111112,0.04588053629154694,688,Is the Mrs. expecting you this year?
2192,4562,0,7,56,63,1.1111111111111112,0.039912289339283334,688,"I will not say ""Going--you know what"" for less than $200."
2500,4562,0,7,56,63,1.1111111111111112,0.039912289339283334,688,"Gonna level with ya Steve, I fart in the elevator right before I get to my floor every chance I get. Jokes on me today, I'm choking on doodoo clouds in here haha"
1867,4562,2,3,58,63,1.1111111111111112,0.051157173304408075,688,Yelp said the restaurant had no atmosphere.
1804,4562,1,5,57,63,1.1111111111111112,0.04588053629154694,688,you know this only goes to the 14th floor right ?
1713,4562,1,5,57,63,1.1111111111111112,0.04588053629154694,688,How do you go to the bathroom in that thing?
1682,4562,0,7,56,63,1.1111111111111112,0.039912289339283334,688,Got the day off?
1681,4562,1,5,57,63,1.1111111111111112,0.04588053629154694,688,"There is nothing more annoying than seeing an astronaut, without his spaceship, taking an elevator to the 6th floor."
1570,4562,1,5,57,63,1.1111111111111112,0.04588053629154694,688,Seventh Floor - Lunar and Extraterrestrial Outerwear
3215,4630,0,6,51,57,1.105263157894737,0.04101019591968312,688,"That's one small step for man, one giant leap for the sixth floor."
1903,4630,0,6,51,57,1.105263157894737,0.04101019591968312,688,"Unfortunately, your wife is also no stranger to re-entry."
3771,4630,1,4,52,57,1.105263157894737,0.04804583837764614,688,"""I'm just warning you, I get pretty panicky in confined spaces."
582,4630,0,6,51,57,1.105263157894737,0.04101019591968312,688,"Sorry sir, it only goes up to the 12th floor."
4808,4630,1,4,52,57,1.105263157894737,0.04804583837764614,688,Will the 73rd floor suffice for infinity and beyond?
2913,4630,1,4,52,57,1.105263157894737,0.04804583837764614,688,"This is it, sir. We don't have a 240,000th floor."
3416,4636,1,4,53,58,1.103448275862069,0.04724506633555822,688,Our service has been added due to a cut in your salary.
3397,4636,0,6,52,58,1.103448275862069,0.04033776909417944,688,"Sorry sir, the elevator doesn't go quite that high."
3369,4636,0,6,52,58,1.103448275862069,0.04033776909417944,688,I think you're at the wrong station!
3277,4636,1,4,53,58,1.103448275862069,0.04724506633555822,688,"Where would you like to go, sir?""
""Where do you think?"
3328,4636,1,4,53,58,1.103448275862069,0.04724506633555822,688,"I'm sorry you have to pass by the perfume counter again, sir."
3315,4636,0,6,52,58,1.103448275862069,0.04033776909417944,688,I don’t care that the restrooms are only for patrons.
3435,4636,0,6,52,58,1.103448275862069,0.04033776909417944,688,"Top floor, hmmm?"
3262,4636,0,6,52,58,1.103448275862069,0.04033776909417944,688,All the IP please
3249,4636,0,6,52,58,1.103448275862069,0.04033776909417944,688,"I know it’s not my place, Mr. Moby, but I can’t resist - you’re a cunt."
3248,4636,1,4,53,58,1.103448275862069,0.04724506633555822,688,I heard that the view from the rooftop terrace is out of this world.
3216,4636,0,6,52,58,1.103448275862069,0.04033776909417944,688,Whichever floor has the nicest bathrooms please.
3336,4636,0,6,52,58,1.103448275862069,0.04033776909417944,688,"No, sir, this is 1952, you'll find 2052 on the top floor."
3446,4636,0,6,52,58,1.103448275862069,0.04033776909417944,688,Where's your son? You said it was take your kid to work day this morning.
3643,4636,1,4,53,58,1.103448275862069,0.04724506633555822,688,The 'no ozone' bar has moved to the 5th floor.
3454,4636,0,6,52,58,1.103448275862069,0.04033776909417944,688,This is as high as this elevator goes.
3704,4636,0,6,52,58,1.103448275862069,0.04033776909417944,688,"To infinity and beyond, thank you."
3699,4636,1,4,53,58,1.103448275862069,0.04724506633555822,688,"Thank you for helping me with the elevator, good sir. I am off to my day job as a spaceman. Toodle Loo!"
3654,4636,0,6,52,58,1.103448275862069,0.04033776909417944,688,Down sir ? How many fathoms ?
3634,4636,0,6,52,58,1.103448275862069,0.04033776909417944,688,"All this, to take a piss."
3631,4636,0,6,52,58,1.103448275862069,0.04033776909417944,688,"2nd floor:
Contagion to the right."
3611,4636,0,6,52,58,1.103448275862069,0.04033776909417944,688,"But sir, the Air Quality Index is only 65 today."
3588,4636,0,6,52,58,1.103448275862069,0.04033776909417944,688,The space station is on a higher floor.
3453,4636,0,6,52,58,1.103448275862069,0.04033776909417944,688,"No offense, Mr. Aldrin, just watch that step."
3577,4636,0,6,52,58,1.103448275862069,0.04033776909417944,688,"Sorry, this one only goes up 35 floors- take the express on the lobby side."
3546,4636,0,6,52,58,1.103448275862069,0.04033776909417944,688,It’s my bachelorette blastoff costume.
3535,4636,0,6,52,58,1.103448275862069,0.04033776909417944,688,"This hotel has only 11 floors, sir. I'm afraid you're in the wrong century."
3514,4636,0,6,52,58,1.103448275862069,0.04033776909417944,688,Do you get claustrophobic working in such tight quarters?
3488,4636,1,4,53,58,1.103448275862069,0.04724506633555822,688,Congratulations! Its a successful landing.
3471,4636,1,4,53,58,1.103448275862069,0.04724506633555822,688,"I'm sorry sir. You must have been given the wrong address.
There is no launchpad on top of this building!"
3461,4636,0,6,52,58,1.103448275862069,0.04033776909417944,688,"One giant leap, sir?"
3460,4636,0,6,52,58,1.103448275862069,0.04033776909417944,688,Floor five: notions and stationery
3547,4636,0,6,52,58,1.103448275862069,0.04033776909417944,688,That's right Mr. Johnson...No flu for you. No flu for you.
3212,4636,0,6,52,58,1.103448275862069,0.04033776909417944,688,Afraid of heights?
2850,4636,0,6,52,58,1.103448275862069,0.04033776909417944,688,Whadaya mean it only goes to the 88th floor?
3147,4636,0,6,52,58,1.103448275862069,0.04033776909417944,688,"I'm sorry, but this elevator stops at the 70th floor."
2716,4636,0,6,52,58,1.103448275862069,0.04033776909417944,688,Your capsule awaits.
2697,4636,0,6,52,58,1.103448275862069,0.04033776909417944,688,"Top floor!  From here on up, Mister Moonman, you're on your own."
2694,4636,0,6,52,58,1.103448275862069,0.04033776909417944,688,Did the elevator ride feel like space?
2691,4636,0,6,52,58,1.103448275862069,0.04033776909417944,688,......the film crew will be along any minute......
2685,4636,0,6,52,58,1.103448275862069,0.04033776909417944,688,Terrific moon-walk sir. What floor?
2655,4636,2,2,54,58,1.103448275862069,0.053264030739395375,688,"Going up, I assume

Or:  Sorry, we only go to the 63rd floor."
2634,4636,1,4,53,58,1.103448275862069,0.04724506633555822,688,"One small step for man, one giant leap onto the 17th floor of the Chrysler Tower!"
2746,4636,0,6,52,58,1.103448275862069,0.04033776909417944,688,Launchpad on floor 31
2625,4636,1,4,53,58,1.103448275862069,0.04724506633555822,688,"Roger that, Houston. T -10 and counting."
2603,4636,2,2,54,58,1.103448275862069,0.053264030739395375,688,"Actually I wanted to be an elevator operator when I grew up, too."
2571,4636,0,6,52,58,1.103448275862069,0.04033776909417944,688,I parked my Duesenberg before the pipe ruptured
2567,4636,0,6,52,58,1.103448275862069,0.04033776909417944,688,"Where to mis-
Oh."
2557,4636,1,4,53,58,1.103448275862069,0.04724506633555822,688,"Finally, some space."
2553,4636,1,4,53,58,1.103448275862069,0.04724506633555822,688,Let me guess. You want the floor with the custom tailor.
2546,4636,0,6,52,58,1.103448275862069,0.04033776909417944,688,"I think you'll find this space isn't quite as light as what you're accustomed to, but it's airier."
2542,4636,0,6,52,58,1.103448275862069,0.04033776909417944,688,Breathing isn't easy wearing shirt and trousers on earth
2613,4636,0,6,52,58,1.103448275862069,0.04033776909417944,688,"With this small step, Bob, your giant leaping days are over."
3210,4636,1,4,53,58,1.103448275862069,0.04724506633555822,688,Give my regards to Species 8472.
2749,4636,1,4,53,58,1.103448275862069,0.04724506633555822,688,What did you think the chair was for?
2797,4636,1,4,53,58,1.103448275862069,0.04724506633555822,688,Up 240 thousand miles please
3091,4636,0,6,52,58,1.103448275862069,0.04033776909417944,688,"Sorry, Airheads are ten floors up."
3066,4636,0,6,52,58,1.103448275862069,0.04033776909417944,688,This is halloween isn't it?
3065,4636,0,6,52,58,1.103448275862069,0.04033776909417944,688,Forgot the spaceship keys again?
3017,4636,0,6,52,58,1.103448275862069,0.04033776909417944,688,Off to eat for a daily launch break.
2999,4636,0,6,52,58,1.103448275862069,0.04033776909417944,688,"Elon Musk's apartment, thanks."
2987,4636,0,6,52,58,1.103448275862069,0.04033776909417944,688,"Sir, you may be in the wrong elevator. The space elevator is down the hall, to the left. Remember to keep on your helmet. It goes to astronomical heights!"
2978,4636,0,6,52,58,1.103448275862069,0.04033776909417944,688,Top floor - form here on you're on your own
2790,4636,0,6,52,58,1.103448275862069,0.04033776909417944,688,I’m not allowed to go above the fortieth floor.
2953,4636,0,6,52,58,1.103448275862069,0.04033776909417944,688,"sorry, the down elevator is to your left."
2907,4636,0,6,52,58,1.103448275862069,0.04033776909417944,688,"you know that ""rarified air"" is just an expression, right?"
2899,4636,1,4,53,58,1.103448275862069,0.04724506633555822,688,"But we don't have an ""outer space"" floor."
3708,4636,0,6,52,58,1.103448275862069,0.04033776909417944,688,"""Thank God for clean coal, crude and trump, right, sir?"
2826,4636,1,4,53,58,1.103448275862069,0.04724506633555822,688,This car only goes to the 21st floor.
2823,4636,0,6,52,58,1.103448275862069,0.04033776909417944,688,Ground floor.  Space Force office is on your right.
2817,4636,0,6,52,58,1.103448275862069,0.04033776909417944,688,"The men's room is one small 'step down' the hallway, but how do you....."
2800,4636,1,4,53,58,1.103448275862069,0.04724506633555822,688,"This is the exit to the roof, sir; would you like me to call a rocket for you?"
2925,4636,0,6,52,58,1.103448275862069,0.04033776909417944,688,"Sir,I think you me looking for the sub-basement"
3713,4636,0,6,52,58,1.103448275862069,0.04033776909417944,688,Put the restrooms on the floor above the food court.... What would you expect?!
4060,4636,1,4,53,58,1.103448275862069,0.04724506633555822,688,This is floor 10...then 9...then 8...then 7...then 6...
3724,4636,0,6,52,58,1.103448275862069,0.04033776909417944,688,"Welcome back to the Ritz, Mr. Aldrin."
5011,4636,1,4,53,58,1.103448275862069,0.04724506633555822,688,"Yes Sir, cryptocurrency is acceptable!"
4967,4636,0,6,52,58,1.103448275862069,0.04033776909417944,688,I don’t think we have that floor.
4949,4636,1,4,53,58,1.103448275862069,0.04724506633555822,688,"You're going to be disappointed with how high this one goes, sir."
4893,4636,1,4,53,58,1.103448275862069,0.04724506633555822,688,I’ll always be here for you.
4865,4636,0,6,52,58,1.103448275862069,0.04033776909417944,688,"I'm sorry, is there a floor beyond ""infinity?"""
4846,4636,1,4,53,58,1.103448275862069,0.04724506633555822,688,"Sorry, I don't have a button here that says ""Up Up and Beyond"""
4824,4636,0,6,52,58,1.103448275862069,0.04033776909417944,688,I must warn you - this goes pretty fast
4800,4636,1,4,53,58,1.103448275862069,0.04724506633555822,688,"Oh no Sir, you must have the wrong elevator, this is the Hilton."
4799,4636,0,6,52,58,1.103448275862069,0.04033776909417944,688,"No, not as high.  But I have had more successful landings than you."
4795,4636,0,6,52,58,1.103448275862069,0.04033776909417944,688,"No, I said 'get off the lift,' not 'lift-off.'"
4735,4636,0,6,52,58,1.103448275862069,0.04033776909417944,688,"Sorry, Colonel, but you have to use the service elevator."
4729,4636,1,4,53,58,1.103448275862069,0.04724506633555822,688,It took me a few months to get used to the altitude.
4689,4636,0,6,52,58,1.103448275862069,0.04033776909417944,688,But I can get you to the 67th floor observatory.
4669,4636,0,6,52,58,1.103448275862069,0.04033776909417944,688,Did you just listen to Astroworld?
4658,4636,1,4,53,58,1.103448275862069,0.04724506633555822,688,It's a Hollywood set.
5031,4636,0,6,52,58,1.103448275862069,0.04033776909417944,688,"Yes sir, one giant step for man, and one giant step to the penthouse."
5056,4636,1,4,53,58,1.103448275862069,0.04724506633555822,688,Having your change of clothes laundered?
5098,4636,0,6,52,58,1.103448275862069,0.04033776909417944,688,"We’ve had some upgrades to the Space Station, sir."
5119,4636,0,6,52,58,1.103448275862069,0.04033776909417944,688,"Nervous about going to the 103rd floor, Sir?"
5304,4636,0,6,52,58,1.103448275862069,0.04033776909417944,688,"Last time, okay?  3,2,1 ..."
5289,4636,1,4,53,58,1.103448275862069,0.04724506633555822,688,Sir? How high do you expect this elevator to go?
5317,4636,0,6,52,58,1.103448275862069,0.04033776909417944,688,I thought you were taking the space elevator
5321,4636,0,6,52,58,1.103448275862069,0.04033776909417944,688,"The top floor is 8, not infinity, sir."
2530,4636,0,6,52,58,1.103448275862069,0.04033776909417944,688,The penthouse?
5283,4636,0,6,52,58,1.103448275862069,0.04033776909417944,688,Our new tax dollars at work- Doormen now at launch entry points!
5274,4636,1,4,53,58,1.103448275862069,0.04724506633555822,688,"By law, I get off at 275.  Godspeed."
4644,4636,0,6,52,58,1.103448275862069,0.04033776909417944,688,"The sub-basement, please; I’m here to fix the leak."
5264,4636,0,6,52,58,1.103448275862069,0.04033776909417944,688,Now it's time to leave the capsule if you dare.
5228,4636,0,6,52,58,1.103448275862069,0.04033776909417944,688,The air quality has gone down.
5201,4636,0,6,52,58,1.103448275862069,0.04033776909417944,688,"It's not mars, but it's close."
5182,4636,0,6,52,58,1.103448275862069,0.04033776909417944,688,"One small step for man, one giant leap for the condo board."
5158,4636,0,6,52,58,1.103448275862069,0.04033776909417944,688,Sixth floor.....the moon please.
5157,4636,0,6,52,58,1.103448275862069,0.04033776909417944,688,"So it’s true, the air really is thinner at the top."
5153,4636,1,4,53,58,1.103448275862069,0.04724506633555822,688,We're going to need a bigger elevator.
5150,4636,0,6,52,58,1.103448275862069,0.04033776909417944,688,"So sorry, sir. There is nothing after PH."
5259,4636,0,6,52,58,1.103448275862069,0.04033776909417944,688,..We're going through some budget cuts
4611,4636,0,6,52,58,1.103448275862069,0.04033776909417944,688,"You know, I used to be an astronaut too”.


Jude Baue"
4610,4636,0,6,52,58,1.103448275862069,0.04033776909417944,688,"Here's the ground to control, Major Tom"
4607,4636,0,6,52,58,1.103448275862069,0.04033776909417944,688,"Sorry, this building doesn't go that high.""

Michael Rogness, St. Paul M"
4166,4636,0,6,52,58,1.103448275862069,0.04033776909417944,688,"""Softest blast-off I ever had!"
4118,4636,0,6,52,58,1.103448275862069,0.04033776909417944,688,"Sir, I don’t think it goes that high."
4037,4636,0,6,52,58,1.103448275862069,0.04033776909417944,688,Feels good to be on the ground again.
4029,4636,1,4,53,58,1.103448275862069,0.04724506633555822,688,"Sir, this is a 47-story building. The penthouse is about a thousand small steps from the lobby."
4027,4636,0,6,52,58,1.103448275862069,0.04033776909417944,688,"Sir, if you want to go 'to the stars', that's the next floor!"
4002,4636,1,4,53,58,1.103448275862069,0.04724506633555822,688,I just always take advantage wherever I can.
3953,4636,1,4,53,58,1.103448275862069,0.04724506633555822,688,"This is as high as I go. To go higher, Move to the next bank of elevators"
4170,4636,0,6,52,58,1.103448275862069,0.04033776909417944,688,"I'm sorry Captain,  but this elevator doesn't go to Mars."
3916,4636,0,6,52,58,1.103448275862069,0.04033776909417944,688,"One of these days Bellhop..one of these days, bam, zoom, straight to the moon."
3840,4636,1,4,53,58,1.103448275862069,0.04724506633555822,688,"Shall I Call A Cab, Sir?"
3811,4636,0,6,52,58,1.103448275862069,0.04033776909417944,688,Do you really want to race my elevator to the top?
3789,4636,0,6,52,58,1.103448275862069,0.04033776909417944,688,"Floor 118, Sir. The rarefied atmosphere of the Executive Dining Room awaits, second door on the right."
3754,4636,0,6,52,58,1.103448275862069,0.04033776909417944,688,There are quicker ways to space than this elevator.
3738,4636,0,6,52,58,1.103448275862069,0.04033776909417944,688,"If you knew you were going to stink up the elevator, why not just take the stairs?"
3736,4636,0,6,52,58,1.103448275862069,0.04033776909417944,688,"Yeah, I am feeling a little spacey today.  Thanks for noticing."
3731,4636,0,6,52,58,1.103448275862069,0.04033776909417944,688,"I'm sorry, this only goes to the 11th floor"
3858,4636,0,6,52,58,1.103448275862069,0.04033776909417944,688,"One hundred twenty six millionth floor ... Rocks, regolith, and customer complaints departments"
3715,4636,0,6,52,58,1.103448275862069,0.04033776909417944,688,The Launchpad is just past Children's Footwear.
4174,4636,0,6,52,58,1.103448275862069,0.04033776909417944,688,"- Welcome home sir!
- Thanks! Ah! Shoot, I forgot the grocery. Hold the elevator please!"
4214,4636,0,6,52,58,1.103448275862069,0.04033776909417944,688,I’ll have a moon on the rocks.
4525,4636,1,4,53,58,1.103448275862069,0.04724506633555822,688,Sorry - we don't go down that far.
4522,4636,1,4,53,58,1.103448275862069,0.04724506633555822,688,They are spacey but not that spacey.
4514,4636,0,6,52,58,1.103448275862069,0.04033776909417944,688,"Will that be the penthouse, Sir?"
4510,4636,1,4,53,58,1.103448275862069,0.04724506633555822,688,This thing gets some momentum going but not enough to break free of earth’s gravity.
4504,4636,0,6,52,58,1.103448275862069,0.04033776909417944,688,"With all due respect, I think you've gone a little too far now in fearing New York City smog."
4490,4636,1,4,53,58,1.103448275862069,0.04724506633555822,688,We don't go lower than the first floor
4432,4636,0,6,52,58,1.103448275862069,0.04033776909417944,688,"Ma'am, I'm sorry, but this only goes up. It can't go to Orlando."
4181,4636,1,4,53,58,1.103448275862069,0.04724506633555822,688,"One small step for man, one giant leap for Black Friday."
4372,4636,0,6,52,58,1.103448275862069,0.04033776909417944,688,"Yes sir, NASA cuts are a ""booger"", but the penthouse still doesn't quite reach. Have you tried Mr. Musk?"
4350,4636,0,6,52,58,1.103448275862069,0.04033776909417944,688,"Ok....OK, Sir.  For the 3rd time today.   T minus 10...9...8"
5344,4636,0,6,52,58,1.103448275862069,0.04033776909417944,688,"You are aware that this building only has 42 floors, right?"
4333,4636,1,4,53,58,1.103448275862069,0.04724506633555822,688,"YOU SHOULD SIT ON THE CHAIR AND PRACTICE DRIVING.  
GOING UP !"
4314,4636,1,4,53,58,1.103448275862069,0.04724506633555822,688,"Oh sir, it's only 120 stories to the roof!"
4293,4636,1,4,53,58,1.103448275862069,0.04724506633555822,688,Sorry. Jupiter was Thursday.
4272,4636,0,6,52,58,1.103448275862069,0.04033776909417944,688,"This is the roof. After that, you're on your own, I'm afraid."
4230,4636,1,4,53,58,1.103448275862069,0.04724506633555822,688,This is as high as we go - you'll need to call Uber Space for the next phase.
4365,4636,0,6,52,58,1.103448275862069,0.04033776909417944,688,It didn't get you there last week either.
2524,4636,1,4,53,58,1.103448275862069,0.04724506633555822,688,"Cheese and grits,” she said. “Cheese AND grits."
760,4636,0,6,52,58,1.103448275862069,0.04033776909417944,688,"-Which floor?
-One Small Step For Man"
2489,4636,1,4,53,58,1.103448275862069,0.04724506633555822,688,"Top floor, sir. Count down? To Christmas?  Right, but no launch planned til New Years."
1052,4636,0,6,52,58,1.103448275862069,0.04033776909417944,688,The elevator to your left will take you the rest of the way to the moon.
1039,4636,0,6,52,58,1.103448275862069,0.04033776909417944,688,Can you press Jupiter
1027,4636,0,6,52,58,1.103448275862069,0.04033776909417944,688,The Elevator broken again?
1008,4636,0,6,52,58,1.103448275862069,0.04033776909417944,688,You could've told me this wasn't a space elevator
1005,4636,0,6,52,58,1.103448275862069,0.04033776909417944,688,"It's the haircut, isn't it?"
1004,4636,0,6,52,58,1.103448275862069,0.04033776909417944,688,I heard the Co-op Board is from outer-space
981,4636,0,6,52,58,1.103448275862069,0.04033776909417944,688,Third Floor: Space Bee Convention
963,4636,1,4,53,58,1.103448275862069,0.04724506633555822,688,"I need to simulate,""Lift Off"";send this on express to the roof."
897,4636,1,4,53,58,1.103448275862069,0.04724506633555822,688,No traffic but took forever to find a spot
856,4636,0,6,52,58,1.103448275862069,0.04033776909417944,688,Not mine kind a day!
754,4636,0,6,52,58,1.103448275862069,0.04033776909417944,688,"I'm recovering from an eye infection,"" they both said"
745,4636,1,4,53,58,1.103448275862069,0.04724506633555822,688,I already got my flu shot.
723,4636,0,6,52,58,1.103448275862069,0.04033776909417944,688,Geez...I thought the Space Force was a branch of the Housing Authority  !
722,4636,1,4,53,58,1.103448275862069,0.04724506633555822,688,I'm sorry--anything higher than the penthouse requires a security code.
708,4636,0,6,52,58,1.103448275862069,0.04033776909417944,688,"That's one small step for man, one giant leap for Manhattan."
1077,4636,0,6,52,58,1.103448275862069,0.04033776909417944,688,Did you find everything that you didn't need sir?
695,4636,0,6,52,58,1.103448275862069,0.04033776909417944,688,"Hey, I like your outfit!  What's it like up there?"
1111,4636,0,6,52,58,1.103448275862069,0.04033776909417944,688,"I'm sorry, sir, but this elevator doesn't go to '4-Gs.'"
1150,4636,0,6,52,58,1.103448275862069,0.04033776909417944,688,But there is no 13th  floor.
1475,4636,0,6,52,58,1.103448275862069,0.04033776909417944,688,Down or up?
1466,4636,0,6,52,58,1.103448275862069,0.04033776909417944,688,"Floor fifty million, please."
1450,4636,0,6,52,58,1.103448275862069,0.04033776909417944,688,Countdown?
1406,4636,1,4,53,58,1.103448275862069,0.04724506633555822,688,"Yes, I do think that you will get away with stealing the bathroom scale."
1382,4636,0,6,52,58,1.103448275862069,0.04033776909417944,688,"Godspeed, Jerald."
1366,4636,1,4,53,58,1.103448275862069,0.04724506633555822,688,I was told the atmosphere would be rarified.
1346,4636,0,6,52,58,1.103448275862069,0.04033776909417944,688,"110th Floor - rockets, gantries, space shuttles. Have a nice day."
1344,4636,1,4,53,58,1.103448275862069,0.04724506633555822,688,your shuttle is stuck in traffic on the Van wyck Expressway
1337,4636,0,6,52,58,1.103448275862069,0.04033776909417944,688,Careful. That' one small step.
1327,4636,0,6,52,58,1.103448275862069,0.04033776909417944,688,"Okayyy, not the launch party I expected."
1284,4636,1,4,53,58,1.103448275862069,0.04724506633555822,688,"Sir, welcome back to the ground floor. Tell me, were the 
chocolate chip cookies up in the space station any good?"
1268,4636,0,6,52,58,1.103448275862069,0.04033776909417944,688,"No sir, this isn't the Willy Wonka elevator."
1229,4636,0,6,52,58,1.103448275862069,0.04033776909417944,688,"So do the Russians also have a
‘13th Floor Mission?’"
1181,4636,1,4,53,58,1.103448275862069,0.04724506633555822,688,Is this going up?
1171,4636,1,4,53,58,1.103448275862069,0.04724506633555822,688,What floor Mr. West?
1148,4636,0,6,52,58,1.103448275862069,0.04033776909417944,688,"Sorry sir, this isn't your floor. I pressed all the buttons so we could do a countdown."
664,4636,0,6,52,58,1.103448275862069,0.04033776909417944,688,"I can take you to the tp floor.  From there, you'll have to call NASA."
652,4636,0,6,52,58,1.103448275862069,0.04033776909417944,688,"Given your acrophobia,
 I don’t know why you insist on living in the penthouse."
648,4636,1,4,53,58,1.103448275862069,0.04724506633555822,688,"Floor 42. Right this way to the Space Force cubicles, sir."
86,4636,0,6,52,58,1.103448275862069,0.04033776909417944,688,"You better wear pinstripes from now on, Mr. Cole"
82,4636,0,6,52,58,1.103448275862069,0.04033776909417944,688,I think we’re gonna need a bigger elevator.
73,4636,0,6,52,58,1.103448275862069,0.04033776909417944,688,NASA isnt launching rockets to the moon  anymore and SpaceX isnt Hiring.What would  you expect Fred!?
72,4636,0,6,52,58,1.103448275862069,0.04033776909417944,688,"You’ nl get used t to ‘the smell eventually,  maybe even love it."
64,4636,0,6,52,58,1.103448275862069,0.04033776909417944,688, 
52,4636,0,6,52,58,1.103448275862069,0.04033776909417944,688,"Yes sir, ll check to see if the dry cleaners can have your space suit back by Monday."
46,4636,0,6,52,58,1.103448275862069,0.04033776909417944,688,"please, forgot my rocket keys!"
43,4636,0,6,52,58,1.103448275862069,0.04033776909417944,688,"Last floor, please."
39,4636,0,6,52,58,1.103448275862069,0.04033776909417944,688,"I knew Pluto wasn’t an  ordinary planet, but how can I breath here?"
33,4636,0,6,52,58,1.103448275862069,0.04033776909417944,688,Can you please close the elevator doors? I’m running late for a meeting.
31,4636,1,4,53,58,1.103448275862069,0.04724506633555822,688,"GOING UP AND OUT, HOUSTON?"
26,4636,0,6,52,58,1.103448275862069,0.04033776909417944,688,Russian Interference Part 2 The Cosmos-Gate. Simply occupying.
24,4636,1,4,53,58,1.103448275862069,0.04724506633555822,688,"Fancy dress party?” “Yeah, redundant job theme."
14,4636,1,4,53,58,1.103448275862069,0.04724506633555822,688,"The two million seven- hundred eighty three thousand one hundred and twelth floor, please."
2502,4636,0,6,52,58,1.103448275862069,0.04033776909417944,688,"Good morning, Mr. Baumgartner, going up or down?"
98,4636,0,6,52,58,1.103448275862069,0.04033776909417944,688,reach the stars in our rooftop” don’t you  think?    It’s a bit exaggerated to
111,4636,0,6,52,58,1.103448275862069,0.04033776909417944,688,Harold’s friends  had failed to mention that  it wasn’t THAT kind of fancy dress  party.
117,4636,0,6,52,58,1.103448275862069,0.04033776909417944,688,"Hows the buisness doing par""  ""Astronomical"
130,4636,0,6,52,58,1.103448275862069,0.04033776909417944,688,"sir, your chair..."
537,4636,0,6,52,58,1.103448275862069,0.04033776909417944,688,You are overdressed.  The garage isn't  flooded.
532,4636,1,4,53,58,1.103448275862069,0.04724506633555822,688,The penthouse is the best I can do.
487,4636,1,4,53,58,1.103448275862069,0.04724506633555822,688,There you go sir: over the moon.
483,4636,0,6,52,58,1.103448275862069,0.04033776909417944,688,"Try chewing gum, it’s only twelve floors."
432,4636,0,6,52,58,1.103448275862069,0.04033776909417944,688,This elevator is not a moon shot sir. Please exit.
412,4636,1,4,53,58,1.103448275862069,0.04724506633555822,688,Our most spacious floor? The penthouse on 89.
376,4636,0,6,52,58,1.103448275862069,0.04033776909417944,688,"The moon chairs are to your right."""
1485,4636,1,4,53,58,1.103448275862069,0.04724506633555822,688,"I'm sorry sir, there is no ""Houston"" floor."
372,4636,0,6,52,58,1.103448275862069,0.04033776909417944,688,Hopeful.
227,4636,0,6,52,58,1.103448275862069,0.04033776909417944,688,"Sorry, Sir. The elevator only goes till the 273rd floor."
184,4636,1,4,53,58,1.103448275862069,0.04724506633555822,688,"3, 2, 1...lift me up!"
179,4636,1,4,53,58,1.103448275862069,0.04724506633555822,688,MERCURY WAS IN MY THIRD HOUSE! BAD DAY FOR A VIRGO.
175,4636,0,6,52,58,1.103448275862069,0.04033776909417944,688,"Spacesuit in NYC- protection from the tourists, subway air &  going broke."
149,4636,1,4,53,58,1.103448275862069,0.04724506633555822,688,"Well, I’m afraid we can only go to the 12th floor of this building."
148,4636,0,6,52,58,1.103448275862069,0.04033776909417944,688,"I need some space, honey"
140,4636,1,4,53,58,1.103448275862069,0.04724506633555822,688,"‘Hue?’ ""Stan?"
328,4636,0,6,52,58,1.103448275862069,0.04033776909417944,688,I take it your on the top floor?
1497,4636,0,6,52,58,1.103448275862069,0.04033776909417944,688,How fast up can you go?
160,4636,0,6,52,58,1.103448275862069,0.04033776909417944,688,"‘Well, they did say prices here were astronomical..’"
1520,4636,0,6,52,58,1.103448275862069,0.04033776909417944,688,You want to go to what floor?! You've got to be knid-ing me!
2318,4636,0,6,52,58,1.103448275862069,0.04033776909417944,688,"There's no sky bar, sir.  And there's no aquarium floor either.  The underground parking garage will have to do."
2288,4636,1,4,53,58,1.103448275862069,0.04724506633555822,688,"If you want more space, you're talkin' Hoboken."
2271,4636,0,6,52,58,1.103448275862069,0.04033776909417944,688,"Sorry, sir, LEO  is sold only online."
2261,4636,0,6,52,58,1.103448275862069,0.04033776909417944,688,Does this thing go any higher?
2256,4636,0,6,52,58,1.103448275862069,0.04033776909417944,688,"Smoking floor, Sir"
2255,4636,1,4,53,58,1.103448275862069,0.04724506633555822,688,Your fragrance free suite is the second door on the right.
2326,4636,0,6,52,58,1.103448275862069,0.04033776909417944,688,"It won’t protect you from astronomical rents, sir!"
2220,4636,1,4,53,58,1.103448275862069,0.04724506633555822,688,"John, take the suit off, we got rid of the asbestos this morning."
2196,4636,1,4,53,58,1.103448275862069,0.04724506633555822,688,"Trump tower’s space force floor has been closed indefinitely. Would you like the lobby, sir?"
2194,4636,1,4,53,58,1.103448275862069,0.04724506633555822,688,"Take me to the moon, Johnny"
2183,4636,0,6,52,58,1.103448275862069,0.04033776909417944,688,"Floor 1,000,059 please."
2172,4636,1,4,53,58,1.103448275862069,0.04724506633555822,688,This doesn't look like Mars
2170,4636,0,6,52,58,1.103448275862069,0.04033776909417944,688,The space station elevator leaves from the third floor.
2156,4636,1,4,53,58,1.103448275862069,0.04724506633555822,688,"Yes, sir. This elevator CAN go sky high."
2198,4636,0,6,52,58,1.103448275862069,0.04033776909417944,688,Forget the ahi tuna. Have the veal loon in the lounge. Frankie is at the piano.
2330,4636,0,6,52,58,1.103448275862069,0.04033776909417944,688,Got it. The elevator overshot the penthouse.
2337,4636,0,6,52,58,1.103448275862069,0.04033776909417944,688,"We have lift off. Seriously, get off."
2341,4636,0,6,52,58,1.103448275862069,0.04033776909417944,688,"No, not this one, try the other elevator for an out-of-this-world experience ."
1501,4636,2,2,54,58,1.103448275862069,0.053264030739395375,688,"NASA sent me, I’ll take it up from here!"
2480,4636,0,6,52,58,1.103448275862069,0.04033776909417944,688,"Buzz, your floor."
2469,4636,1,4,53,58,1.103448275862069,0.04724506633555822,688,"I bet this will be the last time my employees ask for a ""casual Friday""."
2466,4636,1,4,53,58,1.103448275862069,0.04724506633555822,688,The Executive Suite -- rarified turf indeed!
2441,4636,1,4,53,58,1.103448275862069,0.04724506633555822,688,If you hurry I can catch up.
2438,4636,0,6,52,58,1.103448275862069,0.04033776909417944,688,"I’m sorry sir, but this one is heading down"
2425,4636,0,6,52,58,1.103448275862069,0.04033776909417944,688,"One step for ma-"" uh what are you doing?
Ugh you ruined my moment! Now I have to restart all over again"
2414,4636,0,6,52,58,1.103448275862069,0.04033776909417944,688,Eleventh floor. Office space
2396,4636,0,6,52,58,1.103448275862069,0.04033776909417944,688,Our ISS is the guy in the penthouse; sorry for the misunderstanding.
2381,4636,0,6,52,58,1.103448275862069,0.04033776909417944,688,"Oh, I forgot to tell you, DON'T go to the bathroom."
2378,4636,0,6,52,58,1.103448275862069,0.04033776909417944,688,Watch the traffic at 42nd street
2365,4636,0,6,52,58,1.103448275862069,0.04033776909417944,688,"Third floor, penthouse, or Jupiter?"
2361,4636,0,6,52,58,1.103448275862069,0.04033776909417944,688,Thought I'd get a head start!
2357,4636,1,4,53,58,1.103448275862069,0.04724506633555822,688,Floors 3...2...1...lift off!
2342,4636,0,6,52,58,1.103448275862069,0.04033776909417944,688,"Sorry, it doesn't go any higher than infinity."
2143,4636,0,6,52,58,1.103448275862069,0.04033776909417944,688,I see this Top of the World Observation Deck really shoots for the moon in this new skyscraper.
2135,4636,0,6,52,58,1.103448275862069,0.04033776909417944,688,People call this a penthouse?
2305,4636,1,4,53,58,1.103448275862069,0.04724506633555822,688,"Living  in these new towers along the park, is truly breathtaking."
2120,4636,0,6,52,58,1.103448275862069,0.04033776909417944,688,It's surströmming night!
2485,4636,0,6,52,58,1.103448275862069,0.04033776909417944,688,I am so happy the Uber finally went interstellar. Makes my commute so much easier!
1837,4636,0,6,52,58,1.103448275862069,0.04033776909417944,688,"Sorry, this elevator only stops at every sixth floor."
1833,4636,1,4,53,58,1.103448275862069,0.04724506633555822,688,You have the best view in the galaxy.
1822,4636,0,6,52,58,1.103448275862069,0.04033776909417944,688,"Actually Sir, I'm positive that you ""dealt it""."
1803,4636,1,4,53,58,1.103448275862069,0.04724506633555822,688,"This building only goes to infinity, not beyond."
1789,4636,1,4,53,58,1.103448275862069,0.04724506633555822,688,"Because the toilet in my place ""out there"" is busted."
1787,4636,0,6,52,58,1.103448275862069,0.04033776909417944,688,This will be one small step for a man.
1767,4636,1,4,53,58,1.103448275862069,0.04724506633555822,688,"I can take you as far as the two thousandth floor, but then you're on your own."
1760,4636,0,6,52,58,1.103448275862069,0.04033776909417944,688,"Sir, it’s good to be proactive in this colder morning."
1716,4636,1,4,53,58,1.103448275862069,0.04724506633555822,688,Penthouse B or bust.
1698,4636,1,4,53,58,1.103448275862069,0.04724506633555822,688,"Sorry, sir, but the pool's closed for the season."
1642,4636,0,6,52,58,1.103448275862069,0.04033776909417944,688,"Sorry, sir.  This elevator doesn't go that high."
1637,4636,0,6,52,58,1.103448275862069,0.04033776909417944,688,"Yes Sir...the moon is the next stop after lingerie"""
1603,4636,0,6,52,58,1.103448275862069,0.04033776909417944,688,The rocket is under construction.
1580,4636,1,4,53,58,1.103448275862069,0.04724506633555822,688,Floor 250 Million.....fine furniture and  outer space fine art
2123,4636,0,6,52,58,1.103448275862069,0.04033776909417944,688,You came down not up!
1529,4636,0,6,52,58,1.103448275862069,0.04033776909417944,688,stepping out in this weather? Giant step for mankind indeed!
1848,4636,0,6,52,58,1.103448275862069,0.04033776909417944,688,"Sir, there is no one thousandth floor."
1849,4636,0,6,52,58,1.103448275862069,0.04033776909417944,688,Ahhh......we don't go up that high......
1537,4636,0,6,52,58,1.103448275862069,0.04033776909417944,688,Take me to the fourth floor.
2076,4636,1,4,53,58,1.103448275862069,0.04724506633555822,688,Im just down here looking for a $5 hotdog.
2113,4636,1,4,53,58,1.103448275862069,0.04724506633555822,688,The diapers are in the last isle behind lingerie and shoes.
2105,4636,0,6,52,58,1.103448275862069,0.04033776909417944,688,"Now, sir, it only seems that high."
2086,4636,0,6,52,58,1.103448275862069,0.04033776909417944,688,The elevator only goes to the 30th floor.
2083,4636,0,6,52,58,1.103448275862069,0.04033776909417944,688,"The Empire State Building doesn't leave the launch pad, ever."
2073,4636,0,6,52,58,1.103448275862069,0.04033776909417944,688,Please step into the next elevator sir. This one does not go as high as that floor
2039,4636,1,4,53,58,1.103448275862069,0.04724506633555822,688,"Sir, we've had more than enough people attempting to moonwalk here."
2005,4636,0,6,52,58,1.103448275862069,0.04033776909417944,688,No sir. I'm sorry but I  can't explain why the floors don't count down.
1899,4636,0,6,52,58,1.103448275862069,0.04033776909417944,688,I wish I had your ups and downs.
1958,4636,0,6,52,58,1.103448275862069,0.04033776909417944,688,Elon's SpaceX has made the trip to Mars a whole lot easier.
1948,4636,0,6,52,58,1.103448275862069,0.04033776909417944,688,"Ok, it’s a tall building. Five, four, three . . ."
1944,4636,0,6,52,58,1.103448275862069,0.04033776909417944,688,"- Don't worry, Elon said the crash tests have been a success lately.
- I know, but haven't you seen the truck demo?"
1918,4636,1,4,53,58,1.103448275862069,0.04724506633555822,688,it's customary to offer a tip
1906,4636,0,6,52,58,1.103448275862069,0.04033776909417944,688,Right this way miss.
2001,4636,0,6,52,58,1.103448275862069,0.04033776909417944,688,I'm sorry sir.....I'm just not seeing a listing here for Space Force.
3602,4939,1,5,62,68,1.1029411764705883,0.04262926879107264,688,THIS CAR DOESN'T GO TO THE ROOF.
786,4940,0,6,55,61,1.098360655737705,0.038446030818224834,688,"I presume,7th floor paranormal?"
2407,4941,0,6,57,63,1.0952380952380953,0.03728006482184823,688,"one giant step for man, one giant leap for mankind."
4703,4941,0,6,57,63,1.0952380952380953,0.03728006482184823,688,"Sub-Basement:  Decontainment, Disinfection and Diatribes."
1203,4943,1,3,50,54,1.0925925925925926,0.04779204982962338,688,"Yessir, our building is definitely a skyscraper, but it is not a space-scraper!"
3332,4944,0,5,50,55,1.0909090909090908,0.03912104390108503,688,My daughter's driving the rocket this week.
3786,4944,0,5,50,55,1.0909090909090908,0.03912104390108503,688,You met on Tinder?
3587,4944,1,3,51,55,1.0909090909090908,0.04694525268130203,688,How about THIS for atmosphere?
3530,4944,0,5,50,55,1.0909090909090908,0.03912104390108503,688,I’m very sorry sir but we don’t have a Floor -240 miles from Earth .
3995,4944,0,5,50,55,1.0909090909090908,0.03912104390108503,688,"“You know I was going to be an astronaut too, but I have bad knees.”"
3884,4944,0,5,50,55,1.0909090909090908,0.03912104390108503,688,If you're looking for the moon you will find it in our green cheese department.
2988,4944,0,5,50,55,1.0909090909090908,0.03912104390108503,688,Did you forget something up there?
3190,4944,0,5,50,55,1.0909090909090908,0.03912104390108503,688,Fourth Floor. Men’s Wear and Man’s Destiny Lies In The Exploration of Outer Space.
3187,4944,0,5,50,55,1.0909090909090908,0.03912104390108503,688,"Yeah, the air is pretty thin at the top. Look at my eye!"
3144,4944,0,5,50,55,1.0909090909090908,0.03912104390108503,688,"Just be careful, people are saying say he flushed one too many this time"
3092,4944,1,3,51,55,1.0909090909090908,0.04694525268130203,688,You may take one small step or one giant step.
4028,4944,0,5,50,55,1.0909090909090908,0.03912104390108503,688,"Sir, I assure you, there are no ""aliens"" washing the windows of this building."
3080,4944,0,5,50,55,1.0909090909090908,0.03912104390108503,688,"Thermosphere, please."
3025,4944,0,5,50,55,1.0909090909090908,0.03912104390108503,688,"Just take me to the top floor, and step on it."
3303,4944,0,5,50,55,1.0909090909090908,0.03912104390108503,688,"Going Up, Please--Way Up"
4150,4944,0,5,50,55,1.0909090909090908,0.03912104390108503,688,"One step....be careful,  it's a slippery slope in this political climate."
4861,4944,0,5,50,55,1.0909090909090908,0.03912104390108503,688,"118,953,412th floor, please."
4308,4944,0,5,50,55,1.0909090909090908,0.03912104390108503,688,I thought you said you wanted to get off at lingerie.
5293,4944,0,5,50,55,1.0909090909090908,0.03912104390108503,688,Any countdown you'd like. No problem.
5337,4944,1,3,51,55,1.0909090909090908,0.04694525268130203,688,"Yeah, chicks dig astronauts and they will do A-N-Y-T-H-I-N-G when they know you are leaving for a mission and they may never see you again. Anyway, thanks for the lift bro. Im 'bout to go get my fuck on and shoot off like Apollo 11, knaw wut I mean?"
5160,4944,0,5,50,55,1.0909090909090908,0.03912104390108503,688,The elevator goes to PH but not the moon?
5145,4944,0,5,50,55,1.0909090909090908,0.03912104390108503,688,"People have gone to the lobby before sir, might I suggest the prohibition era basement for bold exploration"
5000,4944,0,5,50,55,1.0909090909090908,0.03912104390108503,688,Ground control to MajorTom. You are now the first astronaut to walk onto the hotels bottom floor.
4991,4944,0,5,50,55,1.0909090909090908,0.03912104390108503,688,How high up is the penthouse?
4187,4944,0,5,50,55,1.0909090909090908,0.03912104390108503,688,"I thought you said, ""we are going up."""
4915,4944,0,5,50,55,1.0909090909090908,0.03912104390108503,688,the door belongs to Hubie the evil cab driver
4545,4944,0,5,50,55,1.0909090909090908,0.03912104390108503,688,"Safety before efficacy, Sir?"
4447,4944,0,5,50,55,1.0909090909090908,0.03912104390108503,688,"I said, ""Down, please!"
4420,4944,0,5,50,55,1.0909090909090908,0.03912104390108503,688,Thousandth floor I presume?
4321,4944,0,5,50,55,1.0909090909090908,0.03912104390108503,688,"Sorry, sir, Mercury's as far as we go."
4312,4944,0,5,50,55,1.0909090909090908,0.03912104390108503,688,"Sir, I trust you checked the AQI for Pekin,Illinois, not China."
5339,4944,0,5,50,55,1.0909090909090908,0.03912104390108503,688,It ain't the meat it's the motion
4677,4944,0,5,50,55,1.0909090909090908,0.03912104390108503,688,"Yes, this car IS going down....but not that far down!"
2985,4944,0,5,50,55,1.0909090909090908,0.03912104390108503,688,"Ah, how do I.....well, were does all that food go?"
1245,4944,0,5,50,55,1.0909090909090908,0.03912104390108503,688,Yes i mean up
2717,4944,0,5,50,55,1.0909090909090908,0.03912104390108503,688,"You look handsome, Sir, or ain't you pretty?"
2931,4944,0,5,50,55,1.0909090909090908,0.03912104390108503,688,"No, this isn’t the express elevator."
67,4944,0,5,50,55,1.0909090909090908,0.03912104390108503,688,Where to?” Astronaut: “Outerspace
194,4944,0,5,50,55,1.0909090909090908,0.03912104390108503,688,What you think your better than me?
233,4944,0,5,50,55,1.0909090909090908,0.03912104390108503,688,I’m ready for holiday season!
285,4944,1,3,51,55,1.0909090909090908,0.04694525268130203,688,I insist on a count down before we blast off to 20th floor.
545,4944,1,3,51,55,1.0909090909090908,0.04694525268130203,688,I hear this building is full of nonimmigrant aliens.
684,4944,0,5,50,55,1.0909090909090908,0.03912104390108503,688,"Ready to commence countdown to ""blastoff "" ?"
1026,4944,0,5,50,55,1.0909090909090908,0.03912104390108503,688,"Basement, please. Just kidding!"
1160,4944,0,5,50,55,1.0909090909090908,0.03912104390108503,688,"Penthouse floor, Tower of Babel. May I take your helmet, sir?"
1165,4944,1,3,51,55,1.0909090909090908,0.04694525268130203,688,"The film crew is ready for you,Mr. Armstrong."
1237,4944,0,5,50,55,1.0909090909090908,0.03912104390108503,688,"Enjoy your moonwalk, sir."
1308,4944,1,3,51,55,1.0909090909090908,0.04694525268130203,688,"One small step for man, one giant leap for mankind"
1561,4944,0,5,50,55,1.0909090909090908,0.03912104390108503,688,"Up to the fake floor, I'm guessing?"
1622,4944,1,3,51,55,1.0909090909090908,0.04694525268130203,688,"Sorry  sir, we don't go to Infinity and Beyond."
325,4944,1,3,51,55,1.0909090909090908,0.04694525268130203,688,It's just one small step for a man.
1759,4944,0,5,50,55,1.0909090909090908,0.03912104390108503,688,Up?  We're not going that far.
1868,4944,1,3,51,55,1.0909090909090908,0.04694525268130203,688,"Yeah, Honeymooning without the spouse is trending now"
1882,4944,0,5,50,55,1.0909090909090908,0.03912104390108503,688,First floor--not the Fish Floor
2653,4944,0,5,50,55,1.0909090909090908,0.03912104390108503,688,It was too many steps for mankind.
1990,4944,0,5,50,55,1.0909090909090908,0.03912104390108503,688,Are you sure?...the Penthouse is completely over the moon.
2033,4944,0,5,50,55,1.0909090909090908,0.03912104390108503,688,You do know that the top floor in this building is the 56th.?
2307,4944,1,3,51,55,1.0909090909090908,0.04694525268130203,688,"Mr. President, no one will believe that you were an astronaut -- since they don't believe some of the other self-crediting remarks.  And no, you cannot wear it to the next state dinner!"
2327,4944,0,5,50,55,1.0909090909090908,0.03912104390108503,688,You're now beyond '2001.'
1703,4944,0,5,50,55,1.0909090909090908,0.03912104390108503,688,Just how many floors do you think there are in this building?!
2401,4944,0,5,50,55,1.0909090909090908,0.03912104390108503,688,I thought we
2550,4944,0,5,50,55,1.0909090909090908,0.03912104390108503,688,"Sorry sir. We were going down, not up."
2440,4944,0,5,50,55,1.0909090909090908,0.03912104390108503,688,Welcome to Trump Tower  . . . the only dry spot in New York
2484,4944,0,5,50,55,1.0909090909090908,0.03912104390108503,688,This car does not go to the penthouse.
3038,5008,0,5,53,58,1.0862068965517242,0.03717555967998436,688,The Star Terrace is to your right.
210,5008,0,5,53,58,1.0862068965517242,0.03717555967998436,688,you’ve been a little spacey these days... we’re not seeing each other on the  same eye level
5096,5010,0,4,47,51,1.0784313725490196,0.03802101848953984,688,"Are you sure you won’t just get the flu shot this year, sir?"
3019,5011,0,4,48,52,1.0769230769230769,0.03731317308251277,688,"It's one small step outside the elevator, Mr. Smith."
5318,5011,0,4,48,52,1.0769230769230769,0.03731317308251277,688,"I'm actually going down, believe it or not."
4172,5011,1,2,49,52,1.0769230769230769,0.04632947979911816,688,"This doesn't look good, do you think I should cancel Mrs. Rosenberg's Wall St. Journal?"
3757,5011,0,4,48,52,1.0769230769230769,0.03731317308251277,688,Ok I give up.  Where’s the space rocket?
3683,5011,0,4,48,52,1.0769230769230769,0.03731317308251277,688,We’re not going up that may floors.
3627,5011,0,4,48,52,1.0769230769230769,0.03731317308251277,688,How was that for a soft landing back on Earth Sir?
3555,5011,1,2,49,52,1.0769230769230769,0.04632947979911816,688,"1st floor, camping and skiing equipment"". ""C'mon Sheldon you know I like it when you say blast off  at the lobby."""
3468,5011,0,4,48,52,1.0769230769230769,0.03731317308251277,688,"I’m afraid you’re in the wrong elevator, sir!"
3395,5011,0,4,48,52,1.0769230769230769,0.03731317308251277,688,"I'm glad you're finally getting acclimated to the 13,000th floor Mr. Goodwin."
3297,5011,0,4,48,52,1.0769230769230769,0.03731317308251277,688,"Beam me up, Fred"
3263,5011,1,2,49,52,1.0769230769230769,0.04632947979911816,688,Don't forget your briefcase.
3191,5011,0,4,48,52,1.0769230769230769,0.03731317308251277,688,I am here to help you recover from the Binds
3161,5011,0,4,48,52,1.0769230769230769,0.03731317308251277,688,I don’t believe it goes that high
2729,5011,0,4,48,52,1.0769230769230769,0.03731317308251277,688,Wrong elevator?
2672,5011,0,4,48,52,1.0769230769230769,0.03731317308251277,688,"Yes, Sir. This is as high as we go."
4322,5011,1,2,49,52,1.0769230769230769,0.04632947979911816,688,"You are in the wrong elevator, the one to  floor 1.325.654.345 is in building X."
3159,5011,1,2,49,52,1.0769230769230769,0.04632947979911816,688,I forgot my teddy bear.
2910,5011,0,4,48,52,1.0769230769230769,0.03731317308251277,688,"Yes, sir, this elevator does go to L1, but only a noon."
4479,5011,0,4,48,52,1.0769230769230769,0.03731317308251277,688,It's one small step to the lobby...
5140,5011,0,4,48,52,1.0769230769230769,0.03731317308251277,688,"No, the next floor is not Mars."
4543,5011,1,2,49,52,1.0769230769230769,0.04632947979911816,688,500th floor! I get nosebleeds up there !
5282,5011,1,2,49,52,1.0769230769230769,0.04632947979911816,688,"Who? No, I'm the bellboy,
Can you hear me, Major Tom?"
5236,5011,0,4,48,52,1.0769230769230769,0.03731317308251277,688,"In the event of a super nova, take the stairs."
5224,5011,0,4,48,52,1.0769230769230769,0.03731317308251277,688,This elevator only goes down one more floor !
5300,5011,0,4,48,52,1.0769230769230769,0.03731317308251277,688,"You said the toilets were on this floor, right?"
2599,5011,0,4,48,52,1.0769230769230769,0.03731317308251277,688,One small step for man...
5135,5011,0,4,48,52,1.0769230769230769,0.03731317308251277,688,"The pollen count is higher than usual this morning, Mr. Anderson."
5118,5011,0,4,48,52,1.0769230769230769,0.03731317308251277,688,I'm sorry sir. I'm afraid you'll have to find infinity and beyond elsewhere. 12 is our highest floor.
4940,5011,1,2,49,52,1.0769230769230769,0.04632947979911816,688,"for the last time, stop calling me Major Tom"
4923,5011,0,4,48,52,1.0769230769230769,0.03731317308251277,688,"I'm sorry Mr. Sanders, but ""Space Socialism""  is still socialism. Besides - and no thanks to you - my wages are way up!"
4859,5011,0,4,48,52,1.0769230769230769,0.03731317308251277,688,"Have it your way. Watch your One Giant Leap, please."
4849,5011,0,4,48,52,1.0769230769230769,0.03731317308251277,688,"Sorry sir, floor 30 is the highest this goes"
4840,5011,0,4,48,52,1.0769230769230769,0.03731317308251277,688,Liftoff! You'll break ground on so many levels!
4812,5011,0,4,48,52,1.0769230769230769,0.03731317308251277,688,I'm here for the co-op board interview in 12C.
4650,5011,0,4,48,52,1.0769230769230769,0.03731317308251277,688,And that’s pretty much how the Space Elevator will work.
4643,5011,0,4,48,52,1.0769230769230769,0.03731317308251277,688,"All the way to the Moon and back""?! That's the elevator down the hall, Sir"
4617,5011,0,4,48,52,1.0769230769230769,0.03731317308251277,688,That's one giant step from home furnishings.
4578,5011,0,4,48,52,1.0769230769230769,0.03731317308251277,688,Most people go to the spa to get their buoyancy fix.
4537,5011,0,4,48,52,1.0769230769230769,0.03731317308251277,688,"No, no - your not a space cadet  if you forget the floor."
2581,5011,0,4,48,52,1.0769230769230769,0.03731317308251277,688,Just a couple more floors to make it to the outer atmosphere.
4262,5011,1,2,49,52,1.0769230769230769,0.04632947979911816,688,Working toilets are to your left.
2355,5011,0,4,48,52,1.0769230769230769,0.03731317308251277,688,"Ready for basic training, sir!"
873,5011,0,4,48,52,1.0769230769230769,0.03731317308251277,688,It’s flu season and I don’t wanna risk it.
871,5011,0,4,48,52,1.0769230769230769,0.03731317308251277,688,Top floor. Giant steps not available.
839,5011,0,4,48,52,1.0769230769230769,0.03731317308251277,688,"Usually, Mr. Johnson just lights a match. But, last night he tried this new Mexican restaurant . . ."
790,5011,0,4,48,52,1.0769230769230769,0.03731317308251277,688,I’m not sure you’ll fit in the cab with all your gear.
709,5011,0,4,48,52,1.0769230769230769,0.03731317308251277,688,"‘Forget something, Captain?’ ‘Depends. Could you hold it at my level?’"
674,5011,1,2,49,52,1.0769230769230769,0.04632947979911816,688,"Is this Women's Scarves and Wraps? My wife is expecting me to bring her back something special."""
661,5011,0,4,48,52,1.0769230769230769,0.03731317308251277,688,Enjoy your perpetual night. sir.
590,5011,0,4,48,52,1.0769230769230769,0.03731317308251277,688,Good evening Mr. Aldrin. Shall we have lift-off to the sixth floor?
587,5011,0,4,48,52,1.0769230769230769,0.03731317308251277,688,"You may find the view different than you’re accustomed to, but I think it’s pretty spectacular."
490,5011,0,4,48,52,1.0769230769230769,0.03731317308251277,688,"If I can make it there, I’ll make it anywhere."
489,5011,0,4,48,52,1.0769230769230769,0.03731317308251277,688,They say the plumber will be in shortly.
444,5011,0,4,48,52,1.0769230769230769,0.03731317308251277,688,"""What floor?""
""2001, please."""
338,5011,0,4,48,52,1.0769230769230769,0.03731317308251277,688,"Yes sir, splashdown. It won’t happen again, sir."
222,5011,0,4,48,52,1.0769230769230769,0.03731317308251277,688,OMS SIRH SESE a mankind but please press 12 for me thank you. #
2552,5011,0,4,48,52,1.0769230769230769,0.03731317308251277,688,"Even on the ground floor facing the street, the prices here are astronomical!"
912,5011,0,4,48,52,1.0769230769230769,0.03731317308251277,688,Space capsule? Just 1 quadrillionth of a parsec to the right
1050,5011,0,4,48,52,1.0769230769230769,0.03731317308251277,688,"Sorry sir, this elevator does not go to the moon, just to floor 101!"
250,5011,0,4,48,52,1.0769230769230769,0.03731317308251277,688,"I guess it is today.... Good luck for your court hearing for divorce, sir!"
1173,5011,0,4,48,52,1.0769230769230769,0.03731317308251277,688,Ready to brave flue season then sir?
2210,5011,1,2,49,52,1.0769230769230769,0.04632947979911816,688,"This elevator does have 43,896 floors, but it doesn't go past the atmosphere I'm afraid."
2286,5011,0,4,48,52,1.0769230769230769,0.03731317308251277,688,"Floor 88,000 please"
2097,5011,0,4,48,52,1.0769230769230769,0.03731317308251277,688,No sir. We only go to 17
2016,5011,0,4,48,52,1.0769230769230769,0.03731317308251277,688,"I don't go that far,try the space elevator"
1986,5011,0,4,48,52,1.0769230769230769,0.03731317308251277,688,"Wauw,you really think our hotel will go that high?"
1886,5011,0,4,48,52,1.0769230769230769,0.03731317308251277,688,"10th floor: housewares, space suits and cutlery..Watch your step please."
1871,5011,0,4,48,52,1.0769230769230769,0.03731317308251277,688,"I'm Strong. Where's that ""scary"" Honeycomb in this tower?"
1155,5011,1,2,49,52,1.0769230769230769,0.04632947979911816,688,This is ground floor to Major Tom
1864,5011,0,4,48,52,1.0769230769230769,0.03731317308251277,688,I'm Honey Detector and Extractor.
1656,5011,0,4,48,52,1.0769230769230769,0.03731317308251277,688,To the top. And beyond!
1578,5011,0,4,48,52,1.0769230769230769,0.03731317308251277,688,"Careful getting off, it's one small step for man."
1479,5011,0,4,48,52,1.0769230769230769,0.03731317308251277,688,"All the way up? Air. 
All the way down? Air.
Now, the bar on mezzanine?
Kinda smokey."
1452,5011,0,4,48,52,1.0769230769230769,0.03731317308251277,688,Will you be getting off at groundwater?
1449,5011,0,4,48,52,1.0769230769230769,0.03731317308251277,688,"Excuse me sir, do you know how to get to the Apollo?"
1426,5011,0,4,48,52,1.0769230769230769,0.03731317308251277,688,one small step for the operator and one giant leap for human kind.
1390,5011,0,4,48,52,1.0769230769230769,0.03731317308251277,688,"By the way Mr. Katz, did you hear that 608 was up for sale?"
1663,5011,0,4,48,52,1.0769230769230769,0.03731317308251277,688,I'm sorry...the elevator stops at the 102nd Floor.
3622,5089,0,4,49,53,1.0754716981132075,0.03663114503374153,688,Going up...and step on it
4951,5090,0,4,50,54,1.0740740740740742,0.035973550457676445,688,One small floor?
2024,5091,0,4,51,55,1.0727272727272728,0.03533910239300183,688,I'm afraid this isn't the NASA building.
1841,5092,0,4,54,58,1.0689655172413792,0.033563052647743945,688,"Mars,sir. Made -to-measure to your right."
4353,5093,0,3,45,48,1.0625,0.035308292679127,688,Which floor is the moon on liftman ?
4192,5094,0,3,46,49,1.0612244897959184,0.03460372440370034,688,Welcome! So glad we're finally good use of the hotel roof.
4085,5094,0,3,46,49,1.0612244897959184,0.03460372440370034,688,My room sucked.
4016,5094,0,3,46,49,1.0612244897959184,0.03460372440370034,688,"Sorry, I would've taken that outdoor transport up to the capsule, but I'm afraid of heights."
3644,5094,0,3,46,49,1.0612244897959184,0.03460372440370034,688,"We don't even have Freon gas on the moon, sir. You'll have to leave your suit in the cloakroom like everyone else."
4008,5094,0,3,46,49,1.0612244897959184,0.03460372440370034,688,High rise buildings these days!
3985,5094,0,3,46,49,1.0612244897959184,0.03460372440370034,688,"Is the ""final frontier"" the 19th or 20th floor?"
3935,5094,0,3,46,49,1.0612244897959184,0.03460372440370034,688,Heading to space to find my mr. lost in space future husband...
3931,5094,0,3,46,49,1.0612244897959184,0.03460372440370034,688,"Any floor will do, Charles."
3844,5094,0,3,46,49,1.0612244897959184,0.03460372440370034,688,Please tell Mrs Armstrong that she has my sympathies.
3663,5094,0,3,46,49,1.0612244897959184,0.03460372440370034,688,"Yes, a lot of people have commented that the building looks like the Falcon Heavy."
3662,5094,0,3,46,49,1.0612244897959184,0.03460372440370034,688,"Don't spend six months in space 
without a change of clothes."
3609,5094,0,3,46,49,1.0612244897959184,0.03460372440370034,688,Nope. This is a close as we can get you to the Space Shuttle. But there is a great Star Wars exhibit.
2939,5094,0,3,46,49,1.0612244897959184,0.03460372440370034,688,"Sorry sir, we only go to the 23rd floor, you want the other elevator."
3496,5094,0,3,46,49,1.0612244897959184,0.03460372440370034,688,The next elevator goes to the moon
3426,5094,0,3,46,49,1.0612244897959184,0.03460372440370034,688,La Jake
3294,5094,0,3,46,49,1.0612244897959184,0.03460372440370034,688,"Yeah, just going to check my New Years Resolutions"
3278,5094,0,3,46,49,1.0612244897959184,0.03460372440370034,688,I can take you as high as the 31st floor. You’re on your own from there.
3230,5094,0,3,46,49,1.0612244897959184,0.03460372440370034,688,"Oh sorry, I said ""up""."
3154,5094,0,3,46,49,1.0612244897959184,0.03460372440370034,688,Is there enough space for you in the elevator?
3138,5094,0,3,46,49,1.0612244897959184,0.03460372440370034,688,"Neither, Sire. These are ""floors""."
3113,5094,0,3,46,49,1.0612244897959184,0.03460372440370034,688,Next car over!
3104,5094,0,3,46,49,1.0612244897959184,0.03460372440370034,688,"5th floor... women's lingerie, men's shoe's, the final frontier."
2868,5094,0,3,46,49,1.0612244897959184,0.03460372440370034,688,"Top floor sir, please take care as you exit. Thats it, 'one step for man and one giant leap for mankind' ."
2842,5094,0,3,46,49,1.0612244897959184,0.03460372440370034,688,"Sir, I’m a highly trained professional.  In what possible world could I ever be obsolete?"
2731,5094,0,3,46,49,1.0612244897959184,0.03460372440370034,688,"Floor 130,944 please..."
3605,5094,0,3,46,49,1.0612244897959184,0.03460372440370034,688,"The next stop is lingerie, after that is the jet way to the capsule."
4390,5094,0,3,46,49,1.0612244897959184,0.03460372440370034,688,Sea floor.
5095,5094,0,3,46,49,1.0612244897959184,0.03460372440370034,688,"I’m sorry sir, we’re already at the top floor. We can’t go up."
4421,5094,0,3,46,49,1.0612244897959184,0.03460372440370034,688,Up one flight to the moon.
5310,5094,0,3,46,49,1.0612244897959184,0.03460372440370034,688,"Sorry, but there are only 25 floors."
5278,5094,0,3,46,49,1.0612244897959184,0.03460372440370034,688,Actually Mr. Trump himself invited me.
5261,5094,0,3,46,49,1.0612244897959184,0.03460372440370034,688,You should've taken an express!
5242,5094,0,3,46,49,1.0612244897959184,0.03460372440370034,688,One giant leap  for Post-Millennials.
5229,5094,0,3,46,49,1.0612244897959184,0.03460372440370034,688,Skyway just ahead.
5196,5094,0,3,46,49,1.0612244897959184,0.03460372440370034,688,"No, those really are not funny."
5177,5094,0,3,46,49,1.0612244897959184,0.03460372440370034,688,"This is the elevator to the gallows, not space."
5133,5094,0,3,46,49,1.0612244897959184,0.03460372440370034,688,Thanks for choosing Hyatt Neptune. The doorman will call you a teleporter.
5132,5094,0,3,46,49,1.0612244897959184,0.03460372440370034,688,Weightlessness simulation is located off the roof.
2724,5094,0,3,46,49,1.0612244897959184,0.03460372440370034,688,"The sky’s the limit in this car, sir!"
5057,5094,0,3,46,49,1.0612244897959184,0.03460372440370034,688,"”Sorry, this isn’t the moon, it’s the lobby. The moon is on the thirteenth floor.”"
5027,5094,1,1,47,49,1.0612244897959184,0.045252158828741736,688,...and he's bringing reindeer? The condo association will require sign off.
4396,5094,0,3,46,49,1.0612244897959184,0.03460372440370034,688,There’s no button fir that.
5014,5094,0,3,46,49,1.0612244897959184,0.03460372440370034,688,"I'm sorry, the ninety eight floor is the highest I can go."
4873,5094,0,3,46,49,1.0612244897959184,0.03460372440370034,688,13th floor? Okay.
4809,5094,0,3,46,49,1.0612244897959184,0.03460372440370034,688,Are you going into outer space or down into water?
4807,5094,0,3,46,49,1.0612244897959184,0.03460372440370034,688,It goes up a hundred floors.  It's a start.
4775,5094,0,3,46,49,1.0612244897959184,0.03460372440370034,688,"Fifth floor: Ladies lingerie, housewares, oxygen."
4764,5094,0,3,46,49,1.0612244897959184,0.03460372440370034,688,this doesn't  go up that far.
4740,5094,0,3,46,49,1.0612244897959184,0.03460372440370034,688,These craters are quite square.
4668,5094,0,3,46,49,1.0612244897959184,0.03460372440370034,688,"Is the sky the limit again, sir?"
4635,5094,0,3,46,49,1.0612244897959184,0.03460372440370034,688,I'm afraid you've got the Marriott Canaveral.
4624,5094,0,3,46,49,1.0612244897959184,0.03460372440370034,688,"Anything but 13, I'm guessing.
Greg Stroupe
Madison, WI"
4598,5094,1,1,47,49,1.0612244897959184,0.045252158828741736,688,I've set the course. But I can't go along for the ride.
4541,5094,0,3,46,49,1.0612244897959184,0.03460372440370034,688,"The ISS, sir? I am afraid you'll have to take Elon's space elevator, not this one."
4531,5094,0,3,46,49,1.0612244897959184,0.03460372440370034,688,"Sorry sir, this elevator doesn't go to the roof."
4956,5094,1,1,47,49,1.0612244897959184,0.045252158828741736,688,Time to film the Mars landing Sir?
2693,5094,0,3,46,49,1.0612244897959184,0.03460372440370034,688,InfoWars said there was a child sex slave colony on Mars. But I had no idea it would be so posh!
5084,5094,1,1,47,49,1.0612244897959184,0.045252158828741736,688,I assume you'd like to go down?
2632,5094,0,3,46,49,1.0612244897959184,0.03460372440370034,688,"'Which party? Orbit, space station or moon?'"
917,5094,0,3,46,49,1.0612244897959184,0.03460372440370034,688,"Yea, top floor. The truck's parked on the roof."
913,5094,1,1,47,49,1.0612244897959184,0.045252158828741736,688,"Sir, this IS beyond."
882,5094,0,3,46,49,1.0612244897959184,0.03460372440370034,688,This is the Mars floor. The Jupiter floor is another seven-thousand flights up.
793,5094,0,3,46,49,1.0612244897959184,0.03460372440370034,688,Wrong floor!
740,5094,0,3,46,49,1.0612244897959184,0.03460372440370034,688,I'm expanding my business into retail space.
728,5094,0,3,46,49,1.0612244897959184,0.03460372440370034,688,The dressmaker is the first door on the right.
671,5094,0,3,46,49,1.0612244897959184,0.03460372440370034,688,"Preparing for Mars?
Yeah!Enough of this Impeachment drama!"
603,5094,0,3,46,49,1.0612244897959184,0.03460372440370034,688,"Fly me to the moon, please."
595,5094,0,3,46,49,1.0612244897959184,0.03460372440370034,688,She said she wanted some space.
571,5094,0,3,46,49,1.0612244897959184,0.03460372440370034,688,"Yes, Sir. Space Force is the only branch with an elevator attendant."
327,5094,0,3,46,49,1.0612244897959184,0.03460372440370034,688,"Do watch your step, sir—
 while it might appear but a small one, the elevator is not quite flush and it actually requires more of a giant leap. Still, I don’t suppose that would bother a man of your caliber, if you don’t mind my saying so, sir."
290,5094,0,3,46,49,1.0612244897959184,0.03460372440370034,688,"Your double-parked rocket was towed, sir."
1056,5094,0,3,46,49,1.0612244897959184,0.03460372440370034,688,Going higher?
283,5094,0,3,46,49,1.0612244897959184,0.03460372440370034,688,"No; I don't have a martian mellow. """
238,5094,0,3,46,49,1.0612244897959184,0.03460372440370034,688,Where do they sell spacesuits with built-in toilets?
215,5094,0,3,46,49,1.0612244897959184,0.03460372440370034,688,"- Sir, do you go out alone tonight  - | - |need my space. |"
213,5094,0,3,46,49,1.0612244897959184,0.03460372440370034,688,"To Uranus, please."
203,5094,0,3,46,49,1.0612244897959184,0.03460372440370034,688,Write your caption here  I just want some  me time
197,5094,0,3,46,49,1.0612244897959184,0.03460372440370034,688,Are you going up or down?
187,5094,0,3,46,49,1.0612244897959184,0.03460372440370034,688,Better safe than sorry
163,5094,0,3,46,49,1.0612244897959184,0.03460372440370034,688,5. ..4. Bee. | | |  OO)  iV
115,5094,0,3,46,49,1.0612244897959184,0.03460372440370034,688,"iGRUSS GOTT""  4"
109,5094,0,3,46,49,1.0612244897959184,0.03460372440370034,688,"Earth orbit, please."
108,5094,0,3,46,49,1.0612244897959184,0.03460372440370034,688,"Actually, could you leave it open just a crack?"
68,5094,0,3,46,49,1.0612244897959184,0.03460372440370034,688,"Actually, just to the basement, where that obscure bathroom is. The freeze-dried ice cream really does a number on my digestive system."
2637,5094,0,3,46,49,1.0612244897959184,0.03460372440370034,688,"That ""one small step"" line, who came up with that shit?"
244,5094,0,3,46,49,1.0612244897959184,0.03460372440370034,688,I didnt receive training for this kind of trip.
1064,5094,0,3,46,49,1.0612244897959184,0.03460372440370034,688,But the elevator doesn't go to your ceiling
400,5094,0,3,46,49,1.0612244897959184,0.03460372440370034,688,"Happy holidays,"" said the doorman"
1256,5094,0,3,46,49,1.0612244897959184,0.03460372440370034,688,Please exit quickly!
2528,5094,0,3,46,49,1.0612244897959184,0.03460372440370034,688,I hope the bed is adapted.
1221,5094,0,3,46,49,1.0612244897959184,0.03460372440370034,688,"Sorry, Lady’s Lingerie is as high as we go."
2403,5094,0,3,46,49,1.0612244897959184,0.03460372440370034,688,"The moon? Sorry, we only go up 39 floors."
2356,5094,1,1,47,49,1.0612244897959184,0.045252158828741736,688,"How far down, sir?"
2275,5094,0,3,46,49,1.0612244897959184,0.03460372440370034,688,pee pee poo poo
2237,5094,0,3,46,49,1.0612244897959184,0.03460372440370034,688,That won't be necessary.  This is a skyscraper not a spacescraper.
2222,5094,0,3,46,49,1.0612244897959184,0.03460372440370034,688,"Sorry, the descent beckoned."
2125,5094,0,3,46,49,1.0612244897959184,0.03460372440370034,688,"Yes, the atmosphere on 99 is a bit rarified, but still..."
2047,5094,0,3,46,49,1.0612244897959184,0.03460372440370034,688,I heard Frank Sinatra sing Fly Me To The Moon right in this elevator.
2035,5094,0,3,46,49,1.0612244897959184,0.03460372440370034,688,We have ignition.
1970,5094,1,1,47,49,1.0612244897959184,0.045252158828741736,688,Mars? This is Hershey’s headquarters.
1947,5094,0,3,46,49,1.0612244897959184,0.03460372440370034,688,"I’m sorry, but we only have 63 floors."
1924,5094,0,3,46,49,1.0612244897959184,0.03460372440370034,688,Have a seat. I can launch you to the roof.
1911,5094,0,3,46,49,1.0612244897959184,0.03460372440370034,688,"Just for the record, it’s not true what they say I only take a bath once a week."
2506,5094,0,3,46,49,1.0612244897959184,0.03460372440370034,688,"I'm sorry, sir, but this is as high as it will go."
1863,5094,0,3,46,49,1.0612244897959184,0.03460372440370034,688,"Relax!. It's already removed and 'Safe' in my backpack."""
1369,5094,0,3,46,49,1.0612244897959184,0.03460372440370034,688,"Ground floor sir. Please bring me back a sample of the moon."""
1385,5094,0,3,46,49,1.0612244897959184,0.03460372440370034,688,"The International Space Station, please,"
1404,5094,0,3,46,49,1.0612244897959184,0.03460372440370034,688,It's better than walking on the moon--- it's Trump Tower!
1471,5094,0,3,46,49,1.0612244897959184,0.03460372440370034,688,"“10TH FLOOR”
     “LADIES LINGERIE”
“Undergarments (mainly brassieres), sleepwear and lightweight robes”

""That's one small step for man, one giant leap for mankind."""
1909,5094,0,3,46,49,1.0612244897959184,0.03460372440370034,688,"Sorry, this elevator doesn’t go to the stratosphere."
1512,5094,0,3,46,49,1.0612244897959184,0.03460372440370034,688,"I'm sorry, Sir, we don't go above the penthouse."
1492,5094,0,3,46,49,1.0612244897959184,0.03460372440370034,688,"Sorry, I thought you said down."
1568,5094,0,3,46,49,1.0612244897959184,0.03460372440370034,688,"What up, BRUHHH...?"
1597,5094,0,3,46,49,1.0612244897959184,0.03460372440370034,688,"WHEN I GET TO THE TOP FLOOR, WHICH WAY SHOULD I JUMNP?"
1625,5094,0,3,46,49,1.0612244897959184,0.03460372440370034,688,Light this candle?
1807,5094,0,3,46,49,1.0612244897959184,0.03460372440370034,688,"Sorry about my flatulence."""
1541,5094,0,3,46,49,1.0612244897959184,0.03460372440370034,688,"Down to water level, please."
4154,5211,0,2,42,44,1.0454545454545454,0.031765283723713976,688,"""Welcome to the greenhouse effect."
3389,5212,0,2,43,45,1.0444444444444445,0.031067790907534747,688,"Oh my God, he's is so gonna win this fancy dress competition."
3352,5212,0,2,43,45,1.0444444444444445,0.031067790907534747,688,I didn't know pre-war buildings had floors this high!
3253,5212,0,2,43,45,1.0444444444444445,0.031067790907534747,688,sooo where’s the spacecraft?
2710,5212,0,2,43,45,1.0444444444444445,0.031067790907534747,688,"No, this elevator does not go up to the sky!"
3219,5212,0,2,43,45,1.0444444444444445,0.031067790907534747,688,"They said once more late and you're done, sir."
2946,5212,0,2,43,45,1.0444444444444445,0.031067790907534747,688,"I'm sorry, this elevator stops at the 110 th floor."
2816,5212,0,2,43,45,1.0444444444444445,0.031067790907534747,688,I don't think elevator will go that far
2712,5212,0,2,43,45,1.0444444444444445,0.031067790907534747,688,It's true. You can't impeach a Space Force cadet.
2684,5212,0,2,43,45,1.0444444444444445,0.031067790907534747,688,My bags are on their way down.
3250,5212,0,2,43,45,1.0444444444444445,0.031067790907534747,688,"OK, the 89th floor -- this is as high as I go.  There's a stairway that'll take you to the roof behind the door over there.  The rest if the way you're on your own."
3782,5212,0,2,43,45,1.0444444444444445,0.031067790907534747,688,Yes 'no atmosphere' I know just push the button
4258,5212,0,2,43,45,1.0444444444444445,0.031067790907534747,688,You have the wrong elevator. We only have 50 floors
3883,5212,0,2,43,45,1.0444444444444445,0.031067790907534747,688,Cocain is a hell of a drug
3941,5212,0,2,43,45,1.0444444444444445,0.031067790907534747,688,You will need to transfer at the top floor to continue.
4128,5212,0,2,43,45,1.0444444444444445,0.031067790907534747,688,They said they had space.
4190,5212,0,2,43,45,1.0444444444444445,0.031067790907534747,688,I'm allergic to elevators.
4307,5212,0,2,43,45,1.0444444444444445,0.031067790907534747,688,The budget’s been frozen until we hand over dirt on Biden.
4467,5212,1,0,44,45,1.0444444444444445,0.044444444444444446,688,I'm sorry sir -- this car only goest to the forty-fifth floor.
4583,5212,1,0,44,45,1.0444444444444445,0.044444444444444446,688,"No, I this isn't the Watergate.  Probably the costume Party you are looking for is at Trump Tower."
4637,5212,1,0,44,45,1.0444444444444445,0.044444444444444446,688,"Yes, the prices are stratospheric, but this only goes up to the penthouse."
4699,5212,1,0,44,45,1.0444444444444445,0.044444444444444446,688,"This is “ladies lingerie”.  
Are you sure you don’t want our Halloween shop on eight?"
4864,5212,0,2,43,45,1.0444444444444445,0.031067790907534747,688,"Oh, you need the express elevator."
5327,5212,0,2,43,45,1.0444444444444445,0.031067790907534747,688,"W Hotels bought the naming rights to the Space Station, but otherwise nothing has changed. Enjoy your stay."
2617,5212,0,2,43,45,1.0444444444444445,0.031067790907534747,688,"Just one small step sir, then take your first left and you can’t miss the buffet."
3862,5212,0,2,43,45,1.0444444444444445,0.031067790907534747,688,"You do understand that ""elevator to the stars"" meant the Warner Brothers offices on the 23rd floor?"
2612,5212,0,2,43,45,1.0444444444444445,0.031067790907534747,688,"Sorry, this one only goes to the 5th floor."
3433,5212,0,2,43,45,1.0444444444444445,0.031067790907534747,688,"Sir, if you want the ""boldly go where no man has gone before floor"" you'll have to go just a little higher."
2515,5212,0,2,43,45,1.0444444444444445,0.031067790907534747,688,"When you get to the top
tell em Groucho sent you"
2564,5212,0,2,43,45,1.0444444444444445,0.031067790907534747,688,"Cutbacks? Well, the best I can do for you, buddy, is the penthouse and roof garden."
124,5212,0,2,43,45,1.0444444444444445,0.031067790907534747,688,The chair in Wonka’s  glass elevator was  Charlie’s suggestion; the Space suit is because everyone still knows what happened to the other  kids.
144,5212,0,2,43,45,1.0444444444444445,0.031067790907534747,688,its the 10th floor already and i'm starting to belive they made these 10 stars up
287,5212,0,2,43,45,1.0444444444444445,0.031067790907534747,688,"Hope I didn't offend your religious beliefs, Mx. Doe."
359,5212,0,2,43,45,1.0444444444444445,0.031067790907534747,688,"So sorry, sir. The subterranean level’s door is rusted shut ."
466,5212,0,2,43,45,1.0444444444444445,0.031067790907534747,688,I'm  late  for  work.  How  high will this  go?
499,5212,0,2,43,45,1.0444444444444445,0.031067790907534747,688,"Some International Space Station, Bud!"
647,5212,0,2,43,45,1.0444444444444445,0.031067790907534747,688,3 ..2.. 1..
683,5212,0,2,43,45,1.0444444444444445,0.031067790907534747,688,Try the Empire State Building...
870,5212,0,2,43,45,1.0444444444444445,0.031067790907534747,688,3 more successfully launches and I'm back with my  launch group !!!
1378,5212,0,2,43,45,1.0444444444444445,0.031067790907534747,688,"A little of clothes here I am afraid I’m afraid, But I’ll take you up where there’s more space"
1415,5212,0,2,43,45,1.0444444444444445,0.031067790907534747,688,"To the left, but please, more careful this time."
415,5212,0,2,43,45,1.0444444444444445,0.031067790907534747,688,We have raked out the moon in the swimming pool.
1646,5212,0,2,43,45,1.0444444444444445,0.031067790907534747,688,I think my stop is a little higher up...
1458,5212,0,2,43,45,1.0444444444444445,0.031067790907534747,688,Testing the effects of weightlessness on weightlessness?  Mr. Trump’s office it is!
2418,5212,0,2,43,45,1.0444444444444445,0.031067790907534747,688,"Yes, it was driver-less smarty!   The landing capsule is being picked up from the roof  by Elon Musk."
2347,5212,1,0,44,45,1.0444444444444445,0.044444444444444446,688,"Time to pull out my flame-proof suit;
the cult of crazy has taken over."
2478,5212,0,2,43,45,1.0444444444444445,0.031067790907534747,688,Nice to meet a fellow traveler. Does that thing keep your ears from popping?
2140,5212,0,2,43,45,1.0444444444444445,0.031067790907534747,688,I'm the new captain of Trump's Space Force..  does this elevator go to the moon?  or Mars?
2239,5212,0,2,43,45,1.0444444444444445,0.031067790907534747,688,You can't land in the penthouse swimming pool unless you're a coop member.
1954,5212,0,2,43,45,1.0444444444444445,0.031067790907534747,688,"Guy: Did this dude even check in?
Astronaut: why is this dude looking at me 
Guy:"
1885,5212,0,2,43,45,1.0444444444444445,0.031067790907534747,688,i know - you are going on a mission to mars and this elevator doesn’t even go to the penthouse. life‘s tough like that sometimes.
1852,5212,0,2,43,45,1.0444444444444445,0.031067790907534747,688,"Yeah, it’s been a hell of a day. My bar bill will be astronomic."
1812,5212,0,2,43,45,1.0444444444444445,0.031067790907534747,688,"Excuse me, sir. This one only goes to the tenth floor."
1747,5212,0,2,43,45,1.0444444444444445,0.031067790907534747,688,How do you do business in that coat?
2127,5212,0,2,43,45,1.0444444444444445,0.031067790907534747,688,"Boy, Thanks a lot! Our tenants were up in arms about the washing machines being out of commission!"
4362,5266,0,1,41,42,1.0238095238095237,0.024098134635593994,688,"I'm sorry,this elevator doesn't stop at ""the moon."""
4249,5266,0,1,41,42,1.0238095238095237,0.024098134635593994,688,You might get tired of the music
4176,5266,0,1,41,42,1.0238095238095237,0.024098134635593994,688,"No, I can't make it do the ""vomit comet"" thing. Yes, I've tried."
4158,5266,0,1,41,42,1.0238095238095237,0.024098134635593994,688,Tinder: There's no one new around you.
4133,5266,0,1,41,42,1.0238095238095237,0.024098134635593994,688,"The Eagle, my dear sir, has landed."
4120,5266,0,1,41,42,1.0238095238095237,0.024098134635593994,688,Here you go.... the Space Cadet Convention... on basement level.
3405,5266,0,1,41,42,1.0238095238095237,0.024098134635593994,688,I assure you sir.  This capsule is disinfected every day.
2779,5266,0,1,41,42,1.0238095238095237,0.024098134635593994,688,"Perhaps a misunderstanding, sir? The suite where Michael Jackson stayed is on that floor, not the SpaceX headquarters."
3367,5266,0,1,41,42,1.0238095238095237,0.024098134635593994,688,"In theatres this December: 
The Secrets of the Unsinkable Molly Brown"
3290,5266,0,1,41,42,1.0238095238095237,0.024098134635593994,688,"Sir, you are welcome to take a look yourself, but the aquarium hasn't been here for years."
3041,5266,0,1,41,42,1.0238095238095237,0.024098134635593994,688,Save the great leap for the after party.
2878,5266,0,1,41,42,1.0238095238095237,0.024098134635593994,688,"No sir, not a nose-cone stop at any level."
2747,5266,0,1,41,42,1.0238095238095237,0.024098134635593994,688,"I'm sorry, but the best I can do is the 86th floor""."
2658,5266,0,1,41,42,1.0238095238095237,0.024098134635593994,688,Is NASA cutting costs again?
4413,5266,0,1,41,42,1.0238095238095237,0.024098134635593994,688,Hold on. I think you want the sub basement.
3375,5266,0,1,41,42,1.0238095238095237,0.024098134635593994,688,"Down? Really? I had you pegged for wanting to get to the eighth floor, pronto!"
4418,5266,0,1,41,42,1.0238095238095237,0.024098134635593994,688,We can't go to the 9th floor until after store hours.
5076,5266,0,1,41,42,1.0238095238095237,0.024098134635593994,688,JHOUIBWHQOFWGRFWjgehuirj0eghufjowgprfw90doqefv
4553,5266,0,1,41,42,1.0238095238095237,0.024098134635593994,688,"I'm sorry sir, this elevator does not go that far"
5296,5266,0,1,41,42,1.0238095238095237,0.024098134635593994,688,"There aren't any higher floors"""
5254,5266,0,1,41,42,1.0238095238095237,0.024098134635593994,688,Good morning Mr. Ciaramella.
5144,5266,0,1,41,42,1.0238095238095237,0.024098134635593994,688,"Let me guess, the Lonley Moon Suite?"
5117,5266,0,1,41,42,1.0238095238095237,0.024098134635593994,688,Space aardvarks are on the 4th floor. Burp! I'm Hank!
5089,5266,0,1,41,42,1.0238095238095237,0.024098134635593994,688,you can't live in the Penthouse without one
2554,5266,0,1,41,42,1.0238095238095237,0.024098134635593994,688,PL IDENTIFY YOURSELF
5036,5266,0,1,41,42,1.0238095238095237,0.024098134635593994,688,Are you sure you don't want to go up?
4456,5266,0,1,41,42,1.0238095238095237,0.024098134635593994,688,"This only goes to floor 10, after that you'll have to take the stairs."
5015,5266,0,1,41,42,1.0238095238095237,0.024098134635593994,688,Welcome to Houston...?
4941,5266,0,1,41,42,1.0238095238095237,0.024098134635593994,688,I'm sorry sir but men's suits are not returnable!
4866,5266,0,1,41,42,1.0238095238095237,0.024098134635593994,688,"For the toy department, make the first left."
4815,5266,0,1,41,42,1.0238095238095237,0.024098134635593994,688,I don't have that much up.
4768,5266,0,1,41,42,1.0238095238095237,0.024098134635593994,688,"I'm sorry sir, this elevator only goes to the 52nd floor."
4766,5266,0,1,41,42,1.0238095238095237,0.024098134635593994,688,"Men's Room is to the left. No, I cannot help with your suit."
4695,5266,0,1,41,42,1.0238095238095237,0.024098134635593994,688,"This is the surface elevator, sir."
4575,5266,0,1,41,42,1.0238095238095237,0.024098134635593994,688,"No, sir, there are no launch abort options."
4952,5266,0,1,41,42,1.0238095238095237,0.024098134635593994,688,"I see you've heard the rumors, but let me assure you that the atmospheric conditions here are always suitable for lift off."
2518,5266,0,1,41,42,1.0238095238095237,0.024098134635593994,688,I guess you also found out that the National Chili Bean growers are having their convention here.
1583,5266,0,1,41,42,1.0238095238095237,0.024098134635593994,688,its no door to your right
2383,5266,0,1,41,42,1.0238095238095237,0.024098134635593994,688,May I suggest going down to see how the world looks from below
880,5266,0,1,41,42,1.0238095238095237,0.024098134635593994,688,"All the way to the top. Shoot me to the moon."" 
""But I...."" 
""Just do it. And fast. I don't have much air left."""
2501,5266,0,1,41,42,1.0238095238095237,0.024098134635593994,688,So is getting out of the elevator more of a small step or a giant leap?
797,5266,0,1,41,42,1.0238095238095237,0.024098134635593994,688,"Sequel to Space Odyssey 2001:
Earth Odyssey 2020."
773,5266,0,1,41,42,1.0238095238095237,0.024098134635593994,688,This is Plan B.
730,5266,0,1,41,42,1.0238095238095237,0.024098134635593994,688,I'm using this as my practice capsule.  I'm claustrophobic.
614,5266,0,1,41,42,1.0238095238095237,0.024098134635593994,688,"Down, I assume?"
572,5266,0,1,41,42,1.0238095238095237,0.024098134635593994,688,"What floor?

Ten ...

OK, ten it--

Nine ...

Nine?

Eight ...

NO!"
525,5266,0,1,41,42,1.0238095238095237,0.024098134635593994,688,"I'm sorry, but this is as high as we go."
398,5266,0,1,41,42,1.0238095238095237,0.024098134635593994,688,"Excuse me sir, if you're looking for the moon elevator that's on the other side of the lobby"""
389,5266,0,1,41,42,1.0238095238095237,0.024098134635593994,688,Mind the Barnard 68.
254,5266,0,1,41,42,1.0238095238095237,0.024098134635593994,688,This iSait4 he
171,5266,0,1,41,42,1.0238095238095237,0.024098134635593994,688,"as the bellhop pressed the button, he looked back and suddenly realized teh gravity of the situation"
165,5266,0,1,41,42,1.0238095238095237,0.024098134635593994,688,sir are you going to the space? no i'm heading to delhi
164,5266,0,1,41,42,1.0238095238095237,0.024098134635593994,688,"No, my name is “toy not Houston 9 %  ‘, and yes, we all 7 have problems."
38,5266,0,1,41,42,1.0238095238095237,0.024098134635593994,688,"Unbeknownst to Carl, elevator A had been designated ag an early testing site tor NASA gpace elevator program."
888,5266,0,1,41,42,1.0238095238095237,0.024098134635593994,688,"Going to the penthouse, sir?"
929,5266,0,1,41,42,1.0238095238095237,0.024098134635593994,688,"About the subway, sir...south of Houston, we have a problem."
867,5266,0,1,41,42,1.0238095238095237,0.024098134635593994,688,Geosynchronous Suite... please.
1130,5266,0,1,41,42,1.0238095238095237,0.024098134635593994,688,Here you are sir -- caught between the moon and New York City -- good luck with the love stuff.
2248,5266,0,1,41,42,1.0238095238095237,0.024098134635593994,688,You’re a few decades early.  Elon only sent the press release to get on The Tonight Show again.
2155,5266,0,1,41,42,1.0238095238095237,0.024098134635593994,688,"Sorry, this lift is only for floors 23 - 56."
1926,5266,0,1,41,42,1.0238095238095237,0.024098134635593994,688,"I'm sorry, sir, but this elevator only goes to the sixth floor."
1083,5266,0,1,41,42,1.0238095238095237,0.024098134635593994,688,OK!  10-9-8-8-6 ...
1755,5266,0,1,41,42,1.0238095238095237,0.024098134635593994,688,"I’m just saying, dress for the job YOU want"
1710,5266,0,1,41,42,1.0238095238095237,0.024098134635593994,688,To Infinity...and the fourth floor
1607,5266,0,1,41,42,1.0238095238095237,0.024098134635593994,688,Buzz? Buzz?! *sigh* He's doing it again...
1553,5266,0,1,41,42,1.0238095238095237,0.024098134635593994,688,"I'm sorry, we don't go to the moon."
1776,5266,0,1,41,42,1.0238095238095237,0.024098134635593994,688,"Maybe a giant leap for Mrs. Farkas in 9B, sir. You should be fine."
1486,5266,0,1,41,42,1.0238095238095237,0.024098134635593994,688,"Sir, for the last time, it doesn't go that high."
1440,5266,0,1,41,42,1.0238095238095237,0.024098134635593994,688,C Level please
1395,5266,0,1,41,42,1.0238095238095237,0.024098134635593994,688,Remember your training and don’t accept a bunch of hot air.
1389,5266,0,1,41,42,1.0238095238095237,0.024098134635593994,688,"Do you really think it's faster?""  --Gerard Black Laurelton, N"
1379,5266,0,1,41,42,1.0238095238095237,0.024098134635593994,688,It’s down on the right.
1200,5266,0,1,41,42,1.0238095238095237,0.024098134635593994,688,"Sir, this does not go up to the top of the rocket."
1175,5266,0,1,41,42,1.0238095238095237,0.024098134635593994,688,"This is as far as I can take you, Elton.  You're on your own now, Rocket Man"
1509,5266,0,1,41,42,1.0238095238095237,0.024098134635593994,688,"Certainly, sir.  The restrooms are down the hall, to your left."
3972,5341,0,0,38,38,1.0,0.02666903735313325,688,The custodian asked me to let you know that the climate control on you floor is working properly now.
3306,5341,0,0,38,38,1.0,0.02666903735313325,688,"We only go to the top floor.”
Will Hunter, Plymouth M"
1167,5341,0,0,38,38,1.0,0.02666903735313325,688,"I'm sorry, we don't go to the International Space Station!"""
56,5341,0,0,38,38,1.0,0.02666903735313325,688,"Be right back, just going to check on last years New Years resolutions!"
268,5341,0,0,38,38,1.0,0.02666903735313325,688,Great Wall of  ;  - this is your floor. You A right from your room.
235,5341,0,0,38,38,1.0,0.02666903735313325,688,Yelp said the rooftop patio had great atmosphere
4364,5341,0,0,38,38,1.0,0.02666903735313325,688,"Astronaut Schweickart, aren't you supposed to be testing the backpack on your space walk?"
825,5341,0,0,38,38,1.0,0.02666903735313325,688,Did you enjoy your trip to the moon sir?
4686,5341,0,0,38,38,1.0,0.02666903735313325,688,I'm honored that you would fake a moon landing in our building!
